GEOID,B22010e1,B22010m1,B22010e2,B22010m2,B22010e3,B22010m3,B22010e4,B22010m4,B22010e5,B22010m5,B22010e6,B22010m6,B22010e7,B22010m7,OBJECTID
15000US060014001001,1292,54,0,12,0,12,0,12,1292,54,288,78,1004,77,3
15000US060014002001,443,38,0,12,0,12,0,12,443,38,40,21,403,41,4
15000US060014002002,370,42,5,8,0,12,5,8,365,43,33,17,332,47,5
15000US060014003001,483,102,0,12,0,12,0,12,483,102,66,76,417,112,6
15000US060014003002,717,135,21,32,0,12,21,32,696,128,156,121,540,117,7
15000US060014003003,560,117,34,40,34,40,0,12,526,121,88,67,438,107,8
15000US060014003004,679,112,0,12,0,12,0,12,679,112,75,65,604,111,9
15000US060014004001,672,79,0,12,0,12,0,12,672,79,50,30,622,81,10
15000US060014004002,537,78,0,12,0,12,0,12,537,78,142,59,395,80,11
15000US060014004003,589,77,29,26,20,22,9,15,560,80,129,62,431,84,12
15000US060014005001,1142,84,42,53,34,52,8,13,1100,86,154,67,946,106,13
15000US060014005002,251,83,8,12,8,12,0,12,243,81,45,49,198,75,14
15000US060014005003,250,56,0,12,0,12,0,12,250,56,41,30,209,56,15
15000US060014006001,480,53,40,34,9,12,31,32,440,59,99,59,341,64,16
15000US060014006002,233,44,3,6,0,12,3,6,230,45,43,25,187,41,17
15000US060014007001,508,85,47,33,9,13,38,34,461,84,91,51,370,78,18
15000US060014007002,514,101,39,46,32,45,7,11,475,91,139,87,336,78,19
15000US060014007003,349,76,44,42,14,21,30,36,305,80,55,52,250,73,20
15000US060014007004,416,91,85,65,54,55,31,34,331,88,111,69,220,68,21
15000US060014008001,748,111,37,38,19,28,18,20,711,116,186,94,525,113,22
15000US060014008002,368,94,18,27,18,27,0,12,350,98,54,46,296,92,23
15000US060014008003,464,80,29,26,11,16,18,21,435,80,36,24,399,78,24
15000US060014009001,579,84,51,36,7,10,44,34,528,83,177,71,351,91,25
15000US060014009002,446,66,9,13,0,12,9,13,437,65,86,47,351,66,26
15000US060014010001,447,120,84,72,26,42,58,62,363,117,142,114,221,96,27
15000US060014010002,408,105,67,52,67,52,0,12,341,97,59,47,282,97,28
15000US060014010003,593,117,76,76,76,76,0,12,517,110,95,63,422,113,29
15000US060014010004,258,106,0,12,0,12,0,12,258,106,9,14,249,105,30
15000US060014010005,392,118,39,37,10,16,29,34,353,118,116,86,237,102,31
15000US060014010006,521,119,33,55,33,55,0,12,488,122,115,87,373,126,32
15000US060014011001,253,76,0,12,0,12,0,12,253,76,0,12,253,76,33
15000US060014011002,840,115,14,22,0,12,14,22,826,114,85,60,741,126,34
15000US060014011003,446,99,24,33,0,12,24,33,422,89,66,63,356,79,35
15000US060014011004,493,142,19,30,0,12,19,30,474,144,106,108,368,116,36
15000US060014012001,504,63,36,37,0,12,36,37,468,68,98,50,370,68,37
15000US060014012002,398,57,13,17,0,12,13,17,385,57,44,40,341,54,38
15000US060014012003,329,72,30,47,29,46,1,8,299,71,47,31,252,70,39
15000US060014013001,541,84,94,58,11,17,83,58,447,79,43,39,404,74,40
15000US060014013002,664,88,93,53,39,37,54,37,571,91,301,75,270,87,41
15000US060014013003,500,75,49,45,9,15,40,39,451,80,55,40,396,77,42
15000US060014014001,423,91,18,20,0,12,18,20,405,91,226,78,179,68,43
15000US060014014002,780,120,192,79,18,21,174,76,588,112,184,74,404,106,44
15000US060014014003,341,88,95,56,32,29,63,50,246,78,56,36,190,75,45
15000US060014015001,497,60,78,37,36,23,42,34,419,61,168,51,251,62,46
15000US060014015002,304,50,17,16,7,12,10,10,287,50,81,40,206,57,47
15000US060014015003,222,47,28,26,18,21,10,14,194,45,44,27,150,43,48
15000US060014016001,373,63,98,54,51,35,47,38,275,69,90,45,185,55,49
15000US060014016002,408,64,92,39,54,39,38,32,316,62,91,40,225,63,50
15000US060014017001,368,86,28,27,28,27,0,12,340,87,75,49,265,81,51
15000US060014017002,863,97,61,47,12,20,49,45,802,106,154,74,648,100,52
15000US060014017003,0,12,0,12,0,12,0,12,0,12,0,12,0,12,53
15000US060014018001,320,59,69,50,19,22,50,46,251,49,41,28,210,53,54
15000US060014018002,411,65,132,55,67,49,65,36,279,69,86,41,193,72,55
15000US060014022001,332,50,70,33,14,15,56,29,262,53,97,32,165,49,56
15000US060014022002,287,49,80,34,21,17,59,39,207,51,73,38,134,43,57
15000US060014022003,219,56,14,12,0,12,14,12,205,58,65,40,140,54,58
15000US060014024001,674,82,87,54,0,12,87,54,587,94,205,75,382,95,59
15000US060014024002,477,87,78,51,27,33,51,46,399,86,128,61,271,79,60
15000US060014025001,437,55,56,29,15,18,41,32,381,60,122,49,259,63,61
15000US060014025002,267,42,185,49,81,40,104,45,82,36,40,30,42,29,62
15000US060014026001,654,31,53,30,19,18,34,24,601,43,217,46,384,43,63
15000US060014027001,299,58,90,51,24,22,66,52,209,54,60,31,149,54,64
15000US060014027002,381,60,63,45,43,38,20,21,318,61,118,53,200,53,65
15000US060014028001,911,146,113,65,84,58,29,31,798,131,283,101,515,107,66
15000US060014028002,1384,135,131,72,87,59,44,37,1253,151,364,110,889,139,67
15000US060014029001,853,39,72,33,54,26,18,17,781,50,209,52,572,56,68
15000US060014030001,951,98,58,41,11,18,47,36,893,97,322,90,571,97,69
15000US060014030002,660,117,91,54,6,9,85,54,569,123,316,99,253,106,70
15000US060014031001,712,34,31,29,0,12,31,29,681,41,155,61,526,68,71
15000US060014033001,1402,199,50,43,20,35,30,25,1352,209,152,116,1200,227,72
15000US060014033002,756,175,138,81,15,26,123,77,618,166,339,159,279,120,73
15000US060014034001,615,102,11,18,0,12,11,18,604,101,197,81,407,108,74
15000US060014034002,739,157,57,50,18,25,39,53,682,157,145,86,537,137,75
15000US060014034003,611,116,0,12,0,12,0,12,611,116,179,69,432,127,76
15000US060014034004,781,118,96,83,11,18,85,81,685,137,179,109,506,134,77
15000US060014035011,1254,145,98,86,83,83,15,23,1156,147,417,138,739,157,78
15000US060014035012,1070,184,110,105,0,12,110,105,960,179,134,71,826,193,79
15000US060014035013,259,91,0,12,0,12,0,12,259,91,94,81,165,74,80
15000US060014035021,439,78,6,10,6,10,0,12,433,78,61,45,372,82,81
15000US060014035022,731,98,37,46,5,10,32,49,694,90,106,62,588,93,82
15000US060014036001,559,154,38,44,0,12,38,44,521,155,103,104,418,137,83
15000US060014036002,950,177,10,17,0,12,10,17,940,179,117,70,823,169,84
15000US060014036003,1021,135,13,21,0,12,13,21,1008,134,50,46,958,148,85
15000US060014037011,765,88,43,49,8,13,35,47,722,91,169,52,553,95,86
15000US060014037012,918,89,8,12,0,12,8,12,910,88,70,46,840,93,87
15000US060014037021,326,72,8,14,0,12,8,14,318,72,19,21,299,74,88
15000US060014037022,797,87,61,48,28,35,33,30,736,98,71,40,665,94,89
15000US060014038001,241,49,0,12,0,12,0,12,241,49,57,48,184,46,90
15000US060014038002,493,69,8,13,0,12,8,13,485,70,52,47,433,71,91
15000US060014038003,408,69,30,47,0,12,30,47,378,71,49,27,329,72,92
15000US060014038004,666,93,0,12,0,12,0,12,666,93,18,19,648,96,93
15000US060014039001,913,155,28,49,0,12,28,49,885,155,111,91,774,152,94
15000US060014039002,400,87,0,12,0,12,0,12,400,87,82,89,318,79,95
15000US060014039003,931,153,41,41,41,41,0,12,890,161,226,142,664,148,96
15000US060014040001,1086,107,34,33,0,12,34,33,1052,110,84,39,968,115,97
15000US060014040002,564,79,0,12,0,12,0,12,564,79,81,44,483,82,98
15000US060014041011,641,82,0,12,0,12,0,12,641,82,169,64,472,73,99
15000US060014041012,1038,90,32,25,9,14,23,21,1006,97,101,59,905,97,100
15000US060014041021,893,82,9,13,0,12,9,13,884,81,108,48,776,86,101
15000US060014041022,622,95,0,12,0,12,0,12,622,95,246,73,376,99,102
15000US060014042001,336,61,9,16,0,12,9,16,327,64,46,28,281,64,103
15000US060014042002,514,66,0,12,0,12,0,12,514,66,96,46,418,68,104
15000US060014042003,435,63,0,12,0,12,0,12,435,63,72,32,363,63,105
15000US060014043001,359,54,0,12,0,12,0,12,359,54,29,25,330,59,106
15000US060014043002,352,60,0,12,0,12,0,12,352,60,60,34,292,65,107
15000US060014043003,541,56,0,12,0,12,0,12,541,56,76,47,465,63,108
15000US060014044001,1036,126,0,12,0,12,0,12,1036,126,30,35,1006,126,109
15000US060014044002,635,132,10,16,10,16,0,12,625,132,93,87,532,141,110
15000US060014044003,646,102,0,12,0,12,0,12,646,102,51,46,595,105,111
15000US060014045011,679,24,5,8,5,8,0,12,674,25,86,31,588,35,112
15000US060014045021,270,69,12,17,0,12,12,17,258,72,62,51,196,66,113
15000US060014045022,492,85,0,12,0,12,0,12,492,85,118,71,374,92,114
15000US060014045023,744,130,0,12,0,12,0,12,744,130,228,106,516,118,115
15000US060014045024,833,137,0,12,0,12,0,12,833,137,92,78,741,150,116
15000US060014046001,430,55,0,12,0,12,0,12,430,55,35,27,395,58,117
15000US060014046002,280,46,0,12,0,12,0,12,280,46,9,14,271,47,118
15000US060014046003,526,67,28,32,8,12,20,29,498,68,65,44,433,64,119
15000US060014046004,525,56,0,12,0,12,0,12,525,56,111,44,414,64,120
15000US060014047001,365,39,7,11,7,11,0,12,358,39,36,20,322,43,121
15000US060014047002,430,38,0,12,0,12,0,12,430,38,92,33,338,46,122
15000US060014048001,591,81,25,25,18,22,7,11,566,84,99,35,467,85,123
15000US060014048002,652,79,10,15,0,12,10,15,642,78,205,71,437,93,124
15000US060014049001,293,47,0,12,0,12,0,12,293,47,36,25,257,51,125
15000US060014049002,714,97,0,12,0,12,0,12,714,97,242,90,472,116,126
15000US060014049003,380,78,10,16,0,12,10,16,370,79,51,36,319,81,127
15000US060014049004,558,68,0,12,0,12,0,12,558,68,84,40,474,69,128
15000US060014050001,277,46,8,12,8,12,0,12,269,45,74,42,195,45,129
15000US060014050002,500,80,6,11,6,11,0,12,494,80,95,52,399,68,130
15000US060014050003,699,93,43,42,32,40,11,13,656,92,153,67,503,92,131
15000US060014051001,350,47,0,12,0,12,0,12,350,47,40,31,310,52,132
15000US060014051002,234,49,0,12,0,12,0,12,234,49,79,41,155,42,133
15000US060014051003,375,57,24,37,24,37,0,12,351,69,9,15,342,70,134
15000US060014051004,230,34,0,12,0,12,0,12,230,34,0,12,230,34,135
15000US060014051005,376,72,0,12,0,12,0,12,376,72,27,24,349,76,136
15000US060014052001,669,118,45,45,13,21,32,37,624,119,146,85,478,106,137
15000US060014052002,454,99,17,26,0,12,17,26,437,103,96,59,341,113,138
15000US060014052003,506,98,89,64,0,12,89,64,417,101,120,61,297,113,139
15000US060014052004,762,142,0,12,0,12,0,12,762,142,106,83,656,142,140
15000US060014053011,1114,103,47,36,31,25,16,25,1067,108,200,79,867,112,141
15000US060014053012,403,87,5,9,0,12,5,9,398,86,75,56,323,79,142
15000US060014053021,890,94,43,34,8,12,35,30,847,98,256,87,591,99,143
15000US060014053022,598,103,60,47,30,34,30,34,538,107,150,60,388,102,144
15000US060014054011,734,92,84,43,21,23,63,42,650,97,84,51,566,104,145
15000US060014054012,456,93,63,50,17,26,46,43,393,90,78,46,315,89,146
15000US060014054013,465,76,144,63,72,50,72,48,321,83,59,39,262,83,147
15000US060014054021,629,73,162,69,24,24,138,69,467,85,111,63,356,82,148
15000US060014054022,526,73,88,57,30,38,58,40,438,80,87,51,351,83,149
15000US060014055001,306,64,77,42,25,31,52,33,229,72,87,53,142,64,150
15000US060014055002,390,75,94,45,51,36,43,29,296,71,83,48,213,64,151
15000US060014055003,377,85,66,60,66,60,0,12,311,74,65,47,246,71,152
15000US060014055004,542,84,56,54,30,46,26,29,486,80,106,65,380,74,153
15000US060014056001,339,88,25,39,25,39,0,12,314,83,73,62,241,69,154
15000US060014056002,462,85,28,26,8,12,20,23,434,90,106,48,328,96,155
15000US060014056003,610,93,62,54,31,42,31,38,548,97,50,35,498,91,156
15000US060014057001,490,112,107,78,51,61,56,55,383,93,98,65,285,85,157
15000US060014057002,393,106,80,53,9,13,71,57,313,101,95,67,218,92,158
15000US060014057003,489,102,56,47,19,23,37,41,433,92,95,64,338,90,159
15000US060014058001,391,83,128,72,31,45,97,60,263,76,61,41,202,72,160
15000US060014058002,372,86,65,42,7,13,58,44,307,81,96,47,211,72,161
15000US060014058003,388,69,89,52,17,21,72,55,299,73,88,60,211,67,162
15000US060014058004,169,48,71,38,34,33,37,27,98,44,12,13,86,42,163
15000US060014059011,392,75,140,55,32,35,108,46,252,80,88,63,164,77,164
15000US060014059012,425,85,102,56,48,34,54,48,323,81,173,69,150,60,165
15000US060014059013,240,62,40,34,26,27,14,21,200,60,19,22,181,60,166
15000US060014059021,418,53,107,41,54,28,53,31,311,57,112,40,199,52,167
15000US060014059022,498,61,97,39,42,28,55,28,401,66,110,41,291,60,168
15000US060014060001,354,86,51,39,15,17,36,33,303,82,86,52,217,77,169
15000US060014060002,159,71,54,47,0,12,54,47,105,57,79,60,26,24,170
15000US060014060003,935,102,133,67,77,52,56,44,802,104,290,86,512,108,171
15000US060014061001,364,106,57,53,11,17,46,49,307,96,153,82,154,70,172
15000US060014061002,140,64,42,46,5,10,37,44,98,45,38,29,60,40,173
15000US060014061003,548,108,70,77,34,54,36,59,478,104,35,31,443,107,174
15000US060014061004,444,101,148,73,34,47,114,57,296,83,85,55,211,85,175
15000US060014062011,331,88,17,20,6,9,11,19,314,84,112,64,202,82,176
15000US060014062012,237,59,45,34,24,30,21,25,192,57,53,43,139,59,177
15000US060014062013,508,104,190,72,39,39,151,63,318,105,95,66,223,82,178
15000US060014062014,276,75,63,50,0,12,63,50,213,71,31,33,182,64,179
15000US060014062021,322,71,62,39,0,12,62,39,260,66,115,54,145,57,180
15000US060014062022,418,64,56,41,31,29,25,29,362,62,84,52,278,70,181
15000US060014062023,565,73,284,81,65,42,219,74,281,78,74,48,207,71,182
15000US060014063001,390,75,52,42,27,25,25,33,338,70,200,66,138,48,183
15000US060014063002,314,73,111,60,32,36,79,52,203,67,5,9,198,67,184
15000US060014063003,274,63,62,48,22,22,40,40,212,65,32,35,180,66,185
15000US060014063004,225,68,40,30,17,22,23,19,185,64,24,22,161,64,186
15000US060014064001,202,39,6,9,0,12,6,9,196,41,36,22,160,39,187
15000US060014064002,514,57,113,59,57,48,56,41,401,62,154,48,247,66,188
15000US060014065001,675,95,66,45,19,20,47,45,609,95,139,62,470,109,189
15000US060014065002,274,77,40,38,19,31,21,24,234,83,66,56,168,72,190
15000US060014065003,622,116,141,80,7,15,134,77,481,119,121,57,360,101,191
15000US060014065004,447,108,53,49,42,46,11,18,394,107,103,65,291,93,192
15000US060014066011,321,88,38,37,11,18,27,31,283,95,103,69,180,71,193
15000US060014066012,584,110,99,79,8,11,91,80,485,99,207,84,278,86,194
15000US060014066013,576,94,57,36,35,32,22,31,519,92,140,70,379,80,195
15000US060014066014,198,78,51,49,8,13,43,48,147,63,48,28,99,61,196
15000US060014066021,447,61,9,10,9,10,0,12,438,59,128,53,310,64,197
15000US060014066022,512,62,49,42,8,9,41,41,463,75,123,52,340,80,198
15000US060014067001,398,92,15,23,0,12,15,23,383,91,57,43,326,98,199
15000US060014067002,209,52,13,20,13,20,0,12,196,56,8,15,188,55,200
15000US060014067003,968,165,40,64,0,12,40,64,928,164,325,134,603,147,201
15000US060014067004,312,82,0,12,0,12,0,12,312,82,65,41,247,85,202
15000US060014067005,243,67,14,23,0,12,14,23,229,66,33,27,196,65,203
15000US060014068001,275,50,18,22,0,12,18,22,257,55,43,29,214,59,204
15000US060014068002,299,62,0,12,0,12,0,12,299,62,63,40,236,70,205
15000US060014068003,380,74,29,39,23,37,6,10,351,68,91,54,260,62,206
15000US060014068004,414,82,75,65,8,13,67,64,339,71,12,19,327,68,207
15000US060014069001,235,48,10,15,10,15,0,12,225,52,42,36,183,55,208
15000US060014069002,510,75,0,12,0,12,0,12,510,75,64,42,446,81,209
15000US060014069003,783,88,95,63,11,17,84,63,688,110,135,65,553,111,210
15000US060014070001,364,95,12,20,0,12,12,20,352,92,106,74,246,89,211
15000US060014070002,523,132,46,54,0,12,46,54,477,134,93,79,384,146,212
15000US060014070003,277,115,59,65,16,24,43,62,218,105,42,40,176,104,213
15000US060014070004,485,130,160,102,79,75,81,73,325,111,103,72,222,105,214
15000US060014070005,304,121,48,70,0,12,48,70,256,113,73,66,183,124,215
15000US060014071011,495,97,108,61,33,31,75,55,387,94,130,70,257,85,216
15000US060014071012,525,92,58,53,12,19,46,50,467,93,191,89,276,94,217
15000US060014071021,563,104,152,81,116,69,36,43,411,94,89,46,322,95,218
15000US060014071022,296,97,48,35,17,20,31,30,248,99,7,11,241,98,219
15000US060014071023,185,62,27,25,8,12,19,23,158,64,71,52,87,47,220
15000US060014071024,244,79,38,36,26,29,12,20,206,83,27,27,179,81,221
15000US060014072001,404,86,189,72,104,59,85,57,215,83,78,60,137,66,222
15000US060014072002,418,90,159,84,60,52,99,68,259,83,88,58,171,70,223
15000US060014072003,365,86,72,51,9,13,63,51,293,88,84,49,209,74,224
15000US060014072004,614,102,36,34,18,20,18,29,578,106,129,53,449,107,225
15000US060014073001,365,63,84,37,37,27,47,30,281,63,49,28,232,63,226
15000US060014073002,379,70,53,32,11,18,42,32,326,67,29,23,297,69,227
15000US060014074001,487,76,140,55,65,37,75,49,347,79,122,59,225,74,228
15000US060014074002,340,87,62,54,8,14,54,50,278,81,36,37,242,78,229
15000US060014074003,320,73,107,50,22,25,85,47,213,69,77,51,136,62,230
15000US060014075001,249,102,156,81,66,51,90,67,93,70,15,23,78,63,231
15000US060014075002,748,120,169,100,40,52,129,89,579,144,220,86,359,116,232
15000US060014075003,282,93,8,13,0,12,8,13,274,93,86,54,188,90,233
15000US060014076001,593,135,74,61,0,12,74,61,519,115,127,65,392,122,234
15000US060014076002,395,128,132,96,68,73,64,63,263,102,52,51,211,99,235
15000US060014076003,248,101,10,21,0,12,10,21,238,102,68,71,170,88,236
15000US060014076004,601,153,123,110,0,12,123,110,478,147,145,87,333,133,237
15000US060014076005,349,118,0,12,0,12,0,12,349,118,7,22,342,115,238
15000US060014077001,531,101,66,46,40,37,26,28,465,104,161,71,304,90,239
15000US060014077002,436,89,48,54,10,16,38,51,388,83,118,61,270,73,240
15000US060014077003,349,64,27,24,10,15,17,20,322,65,55,36,267,65,241
15000US060014077004,330,70,0,12,0,12,0,12,330,70,88,55,242,61,242
15000US060014078001,16,25,0,12,0,12,0,12,16,25,0,12,16,25,243
15000US060014078002,438,56,20,20,14,14,6,10,418,59,69,33,349,55,244
15000US060014078003,305,56,34,23,5,8,29,23,271,57,60,30,211,55,245
15000US060014079001,268,60,0,12,0,12,0,12,268,60,34,25,234,62,246
15000US060014079002,413,69,7,13,7,13,0,12,406,68,80,43,326,77,247
15000US060014079003,432,73,10,16,0,12,10,16,422,72,72,42,350,79,248
15000US060014080001,329,45,3,5,3,5,0,12,326,45,39,22,287,55,249
15000US060014080002,641,55,6,9,0,12,6,9,635,54,118,41,517,69,250
15000US060014081001,554,96,0,12,0,12,0,12,554,96,83,50,471,102,251
15000US060014081002,1362,156,0,12,0,12,0,12,1362,156,227,115,1135,168,252
15000US060014081003,396,85,0,12,0,12,0,12,396,85,71,51,325,97,253
15000US060014081004,350,84,17,29,0,12,17,29,333,90,53,39,280,94,254
15000US060014082001,565,81,9,12,0,12,9,12,556,82,87,53,469,85,255
15000US060014082002,755,113,170,83,56,53,114,76,585,111,239,90,346,86,256
15000US060014082003,383,86,35,34,8,13,27,32,348,90,90,56,258,93,257
15000US060014083001,195,57,0,12,0,12,0,12,195,57,21,33,174,55,258
15000US060014083002,460,118,13,19,13,19,0,12,447,116,56,36,391,116,259
15000US060014083003,363,86,14,23,14,23,0,12,349,88,117,63,232,73,260
15000US060014083004,523,121,189,107,96,84,93,77,334,92,60,43,274,94,261
15000US060014083005,221,66,8,14,0,12,8,14,213,66,52,44,161,70,262
15000US060014084001,426,95,97,61,42,39,55,43,329,94,96,57,233,88,263
15000US060014084002,257,89,118,66,35,43,83,56,139,75,84,52,55,57,264
15000US060014084003,403,100,92,67,45,43,47,51,311,88,95,63,216,81,265
15000US060014085001,371,91,57,48,8,13,49,47,314,78,89,59,225,81,266
15000US060014085002,358,76,156,68,31,37,125,59,202,71,55,49,147,63,267
15000US060014085003,275,87,39,39,39,39,0,12,236,80,112,70,124,55,268
15000US060014085004,251,73,70,43,19,21,51,43,181,74,35,32,146,69,269
15000US060014085005,362,89,53,41,31,31,22,34,309,94,135,72,174,76,270
15000US060014086001,543,107,120,66,72,53,48,45,423,102,107,56,316,101,271
15000US060014086002,497,101,55,41,11,19,44,35,442,102,200,82,242,98,272
15000US060014086003,522,115,85,70,0,12,85,70,437,110,94,62,343,104,273
15000US060014086004,249,89,78,71,0,12,78,71,171,65,83,46,88,66,274
15000US060014087001,464,139,107,97,52,69,55,68,357,135,61,72,296,125,275
15000US060014087002,507,130,102,86,0,12,102,86,405,128,80,58,325,128,276
15000US060014087003,331,103,98,82,15,23,83,81,233,84,77,59,156,72,277
15000US060014087004,268,84,147,88,21,33,126,90,121,74,90,76,31,38,278
15000US060014087005,414,126,128,85,47,61,81,64,286,116,75,76,211,102,279
15000US060014087006,341,126,38,60,0,12,38,60,303,120,161,98,142,86,280
15000US060014088001,415,89,152,72,13,20,139,70,263,71,94,52,169,74,281
15000US060014088002,335,104,162,88,49,44,113,70,173,82,57,36,116,69,282
15000US060014088003,468,98,252,85,101,62,151,73,216,79,111,59,105,67,283
15000US060014088004,732,127,136,82,19,21,117,77,596,136,192,91,404,111,284
15000US060014089001,461,57,109,42,52,32,57,28,352,63,144,47,208,57,285
15000US060014089002,483,67,101,45,44,31,57,36,382,75,81,39,301,68,286
15000US060014090001,575,57,93,42,41,26,52,34,482,69,146,52,336,65,287
15000US060014090002,0,12,0,12,0,12,0,12,0,12,0,12,0,12,288
15000US060014090003,463,52,37,25,27,22,10,12,426,55,127,44,299,62,289
15000US060014090004,0,12,0,12,0,12,0,12,0,12,0,12,0,12,290
15000US060014091001,348,62,77,49,13,13,64,52,271,63,84,39,187,63,291
15000US060014091002,286,49,80,38,23,20,57,34,206,45,73,32,133,43,292
15000US060014092001,556,63,108,42,66,36,42,24,448,66,183,50,265,67,293
15000US060014092002,367,61,105,41,30,20,75,38,262,56,63,30,199,45,294
15000US060014093001,610,113,114,79,20,21,94,77,496,107,212,94,284,91,295
15000US060014093002,407,82,90,61,67,47,23,37,317,88,97,48,220,87,296
15000US060014093003,269,74,68,53,11,17,57,51,201,59,80,41,121,53,297
15000US060014093004,267,76,73,59,33,37,40,46,194,67,75,53,119,59,298
15000US060014094001,224,71,64,48,17,26,47,35,160,60,69,50,91,52,299
15000US060014094002,637,79,215,85,95,57,120,60,422,87,100,53,322,80,300
15000US060014094003,369,76,139,61,68,50,71,38,230,70,45,42,185,66,301
15000US060014095001,469,63,186,49,38,32,148,49,283,59,66,35,217,54,302
15000US060014095002,340,66,109,51,34,22,75,45,231,58,80,40,151,53,303
15000US060014095003,308,51,80,45,7,12,73,44,228,50,80,47,148,49,304
15000US060014096001,369,91,115,66,59,55,56,43,254,91,100,67,154,73,305
15000US060014096002,232,74,39,36,39,36,0,12,193,68,39,33,154,66,306
15000US060014096003,264,84,28,39,24,38,4,9,236,88,41,41,195,80,307
15000US060014096004,152,65,39,42,22,34,17,26,113,62,49,55,64,38,308
15000US060014096005,365,84,118,76,34,43,84,63,247,80,98,65,149,60,309
15000US060014097001,296,92,109,72,40,31,69,65,187,69,40,35,147,64,310
15000US060014097002,561,106,145,75,42,37,103,63,416,117,103,55,313,110,311
15000US060014097003,339,69,95,49,26,26,69,43,244,76,37,30,207,76,312
15000US060014097004,328,85,31,49,0,12,31,49,297,84,67,54,230,83,313
15000US060014098001,358,97,10,16,10,16,0,12,348,97,72,42,276,100,314
15000US060014098002,648,102,50,55,8,14,42,48,598,113,247,78,351,121,315
15000US060014098003,249,77,0,12,0,12,0,12,249,77,92,67,157,59,316
15000US060014099001,237,50,0,12,0,12,0,12,237,50,63,46,174,57,317
15000US060014099002,248,57,10,17,0,12,10,17,238,57,26,23,212,60,318
15000US060014099003,551,79,38,46,38,46,0,12,513,72,142,58,371,71,319
15000US060014099004,347,55,11,17,0,12,11,17,336,57,56,38,280,64,320
15000US060014100001,375,57,0,12,0,12,0,12,375,57,113,58,262,69,321
15000US060014100002,809,60,41,47,11,13,30,46,768,69,154,67,614,88,322
15000US060014100003,13,19,0,12,0,12,0,12,13,19,0,12,13,19,323
15000US060014101001,440,60,45,28,17,12,28,26,395,54,160,45,235,48,324
15000US060014101002,552,75,107,49,30,29,77,44,445,68,86,33,359,75,325
15000US060014102001,447,98,109,75,0,12,109,75,338,88,84,51,254,69,326
15000US060014102002,355,99,32,44,5,11,27,43,323,93,153,89,170,75,327
15000US060014102003,344,95,7,12,0,12,7,12,337,95,9,14,328,95,328
15000US060014103001,158,48,33,25,13,16,20,19,125,41,40,25,85,40,329
15000US060014103002,377,62,101,48,56,38,45,31,276,62,63,39,213,56,330
15000US060014103003,411,56,51,30,8,13,43,27,360,57,87,40,273,60,331
15000US060014104001,363,70,36,38,0,12,36,38,327,71,104,61,223,74,332
15000US060014104002,420,78,43,35,20,29,23,34,377,74,122,56,255,67,333
15000US060014104003,614,89,49,34,9,14,40,32,565,93,86,66,479,101,334
15000US060014105001,961,48,307,77,124,62,183,62,654,77,239,55,415,76,335
15000US060014201001,384,46,0,12,0,12,0,12,384,46,55,24,329,44,336
15000US060014201002,240,40,0,12,0,12,0,12,240,40,62,32,178,45,337
15000US060014201003,246,41,0,12,0,12,0,12,246,41,54,28,192,41,338
15000US060014202001,504,73,24,24,0,12,24,24,480,75,99,49,381,82,339
15000US060014202002,373,84,0,12,0,12,0,12,373,84,83,58,290,77,340
15000US060014202003,363,74,14,23,14,23,0,12,349,75,9,13,340,75,341
15000US060014203001,682,118,41,48,0,12,41,48,641,119,53,48,588,121,342
15000US060014203002,919,125,0,12,0,12,0,12,919,125,107,70,812,133,343
15000US060014203003,354,95,0,12,0,12,0,12,354,95,18,21,336,99,344
15000US060014204001,1177,52,234,84,45,49,189,81,943,88,46,34,897,93,345
15000US060014205001,346,52,27,17,13,10,14,14,319,52,55,29,264,53,346
15000US060014205002,588,49,17,18,8,12,9,13,571,55,85,36,486,57,347
15000US060014206001,420,65,0,12,0,12,0,12,420,65,105,48,315,62,348
15000US060014206002,381,72,21,31,0,12,21,31,360,71,62,38,298,69,349
15000US060014206003,418,74,7,12,0,12,7,12,411,74,123,56,288,67,350
15000US060014211001,340,32,5,8,0,12,5,8,335,32,95,27,240,39,351
15000US060014211002,520,35,0,12,0,12,0,12,520,35,124,38,396,40,352
15000US060014212001,287,42,0,12,0,12,0,12,287,42,54,33,233,51,353
15000US060014212002,541,59,0,12,0,12,0,12,541,59,99,42,442,70,354
15000US060014212003,321,48,0,12,0,12,0,12,321,48,57,42,264,55,355
15000US060014212004,372,54,0,12,0,12,0,12,372,54,39,21,333,61,356
15000US060014213001,409,51,8,12,0,12,8,12,401,49,116,45,285,59,357
15000US060014213002,545,76,0,12,0,12,0,12,545,76,110,64,435,81,358
15000US060014213003,410,61,32,44,0,12,32,44,378,66,57,28,321,65,359
15000US060014213004,274,35,0,12,0,12,0,12,274,35,70,33,204,45,360
15000US060014214001,394,42,4,7,4,7,0,12,390,43,91,30,299,42,361
15000US060014214002,256,34,0,12,0,12,0,12,256,34,53,23,203,33,362
15000US060014215001,524,58,8,12,0,12,8,12,516,57,80,38,436,50,363
15000US060014215002,519,60,0,12,0,12,0,12,519,60,88,52,431,58,364
15000US060014215003,536,61,0,12,0,12,0,12,536,61,52,31,484,67,365
15000US060014216001,436,58,0,12,0,12,0,12,436,58,85,47,351,70,366
15000US060014216002,516,75,0,12,0,12,0,12,516,75,86,44,430,76,367
15000US060014216003,310,45,0,12,0,12,0,12,310,45,79,43,231,56,368
15000US060014216004,321,53,0,12,0,12,0,12,321,53,35,23,286,55,369
15000US060014217001,681,75,0,12,0,12,0,12,681,75,109,57,572,80,370
15000US060014217002,417,78,40,50,0,12,40,50,377,82,48,32,329,86,371
15000US060014217003,507,71,16,20,7,12,9,15,491,71,99,52,392,77,372
15000US060014218001,469,44,8,12,8,12,0,12,461,46,57,33,404,52,373
15000US060014218002,469,47,0,12,0,12,0,12,469,47,106,44,363,45,374
15000US060014219001,429,67,0,12,0,12,0,12,429,67,39,30,390,75,375
15000US060014219002,458,62,0,12,0,12,0,12,458,62,88,42,370,68,376
15000US060014219003,383,74,38,47,8,13,30,46,345,70,23,24,322,70,377
15000US060014219004,441,77,0,12,0,12,0,12,441,77,81,57,360,63,378
15000US060014220001,610,67,56,35,18,18,38,36,554,67,72,26,482,72,379
15000US060014220002,274,57,52,49,17,27,35,40,222,58,51,29,171,55,380
15000US060014221001,350,73,9,14,0,12,9,14,341,70,23,26,318,74,381
15000US060014221002,792,102,28,30,12,19,16,23,764,106,130,63,634,107,382
15000US060014222001,519,73,44,43,32,38,12,19,475,70,97,46,378,65,383
15000US060014222002,572,86,75,68,34,46,41,47,497,91,51,44,446,86,384
15000US060014222003,522,80,0,12,0,12,0,12,522,80,74,48,448,76,385
15000US060014223001,360,65,0,12,0,12,0,12,360,65,36,28,324,68,386
15000US060014223002,671,89,35,28,18,19,17,19,636,90,108,52,528,101,387
15000US060014223003,722,82,17,20,0,12,17,20,705,86,111,72,594,87,388
15000US060014224001,971,147,0,12,0,12,0,12,971,147,30,25,941,149,389
15000US060014224002,486,143,33,49,0,12,33,49,453,142,76,71,377,128,390
15000US060014224003,666,148,14,23,0,12,14,23,652,147,46,42,606,151,391
15000US060014225001,502,71,0,12,0,12,0,12,502,71,41,25,461,73,392
15000US060014225002,236,50,11,17,11,17,0,12,225,51,9,13,216,53,393
15000US060014225003,716,80,38,41,8,13,30,39,678,76,66,36,612,79,394
15000US060014226001,21,16,0,12,0,12,0,12,21,16,17,16,4,7,395
15000US060014227001,315,77,0,12,0,12,0,12,315,77,24,24,291,77,396
15000US060014227002,144,57,0,12,0,12,0,12,144,57,33,44,111,49,397
15000US060014227003,560,84,9,13,9,13,0,12,551,85,37,44,514,85,398
15000US060014228001,282,78,0,12,0,12,0,12,282,78,10,15,272,77,399
15000US060014228002,205,67,0,12,0,12,0,12,205,67,5,8,200,68,400
15000US060014228003,902,101,39,28,29,24,10,15,863,106,111,79,752,121,401
15000US060014229001,874,136,0,12,0,12,0,12,874,136,106,75,768,145,402
15000US060014229002,1084,161,73,45,28,40,45,47,1011,171,109,63,902,162,403
15000US060014230001,717,131,15,23,15,23,0,12,702,132,162,84,540,121,404
15000US060014230002,656,116,0,12,0,12,0,12,656,116,75,57,581,120,405
15000US060014230003,580,101,0,12,0,12,0,12,580,101,176,106,404,87,406
15000US060014231001,871,114,34,29,13,14,21,23,837,120,206,87,631,124,407
15000US060014231002,322,71,11,17,11,17,0,12,311,69,37,31,274,74,408
15000US060014231003,440,84,12,17,12,17,0,12,428,84,11,17,417,85,409
15000US060014231004,378,62,0,12,0,12,0,12,378,62,73,44,305,63,410
15000US060014232001,516,91,76,53,50,50,26,24,440,88,68,42,372,90,411
15000US060014232002,614,98,73,56,18,26,55,51,541,105,138,88,403,92,412
15000US060014233001,618,103,39,51,39,51,0,12,579,102,94,55,485,99,413
15000US060014233002,663,107,16,21,8,15,8,14,647,108,141,60,506,107,414
15000US060014233003,384,77,0,12,0,12,0,12,384,77,36,32,348,84,415
15000US060014234001,412,94,16,25,0,12,16,25,396,94,84,51,312,96,416
15000US060014234002,461,99,14,22,14,22,0,12,447,101,62,46,385,107,417
15000US060014234003,732,121,209,126,175,126,34,34,523,112,150,98,373,102,418
15000US060014234004,479,132,53,40,22,28,31,33,426,130,86,62,340,119,419
15000US060014235001,630,63,38,34,23,28,15,16,592,66,132,52,460,82,420
15000US060014235002,395,69,40,33,25,29,15,16,355,77,38,31,317,74,421
15000US060014235003,448,74,50,44,9,16,41,41,398,76,52,49,346,68,422
15000US060014236011,610,84,8,13,0,12,8,13,602,85,120,59,482,87,423
15000US060014236012,560,98,0,12,0,12,0,12,560,98,73,51,487,94,424
15000US060014236021,908,162,0,12,0,12,0,12,908,162,116,78,792,167,425
15000US060014236022,585,144,24,27,0,12,24,27,561,144,0,12,561,144,426
15000US060014236023,769,161,41,65,0,12,41,65,728,156,0,12,728,156,427
15000US060014237001,431,69,45,35,24,26,21,24,386,73,113,49,273,75,428
15000US060014237002,579,78,0,12,0,12,0,12,579,78,99,42,480,88,429
15000US060014237003,349,84,10,15,0,12,10,15,339,84,40,32,299,82,430
15000US060014238001,275,66,0,12,0,12,0,12,275,66,42,28,233,73,431
15000US060014238002,436,61,8,13,8,13,0,12,428,62,115,51,313,66,432
15000US060014238003,578,79,0,12,0,12,0,12,578,79,144,66,434,83,433
15000US060014239011,443,61,0,12,0,12,0,12,443,61,52,32,391,64,434
15000US060014239012,416,60,45,32,34,30,11,11,371,55,81,35,290,51,435
15000US060014239021,331,53,0,12,0,12,0,12,331,53,48,30,283,55,436
15000US060014239022,395,45,0,12,0,12,0,12,395,45,25,18,370,48,437
15000US060014240011,358,69,43,46,0,12,43,46,315,63,79,45,236,68,438
15000US060014240012,301,66,23,29,0,12,23,29,278,62,36,34,242,64,439
15000US060014240013,427,73,49,41,23,26,26,30,378,71,64,44,314,68,440
15000US060014240014,457,79,86,41,26,30,60,36,371,81,78,40,293,78,441
15000US060014240021,512,68,105,55,87,51,18,16,407,68,119,55,288,69,442
15000US060014240022,446,68,22,18,9,12,13,13,424,70,132,60,292,64,443
15000US060014251011,265,75,27,45,27,45,0,12,238,65,26,19,212,61,444
15000US060014251012,896,89,46,53,10,14,36,51,850,105,198,75,652,110,445
15000US060014251021,657,96,24,38,24,38,0,12,633,96,17,26,616,94,446
15000US060014251022,763,114,7,12,0,12,7,12,756,116,61,34,695,113,447
15000US060014251023,378,82,0,12,0,12,0,12,378,82,32,32,346,83,448
15000US060014251031,391,70,21,32,21,32,0,12,370,67,18,19,352,66,449
15000US060014251032,488,87,0,12,0,12,0,12,488,87,70,50,418,92,450
15000US060014251033,501,87,12,16,0,12,12,16,489,90,98,64,391,91,451
15000US060014251041,938,106,93,65,65,59,28,36,845,114,102,52,743,122,452
15000US060014251042,986,141,42,34,9,14,33,30,944,137,349,145,595,114,453
15000US060014261001,469,84,0,12,0,12,0,12,469,84,56,54,413,90,454
15000US060014261002,216,81,0,12,0,12,0,12,216,81,14,22,202,77,455
15000US060014261003,401,102,0,12,0,12,0,12,401,102,0,12,401,102,456
15000US060014261004,412,71,0,12,0,12,0,12,412,71,55,47,357,78,457
15000US060014261005,447,87,0,12,0,12,0,12,447,87,60,42,387,86,458
15000US060014261006,271,73,0,12,0,12,0,12,271,73,81,64,190,61,459
15000US060014262001,550,74,0,12,0,12,0,12,550,74,45,39,505,72,460
15000US060014262002,724,65,0,12,0,12,0,12,724,65,67,41,657,81,461
15000US060014262003,435,66,23,22,5,9,18,19,412,73,62,44,350,74,462
15000US060014271001,387,76,19,21,7,11,12,17,368,78,63,43,305,81,463
15000US060014271002,334,52,0,12,0,12,0,12,334,52,70,38,264,51,464
15000US060014271003,680,67,0,12,0,12,0,12,680,67,58,34,622,72,465
15000US060014272001,443,85,0,12,0,12,0,12,443,85,54,33,389,86,466
15000US060014272002,587,109,45,45,14,22,31,39,542,114,140,72,402,98,467
15000US060014272003,403,93,33,51,0,12,33,51,370,100,110,88,260,81,468
15000US060014272004,230,66,15,24,0,12,15,24,215,64,73,45,142,60,469
15000US060014272005,0,12,0,12,0,12,0,12,0,12,0,12,0,12,470
15000US060014273001,569,83,28,34,9,15,19,31,541,86,70,50,471,85,471
15000US060014273002,441,66,0,12,0,12,0,12,441,66,40,30,401,68,472
15000US060014273003,405,71,48,35,22,29,26,23,357,73,58,34,299,75,473
15000US060014273004,248,43,29,27,29,27,0,12,219,44,54,31,165,41,474
15000US060014273005,273,77,59,56,8,13,51,55,214,76,105,56,109,50,475
15000US060014276001,803,98,109,71,21,23,88,66,694,104,103,53,591,108,476
15000US060014276002,803,110,123,68,57,45,66,54,680,114,206,82,474,119,477
15000US060014276003,232,58,56,34,35,29,21,24,176,54,42,29,134,47,478
15000US060014277001,353,126,0,12,0,12,0,12,353,126,36,37,317,131,479
15000US060014277002,982,141,72,67,24,33,48,53,910,133,124,58,786,136,480
15000US060014277003,620,119,0,12,0,12,0,12,620,119,41,36,579,123,481
15000US060014277004,329,88,16,26,0,12,16,26,313,86,19,29,294,86,482
15000US060014278001,368,107,41,48,15,37,26,29,327,98,64,47,263,101,483
15000US060014278002,406,86,0,12,0,12,0,12,406,86,77,49,329,101,484
15000US060014278003,314,77,0,12,0,12,0,12,314,77,48,45,266,77,485
15000US060014278004,410,97,0,12,0,12,0,12,410,97,66,71,344,87,486
15000US060014278005,511,146,69,74,0,12,69,74,442,145,102,86,340,138,487
15000US060014279001,386,95,10,16,0,12,10,16,376,97,48,40,328,100,488
15000US060014279002,510,104,21,33,0,12,21,33,489,108,133,82,356,97,489
15000US060014279003,413,102,0,12,0,12,0,12,413,102,12,18,401,105,490
15000US060014279004,267,96,0,12,0,12,0,12,267,96,47,43,220,96,491
15000US060014279005,635,122,0,12,0,12,0,12,635,122,197,133,438,118,492
15000US060014280001,285,91,0,12,0,12,0,12,285,91,47,49,238,88,493
15000US060014280002,1105,93,55,37,0,12,55,37,1050,89,246,96,804,100,494
15000US060014281001,597,76,17,17,17,17,0,12,580,80,84,51,496,87,495
15000US060014281002,367,51,0,12,0,12,0,12,367,51,53,30,314,53,496
15000US060014281003,524,74,31,38,0,12,31,38,493,76,87,55,406,79,497
15000US060014281004,455,92,27,42,0,12,27,42,428,83,77,48,351,80,498
15000US060014282001,407,98,18,27,18,27,0,12,389,99,54,52,335,101,499
15000US060014282002,916,176,19,32,0,12,19,32,897,173,188,96,709,176,500
15000US060014282003,457,119,67,84,0,12,67,84,390,101,103,72,287,88,501
15000US060014282004,565,101,42,48,22,35,20,31,523,108,103,68,420,109,502
15000US060014282005,363,96,0,12,0,12,0,12,363,96,19,29,344,99,503
15000US060014283011,838,129,0,12,0,12,0,12,838,129,178,82,660,144,504
15000US060014283012,376,87,60,81,0,12,60,81,316,72,74,45,242,76,505
15000US060014283013,258,73,0,12,0,12,0,12,258,73,25,38,233,81,506
15000US060014283014,1037,118,15,23,0,12,15,23,1022,123,63,48,959,134,507
15000US060014283021,794,102,46,59,0,12,46,59,748,102,141,84,607,109,508
15000US060014283022,1052,117,0,12,0,12,0,12,1052,117,226,87,826,129,509
15000US060014283023,816,107,0,12,0,12,0,12,816,107,231,85,585,132,510
15000US060014284001,791,90,33,44,0,12,33,44,758,89,154,62,604,89,511
15000US060014284002,434,91,8,14,0,12,8,14,426,92,60,49,366,88,512
15000US060014284003,627,93,18,20,0,12,18,20,609,94,47,31,562,88,513
15000US060014285001,1115,96,83,45,11,18,72,45,1032,98,166,74,866,105,514
15000US060014285002,313,71,0,12,0,12,0,12,313,71,27,20,286,70,515
15000US060014286001,764,87,27,30,27,30,0,12,737,88,116,47,621,97,516
15000US060014286002,295,64,0,12,0,12,0,12,295,64,78,64,217,60,517
15000US060014286003,492,78,0,12,0,12,0,12,492,78,49,45,443,80,518
15000US060014287001,963,73,60,48,0,12,60,48,903,69,189,70,714,89,519
15000US060014287002,330,66,135,46,54,45,81,45,195,60,75,38,120,55,520
15000US060014301011,474,73,33,40,0,12,33,40,441,85,26,33,415,93,521
15000US060014301012,777,113,0,12,0,12,0,12,777,113,95,47,682,116,522
15000US060014301013,997,117,16,27,16,27,0,12,981,110,139,84,842,113,523
15000US060014301021,867,40,6,10,6,10,0,12,861,39,136,40,725,52,524
15000US060014302001,660,94,14,22,0,12,14,22,646,98,41,39,605,104,525
15000US060014302002,390,103,0,12,0,12,0,12,390,103,79,54,311,102,526
15000US060014302003,336,100,0,12,0,12,0,12,336,100,110,95,226,84,527
15000US060014302004,589,118,0,12,0,12,0,12,589,118,174,111,415,93,528
15000US060014302005,531,102,0,12,0,12,0,12,531,102,137,64,394,122,529
15000US060014303001,480,57,7,12,7,12,0,12,473,57,86,37,387,58,530
15000US060014303002,440,66,44,57,0,12,44,57,396,67,58,35,338,76,531
15000US060014303003,372,55,25,33,25,33,0,12,347,58,108,52,239,61,532
15000US060014304001,316,41,0,12,0,12,0,12,316,41,80,27,236,43,533
15000US060014304002,413,46,0,12,0,12,0,12,413,46,39,30,374,55,534
15000US060014305001,778,127,16,26,0,12,16,26,762,131,233,98,529,126,535
15000US060014305002,595,109,61,60,0,12,61,60,534,105,135,89,399,105,536
15000US060014305003,658,115,70,69,29,32,41,63,588,118,92,77,496,117,537
15000US060014306001,415,102,0,12,0,12,0,12,415,102,47,36,368,104,538
15000US060014306002,481,117,52,59,0,12,52,59,429,118,58,40,371,122,539
15000US060014306003,978,135,59,76,59,76,0,12,919,136,220,96,699,146,540
15000US060014306004,314,97,0,12,0,12,0,12,314,97,42,49,272,96,541
15000US060014307001,264,52,10,16,10,16,0,12,254,53,78,37,176,49,542
15000US060014307002,609,88,13,20,11,19,2,6,596,91,130,63,466,104,543
15000US060014307003,456,66,0,12,0,12,0,12,456,66,47,33,409,67,544
15000US060014308001,253,73,0,12,0,12,0,12,253,73,66,66,187,75,545
15000US060014308002,394,102,12,20,12,20,0,12,382,103,101,55,281,118,546
15000US060014308003,765,155,55,74,14,27,41,59,710,155,92,76,618,161,547
15000US060014308004,792,168,92,83,0,12,92,83,700,163,138,70,562,171,548
15000US060014309001,721,95,54,43,7,14,47,40,667,92,90,42,577,93,549
15000US060014309002,1080,100,199,86,68,43,131,80,881,117,188,91,693,120,550
15000US060014310001,472,78,20,26,0,12,20,26,452,76,121,53,331,82,551
15000US060014310002,630,78,11,16,0,12,11,16,619,79,161,58,458,88,552
15000US060014311001,546,76,61,39,0,12,61,39,485,83,104,64,381,91,553
15000US060014311002,828,79,158,65,18,21,140,66,670,84,167,63,503,96,554
15000US060014312001,609,136,0,12,0,12,0,12,609,136,148,88,461,138,555
15000US060014312002,946,166,30,44,0,12,30,44,916,167,194,127,722,160,556
15000US060014312003,934,178,0,12,0,12,0,12,934,178,242,108,692,198,557
15000US060014321001,655,97,46,36,36,30,10,18,609,97,91,48,518,103,558
15000US060014321002,433,79,41,43,0,12,41,43,392,85,44,37,348,82,559
15000US060014321003,396,58,23,31,0,12,23,31,373,54,73,41,300,51,560
15000US060014322001,428,74,75,56,14,19,61,53,353,66,64,36,289,74,561
15000US060014322002,337,64,0,12,0,12,0,12,337,64,64,32,273,68,562
15000US060014322003,942,96,58,55,8,13,50,52,884,92,202,72,682,95,563
15000US060014323001,496,80,14,22,14,22,0,12,482,80,122,65,360,85,564
15000US060014323002,424,85,38,57,0,12,38,57,386,97,15,18,371,99,565
15000US060014323003,789,96,22,23,0,12,22,23,767,99,169,70,598,111,566
15000US060014324001,457,79,70,42,38,32,32,29,387,82,104,44,283,85,567
15000US060014324002,704,121,117,76,17,22,100,74,587,111,198,74,389,101,568
15000US060014324003,691,99,96,69,18,18,78,68,595,99,156,57,439,102,569
15000US060014325011,396,92,31,37,26,38,5,8,365,76,96,43,269,89,570
15000US060014325012,355,82,30,27,17,17,13,21,325,85,89,62,236,78,571
15000US060014325013,718,98,56,45,32,37,24,23,662,93,154,52,508,84,572
15000US060014325021,739,107,34,26,19,23,15,16,705,105,277,104,428,104,573
15000US060014325022,344,76,37,45,0,12,37,45,307,85,73,57,234,75,574
15000US060014325023,439,100,87,55,21,23,66,50,352,96,38,33,314,96,575
15000US060014326001,543,126,71,86,14,22,57,83,472,118,161,89,311,92,576
15000US060014326002,625,144,61,48,44,41,17,29,564,148,60,75,504,137,577
15000US060014326003,368,108,72,73,16,22,56,70,296,106,16,28,280,105,578
15000US060014326004,325,102,0,12,0,12,0,12,325,102,121,80,204,99,579
15000US060014326005,1175,155,21,32,0,12,21,32,1154,156,196,96,958,160,580
15000US060014327001,364,66,0,12,0,12,0,12,364,66,63,38,301,74,581
15000US060014327002,351,64,20,33,20,33,0,12,331,64,76,40,255,63,582
15000US060014327003,349,63,31,35,22,30,9,14,318,62,70,37,248,67,583
15000US060014328001,252,55,0,12,0,12,0,12,252,55,56,32,196,53,584
15000US060014328002,656,89,15,22,15,22,0,12,641,89,131,48,510,88,585
15000US060014328003,444,94,64,44,21,32,43,37,380,91,96,49,284,99,586
15000US060014330001,367,67,0,12,0,12,0,12,367,67,44,32,323,67,587
15000US060014330002,367,68,0,12,0,12,0,12,367,68,77,44,290,67,588
15000US060014330003,289,61,0,12,0,12,0,12,289,61,43,32,246,72,589
15000US060014330004,319,72,17,15,9,14,8,13,302,73,107,46,195,74,590
15000US060014331021,570,95,22,25,12,19,10,15,548,100,113,45,435,105,591
15000US060014331022,759,80,0,12,0,12,0,12,759,80,139,53,620,91,592
15000US060014331031,1048,116,56,44,30,29,26,37,992,119,89,53,903,119,593
15000US060014331032,542,113,53,65,44,64,9,15,489,120,82,59,407,123,594
15000US060014331041,453,121,6,11,6,11,0,12,447,123,53,39,394,125,595
15000US060014331042,414,98,30,38,30,38,0,12,384,109,112,74,272,102,596
15000US060014331043,991,132,90,72,17,19,73,71,901,132,200,78,701,126,597
15000US060014332001,584,121,112,72,83,64,29,33,472,116,50,48,422,115,598
15000US060014332002,952,172,74,95,16,24,58,92,878,170,182,103,696,174,599
15000US060014332003,828,186,179,133,40,49,139,116,649,189,12,20,637,193,600
15000US060014332004,410,88,30,41,30,41,0,12,380,93,106,61,274,98,601
15000US060014333001,495,94,26,31,10,17,16,25,469,94,141,77,328,91,602
15000US060014333002,231,73,0,12,0,12,0,12,231,73,72,60,159,75,603
15000US060014333003,554,104,76,87,20,32,56,79,478,128,79,48,399,125,604
15000US060014333004,524,117,33,28,0,12,33,28,491,119,98,59,393,123,605
15000US060014333005,467,117,0,12,0,12,0,12,467,117,127,93,340,104,606
15000US060014334001,322,96,27,40,0,12,27,40,295,98,39,39,256,111,607
15000US060014334002,277,100,21,32,0,12,21,32,256,98,38,30,218,94,608
15000US060014334003,344,131,0,12,0,12,0,12,344,131,46,45,298,134,609
15000US060014334004,477,121,0,12,0,12,0,12,477,121,67,59,410,122,610
15000US060014334005,352,99,45,67,45,67,0,12,307,104,0,12,307,104,611
15000US060014334006,520,134,17,28,17,28,0,12,503,130,120,80,383,131,612
15000US060014335001,251,58,5,11,4,10,1,3,246,59,77,45,169,59,613
15000US060014335002,323,61,31,29,23,27,8,13,292,63,63,39,229,69,614
15000US060014335003,501,78,15,25,15,25,0,12,486,85,113,61,373,92,615
15000US060014335004,330,71,8,13,0,12,8,13,322,73,90,56,232,62,616
15000US060014336001,265,79,0,12,0,12,0,12,265,79,74,53,191,82,617
15000US060014336002,768,145,235,127,88,98,147,95,533,143,72,63,461,148,618
15000US060014336003,554,121,53,64,40,60,13,20,501,122,24,30,477,124,619
15000US060014336004,571,138,0,12,0,12,0,12,571,138,203,117,368,131,620
15000US060014337001,402,78,56,47,36,38,20,28,346,74,18,18,328,78,621
15000US060014337002,306,86,0,12,0,12,0,12,306,86,76,48,230,85,622
15000US060014337003,332,89,34,34,7,11,27,32,298,95,37,34,261,90,623
15000US060014338001,281,87,33,49,0,12,33,49,248,85,40,30,208,92,624
15000US060014338002,852,165,191,111,61,59,130,95,661,189,66,52,595,189,625
15000US060014338003,913,167,21,32,21,32,0,12,892,171,81,48,811,177,626
15000US060014338004,525,118,73,69,28,32,45,62,452,99,198,101,254,85,627
15000US060014339001,611,166,143,146,0,12,143,146,468,202,55,56,413,200,628
15000US060014339002,544,157,42,39,42,39,0,12,502,159,238,124,264,131,629
15000US060014339003,474,118,175,119,0,12,175,119,299,113,54,67,245,108,630
15000US060014339004,769,163,116,80,36,57,80,75,653,157,58,70,595,148,631
15000US060014340001,949,110,86,54,40,40,46,41,863,120,254,94,609,115,632
15000US060014340002,360,96,26,30,17,27,9,15,334,95,18,18,316,94,633
15000US060014340003,512,97,167,90,35,31,132,90,345,93,76,30,269,94,634
15000US060014351021,758,95,20,24,0,12,20,24,738,96,98,47,640,108,635
15000US060014351022,813,95,12,12,0,12,12,12,801,95,111,54,690,96,636
15000US060014351031,1008,112,0,12,0,12,0,12,1008,112,162,70,846,116,637
15000US060014351032,941,116,16,25,0,12,16,25,925,118,151,61,774,119,638
15000US060014351033,257,67,0,12,0,12,0,12,257,67,52,63,205,74,639
15000US060014351041,775,126,21,23,21,23,0,12,754,124,121,69,633,118,640
15000US060014351042,1009,146,281,101,81,55,200,94,728,132,190,128,538,128,641
15000US060014351043,254,57,26,27,0,12,26,27,228,57,67,38,161,65,642
15000US060014352001,792,105,53,35,8,13,45,33,739,101,103,63,636,95,643
15000US060014352002,651,97,6,11,0,12,6,11,645,98,126,69,519,124,644
15000US060014353001,389,78,55,40,37,31,18,22,334,78,43,37,291,80,645
15000US060014353002,708,114,43,30,28,25,15,16,665,115,111,67,554,112,646
15000US060014353003,466,91,20,23,0,12,20,23,446,89,176,76,270,84,647
15000US060014354001,842,110,191,90,53,52,138,81,651,113,164,65,487,107,648
15000US060014354002,370,101,71,50,16,17,55,47,299,96,66,37,233,85,649
15000US060014354003,549,88,49,36,7,11,42,34,500,85,92,46,408,90,650
15000US060014355001,387,78,6,10,6,10,0,12,381,78,173,67,208,58,651
15000US060014355002,602,103,37,39,4,11,33,38,565,104,40,30,525,105,652
15000US060014355003,423,82,101,65,38,35,63,54,322,86,83,36,239,88,653
15000US060014356011,1053,127,273,116,32,35,241,115,780,153,163,85,617,135,654
15000US060014356012,574,130,58,58,7,11,51,57,516,129,135,66,381,119,655
15000US060014356021,492,92,103,77,26,41,77,65,389,101,25,25,364,99,656
15000US060014356022,342,85,56,50,53,49,3,5,286,79,53,32,233,80,657
15000US060014356023,377,82,55,43,37,32,18,30,322,77,55,33,267,77,658
15000US060014356024,425,88,36,32,23,30,13,16,389,96,118,54,271,89,659
15000US060014357001,375,104,28,31,5,10,23,30,347,101,104,66,243,93,660
15000US060014357002,315,70,0,12,0,12,0,12,315,70,65,43,250,76,661
15000US060014357003,363,71,26,40,0,12,26,40,337,71,74,41,263,69,662
15000US060014357004,332,82,12,11,12,11,0,12,320,82,109,57,211,86,663
15000US060014358001,353,77,3,6,3,6,0,12,350,79,123,57,227,76,664
15000US060014358002,420,85,45,43,25,37,20,24,375,81,107,58,268,87,665
15000US060014358003,422,97,18,22,14,21,4,7,404,93,58,36,346,90,666
15000US060014358004,450,95,7,11,0,12,7,11,443,97,117,59,326,111,667
15000US060014359001,582,83,0,12,0,12,0,12,582,83,102,50,480,84,668
15000US060014359002,497,84,49,37,15,17,34,36,448,82,97,59,351,90,669
15000US060014359003,317,65,64,53,25,39,39,40,253,56,60,34,193,56,670
15000US060014359004,215,55,18,27,0,12,18,27,197,51,61,39,136,51,671
15000US060014360001,369,66,0,12,0,12,0,12,369,66,28,24,341,74,672
15000US060014360002,605,78,30,30,4,9,26,29,575,82,164,76,411,80,673
15000US060014360003,433,77,0,12,0,12,0,12,433,77,112,48,321,80,674
15000US060014361001,338,84,10,18,10,18,0,12,328,85,120,78,208,71,675
15000US060014361002,868,121,46,49,8,13,38,46,822,121,202,80,620,126,676
15000US060014361003,613,95,36,41,12,18,24,37,577,93,117,49,460,95,677
15000US060014362001,517,93,172,78,42,47,130,68,345,84,67,39,278,82,678
15000US060014362002,758,106,191,76,34,27,157,75,567,103,121,55,446,102,679
15000US060014363001,634,140,179,84,31,40,148,84,455,130,188,109,267,133,680
15000US060014363002,888,152,64,54,0,12,64,54,824,152,178,91,646,149,681
15000US060014363003,400,107,68,62,0,12,68,62,332,108,35,37,297,117,682
15000US060014363004,682,141,0,12,0,12,0,12,682,141,123,82,559,143,683
15000US060014364011,401,126,0,12,0,12,0,12,401,126,113,78,288,117,684
15000US060014364012,942,204,77,95,0,12,77,95,865,194,239,101,626,176,685
15000US060014364013,807,186,179,129,60,85,119,100,628,195,125,78,503,178,686
15000US060014364014,577,164,84,89,0,12,84,89,493,147,174,111,319,113,687
15000US060014364015,286,109,136,106,57,66,79,81,150,92,0,12,150,92,688
15000US060014364021,609,59,1,6,0,12,1,6,608,59,127,51,481,81,689
15000US060014364022,412,54,0,12,0,12,0,12,412,54,115,46,297,64,690
15000US060014365001,584,89,124,70,10,16,114,68,460,91,54,35,406,89,691
15000US060014365002,1131,91,80,54,42,38,38,39,1051,98,138,53,913,98,692
15000US060014366011,503,94,89,43,34,42,55,40,414,96,84,55,330,93,693
15000US060014366012,833,107,130,71,20,22,110,67,703,107,124,57,579,106,694
15000US060014366013,518,107,145,72,96,69,49,38,373,96,111,52,262,96,695
15000US060014366021,1231,99,190,89,32,34,158,82,1041,100,191,76,850,104,696
15000US060014366022,436,91,121,68,0,12,121,68,315,69,96,55,219,65,697
15000US060014367001,433,81,43,43,5,10,38,42,390,77,71,39,319,71,698
15000US060014367002,588,82,67,34,49,28,18,20,521,90,123,57,398,79,699
15000US060014368001,830,89,221,94,44,57,177,93,609,123,24,21,585,122,700
15000US060014368002,508,87,74,65,0,12,74,65,434,92,103,43,331,95,701
15000US060014369001,634,114,208,86,17,18,191,85,426,124,100,60,326,112,702
15000US060014369002,293,73,20,24,10,17,10,16,273,77,108,65,165,58,703
15000US060014369003,306,76,24,26,24,26,0,12,282,71,75,41,207,75,704
15000US060014369004,551,120,82,51,63,49,19,20,469,114,106,63,363,105,705
15000US060014370001,477,61,22,20,7,13,15,17,455,62,44,26,411,66,706
15000US060014370002,317,58,0,12,0,12,0,12,317,58,39,29,278,58,707
15000US060014370003,448,51,58,46,58,46,0,12,390,56,76,41,314,67,708
15000US060014371011,909,102,12,18,12,18,0,12,897,103,151,55,746,115,709
15000US060014371012,572,103,15,18,15,18,0,12,557,105,203,83,354,98,710
15000US060014371013,426,73,92,43,24,23,68,37,334,76,133,57,201,72,711
15000US060014371021,464,91,84,65,27,24,57,60,380,78,82,51,298,72,712
15000US060014371022,545,83,39,31,13,21,26,26,506,92,110,46,396,99,713
15000US060014371023,382,81,54,43,22,25,32,36,328,94,98,55,230,90,714
15000US060014372001,877,118,77,61,26,28,51,58,800,125,197,95,603,148,715
15000US060014372002,292,89,62,75,8,13,54,74,230,79,54,41,176,86,716
15000US060014372003,444,92,0,12,0,12,0,12,444,92,193,105,251,77,717
15000US060014372004,688,116,90,81,33,52,57,64,598,136,129,82,469,144,718
15000US060014373001,251,48,7,11,0,12,7,11,244,47,84,32,160,40,719
15000US060014373002,476,68,123,47,35,39,88,38,353,62,85,46,268,64,720
15000US060014373003,188,56,0,12,0,12,0,12,188,56,79,51,109,37,721
15000US060014374001,264,44,19,16,11,12,8,11,245,47,53,27,192,49,722
15000US060014374002,643,55,39,37,2,4,37,37,604,57,226,58,378,63,723
15000US060014375001,503,80,106,54,54,41,52,46,397,96,52,47,345,87,724
15000US060014375002,674,81,173,70,30,26,143,64,501,90,74,45,427,94,725
15000US060014376001,613,50,116,45,58,32,58,42,497,61,186,58,311,70,726
15000US060014376002,277,42,29,22,9,13,20,18,248,40,89,41,159,32,727
15000US060014377011,168,63,51,42,0,12,51,42,117,55,9,14,108,54,728
15000US060014377012,660,87,149,72,62,50,87,64,511,90,80,45,431,92,729
15000US060014377013,231,62,83,42,27,30,56,45,148,54,50,34,98,53,730
15000US060014377021,669,82,193,82,32,33,161,80,476,86,36,34,440,90,731
15000US060014377022,425,75,166,72,57,42,109,59,259,74,63,52,196,73,732
15000US060014378001,1134,62,50,48,9,16,41,45,1084,63,322,79,762,91,733
15000US060014378002,239,54,35,37,6,9,29,36,204,50,34,25,170,46,734
15000US060014379001,352,50,10,14,10,14,0,12,342,48,84,40,258,56,735
15000US060014379002,308,51,16,13,5,7,11,11,292,52,78,35,214,48,736
15000US060014380001,756,84,0,12,0,12,0,12,756,84,154,58,602,97,737
15000US060014380002,341,76,23,22,12,23,11,17,318,76,109,67,209,71,738
15000US060014381001,500,116,26,30,26,30,0,12,474,113,225,86,249,105,739
15000US060014381002,200,68,0,12,0,12,0,12,200,68,80,51,120,56,740
15000US060014381003,292,107,14,23,14,23,0,12,278,113,106,100,172,100,741
15000US060014381004,485,89,14,23,14,23,0,12,471,88,95,63,376,108,742
15000US060014381005,263,90,39,60,0,12,39,60,224,86,47,45,177,82,743
15000US060014381006,317,95,24,34,24,34,0,12,293,93,120,61,173,93,744
15000US060014382011,419,86,175,93,86,65,89,74,244,79,134,70,110,50,745
15000US060014382012,489,92,22,21,13,16,9,15,467,91,172,69,295,84,746
15000US060014382013,279,74,25,23,19,21,6,10,254,73,64,35,190,75,747
15000US060014382031,575,77,52,34,21,20,31,23,523,87,157,66,366,96,748
15000US060014382032,637,88,54,44,12,16,42,43,583,89,132,67,451,102,749
15000US060014382041,623,92,35,32,8,13,27,28,588,92,75,43,513,100,750
15000US060014382042,338,72,23,27,0,12,23,27,315,69,80,42,235,63,751
15000US060014382043,848,95,67,43,61,47,6,10,781,96,195,66,586,101,752
15000US060014383001,345,57,86,53,23,23,63,48,259,54,78,37,181,52,753
15000US060014383002,296,54,42,37,9,9,33,37,254,46,64,26,190,49,754
15000US060014383003,249,47,11,14,11,14,0,12,238,47,65,33,173,46,755
15000US060014384001,327,41,29,21,8,9,21,19,298,44,56,32,242,45,756
15000US060014384002,366,52,9,12,0,12,9,12,357,50,154,50,203,54,757
15000US060014401001,1002,64,30,21,16,20,14,15,972,65,280,62,692,74,758
15000US060014402001,398,80,29,35,0,12,29,35,369,83,86,50,283,81,759
15000US060014402002,318,86,76,55,51,45,25,33,242,75,88,51,154,64,760
15000US060014402003,449,86,41,41,9,14,32,37,408,87,106,60,302,85,761
15000US060014402004,338,76,45,38,23,27,22,28,293,82,65,38,228,83,762
15000US060014403011,657,154,81,68,81,68,0,12,576,167,50,55,526,175,763
15000US060014403012,575,129,0,12,0,12,0,12,575,129,176,89,399,115,764
15000US060014403013,447,111,27,40,0,12,27,40,420,109,63,44,357,98,765
15000US060014403014,402,124,78,71,0,12,78,71,324,105,36,44,288,101,766
15000US060014403041,329,62,22,19,0,12,22,19,307,65,57,34,250,66,767
15000US060014403042,555,75,85,62,9,15,76,61,470,87,90,54,380,86,768
15000US060014403043,384,73,39,56,39,56,0,12,345,64,66,34,279,62,769
15000US060014403051,224,40,9,9,0,12,9,9,215,43,44,23,171,43,770
15000US060014403052,281,54,27,17,8,8,19,16,254,55,71,38,183,51,771
15000US060014403053,466,57,10,10,10,10,0,12,456,54,103,38,353,65,772
15000US060014403061,713,68,42,30,0,12,42,30,671,74,97,39,574,74,773
15000US060014403062,319,59,40,32,14,15,26,29,279,54,39,24,240,57,774
15000US060014403071,926,88,105,57,65,46,40,28,821,86,283,88,538,105,775
15000US060014403072,309,76,18,20,10,16,8,13,291,76,72,48,219,72,776
15000US060014403073,257,52,0,12,0,12,0,12,257,52,69,34,188,56,777
15000US060014403081,580,82,14,15,7,11,7,11,566,85,109,46,457,88,778
15000US060014403082,329,67,38,38,7,11,31,36,291,65,32,25,259,61,779
15000US060014403083,419,75,43,47,0,12,43,47,376,74,85,47,291,72,780
15000US060014403084,589,84,0,12,0,12,0,12,589,84,131,59,458,75,781
15000US060014403311,476,47,61,38,19,24,42,30,415,51,113,46,302,54,782
15000US060014403312,443,56,40,35,5,8,35,34,403,59,123,42,280,60,783
15000US060014403321,311,41,0,12,0,12,0,12,311,41,42,24,269,36,784
15000US060014403322,568,37,0,12,0,12,0,12,568,37,130,49,438,59,785
15000US060014403331,463,56,5,8,0,12,5,8,458,58,74,29,384,63,786
15000US060014403332,349,53,0,12,0,12,0,12,349,53,48,30,301,53,787
15000US060014403341,415,71,12,19,0,12,12,19,403,72,124,69,279,91,788
15000US060014403342,636,87,30,33,0,12,30,33,606,84,116,68,490,87,789
15000US060014403351,819,115,9,15,9,15,0,12,810,114,88,58,722,119,790
15000US060014403352,1377,150,49,57,31,50,18,30,1328,152,109,65,1219,159,791
15000US060014403361,672,94,55,35,6,9,49,34,617,99,50,33,567,104,792
15000US060014403362,770,103,21,22,14,18,7,11,749,99,154,68,595,107,793
15000US060014411001,872,85,27,25,10,15,17,21,845,87,203,70,642,79,794
15000US060014411002,712,89,45,57,0,12,45,57,667,92,133,64,534,82,795
15000US060014412001,1036,143,15,24,0,12,15,24,1021,146,157,87,864,150,796
15000US060014412002,508,128,0,12,0,12,0,12,508,128,145,86,363,111,797
15000US060014412003,998,127,12,21,0,12,12,21,986,129,184,103,802,151,798
15000US060014413011,254,56,0,12,0,12,0,12,254,56,42,30,212,62,799
15000US060014413012,914,57,27,30,0,12,27,30,887,60,43,25,844,62,800
15000US060014413021,570,89,25,23,17,19,8,13,545,89,98,45,447,86,801
15000US060014413022,439,80,0,12,0,12,0,12,439,80,91,48,348,89,802
15000US060014413023,323,68,7,11,0,12,7,11,316,70,81,42,235,70,803
15000US060014413024,490,93,65,45,22,21,43,41,425,87,61,42,364,88,804
15000US060014414011,586,115,50,57,25,36,25,41,536,115,139,89,397,120,805
15000US060014414012,612,111,23,35,0,12,23,35,589,112,168,78,421,118,806
15000US060014414013,282,82,0,12,0,12,0,12,282,82,76,54,206,79,807
15000US060014414014,845,129,87,69,43,54,44,45,758,127,116,64,642,133,808
15000US060014414021,683,65,25,26,10,14,15,24,658,72,104,54,554,71,809
15000US060014414022,631,84,65,45,19,20,46,39,566,79,54,30,512,80,810
15000US060014414023,330,59,11,15,0,12,11,15,319,61,63,37,256,60,811
15000US060014415011,914,101,4,7,4,7,0,12,910,102,183,74,727,102,812
15000US060014415012,867,91,11,18,0,12,11,18,856,95,134,56,722,98,813
15000US060014415031,1481,108,4,8,4,8,0,12,1477,109,110,53,1367,114,814
15000US060014415032,539,96,8,12,0,12,8,12,531,97,51,41,480,103,815
15000US060014415211,512,63,15,18,6,9,9,15,497,70,69,46,428,78,816
15000US060014415212,524,66,9,14,0,12,9,14,515,66,59,35,456,70,817
15000US060014415213,465,61,9,13,0,12,9,13,456,64,61,36,395,74,818
15000US060014415214,298,63,9,13,9,13,0,12,289,62,86,37,203,61,819
15000US060014415221,366,64,16,22,0,12,16,22,350,63,19,18,331,65,820
15000US060014415222,550,70,16,21,0,12,16,21,534,76,83,42,451,82,821
15000US060014415223,565,74,34,40,0,12,34,40,531,79,128,54,403,84,822
15000US060014415231,543,81,0,12,0,12,0,12,543,81,64,59,479,84,823
15000US060014415232,474,72,9,14,0,12,9,14,465,75,57,36,408,79,824
15000US060014415233,402,68,9,15,9,15,0,12,393,69,22,25,371,73,825
15000US060014415241,837,91,60,46,30,45,30,26,777,87,51,30,726,92,826
15000US060014415242,465,86,8,13,8,13,0,12,457,87,82,52,375,91,827
15000US060014416011,252,48,7,11,0,12,7,11,245,46,26,23,219,49,828
15000US060014416012,776,72,29,45,0,12,29,45,747,75,150,63,597,90,829
15000US060014416013,427,66,0,12,0,12,0,12,427,66,68,34,359,77,830
15000US060014416021,794,131,13,20,0,12,13,20,781,132,124,73,657,141,831
15000US060014416022,267,73,18,27,7,16,11,20,249,77,101,89,148,77,832
15000US060014416023,849,139,85,66,0,12,85,66,764,152,108,68,656,158,833
15000US060014416024,353,96,30,45,0,12,30,45,323,93,50,47,273,92,834
15000US060014417001,989,142,0,12,0,12,0,12,989,142,41,38,948,153,835
15000US060014417002,782,120,13,24,13,24,0,12,769,121,57,50,712,132,836
15000US060014417003,268,90,36,59,0,12,36,59,232,75,54,41,178,76,837
15000US060014417004,582,111,60,60,8,13,52,60,522,112,112,73,410,101,838
15000US060014418001,865,129,26,36,0,12,26,36,839,138,128,65,711,143,839
15000US060014418002,417,117,14,23,14,23,0,12,403,119,29,33,374,121,840
15000US060014418003,760,107,14,22,0,12,14,22,746,106,208,89,538,122,841
15000US060014418004,272,60,0,12,0,12,0,12,272,60,15,24,257,65,842
15000US060014419211,350,80,14,17,7,12,7,11,336,84,29,37,307,82,843
15000US060014419212,879,115,6,11,0,12,6,11,873,116,115,52,758,121,844
15000US060014419231,644,145,0,12,0,12,0,12,644,145,277,111,367,127,845
15000US060014419232,614,150,43,63,0,12,43,63,571,155,115,87,456,147,846
15000US060014419233,1102,158,86,70,21,31,65,66,1016,167,193,124,823,154,847
15000US060014419241,968,138,43,68,0,12,43,68,925,155,77,50,848,164,848
15000US060014419242,509,104,0,12,0,12,0,12,509,104,112,55,397,111,849
15000US060014419243,753,123,0,12,0,12,0,12,753,123,180,88,573,110,850
15000US060014419244,421,101,0,12,0,12,0,12,421,101,24,28,397,104,851
15000US060014419251,1656,154,0,12,0,12,0,12,1656,154,162,93,1494,178,852
15000US060014419252,1181,176,84,69,10,17,74,67,1097,180,153,86,944,169,853
15000US060014419261,763,84,57,40,40,38,17,18,706,88,93,47,613,94,854
15000US060014419262,685,79,17,19,9,14,8,12,668,81,49,33,619,84,855
15000US060014419271,937,108,38,35,20,22,18,27,899,113,72,41,827,112,856
15000US060014419272,853,92,0,12,0,12,0,12,853,92,219,68,634,93,857
15000US060014420001,645,53,11,16,11,16,0,12,634,53,142,60,492,74,858
15000US060014420002,389,54,0,12,0,12,0,12,389,54,33,25,356,59,859
15000US060014421001,682,62,10,16,10,16,0,12,672,63,116,46,556,73,860
15000US060014421002,934,85,26,23,17,18,9,14,908,89,131,50,777,101,861
15000US060014422001,583,88,11,19,11,19,0,12,572,87,83,52,489,102,862
15000US060014422002,686,117,0,12,0,12,0,12,686,117,71,57,615,125,863
15000US060014422003,451,98,0,12,0,12,0,12,451,98,60,46,391,97,864
15000US060014422004,420,95,0,12,0,12,0,12,420,95,94,54,326,103,865
15000US060014423011,473,85,6,9,6,9,0,12,467,85,127,50,340,84,866
15000US060014423012,343,66,39,40,10,16,29,35,304,70,40,38,264,61,867
15000US060014423013,700,92,81,57,8,13,73,54,619,107,84,42,535,102,868
15000US060014423021,704,108,16,19,8,13,8,14,688,110,131,69,557,98,869
15000US060014423022,717,98,57,40,19,29,38,28,660,91,154,59,506,93,870
15000US060014423023,644,108,31,48,31,48,0,12,613,101,124,59,489,112,871
15000US060014424001,395,79,6,11,0,12,6,11,389,80,59,36,330,84,872
15000US060014424002,588,92,19,22,8,12,11,19,569,94,93,55,476,107,873
15000US060014424003,427,76,19,21,8,13,11,17,408,78,61,36,347,78,874
15000US060014424004,565,93,31,40,6,11,25,38,534,101,92,52,442,100,875
15000US060014425001,513,124,27,43,0,12,27,43,486,114,106,61,380,106,876
15000US060014425002,570,165,14,25,14,25,0,12,556,167,165,89,391,156,877
15000US060014425003,716,171,45,67,45,67,0,12,671,155,105,69,566,155,878
15000US060014425004,420,111,18,27,18,27,0,12,402,111,95,93,307,97,879
15000US060014426011,491,86,7,11,0,12,7,11,484,86,112,46,372,87,880
15000US060014426012,810,92,4,9,0,12,4,9,806,91,59,39,747,107,881
15000US060014426021,776,107,96,74,7,12,89,73,680,104,113,67,567,105,882
15000US060014426022,842,108,12,24,0,12,12,24,830,104,143,56,687,122,883
15000US060014427001,408,72,0,12,0,12,0,12,408,72,98,55,310,69,884
15000US060014427002,366,65,15,17,0,12,15,17,351,66,54,32,297,70,885
15000US060014427003,263,51,0,12,0,12,0,12,263,51,60,32,203,51,886
15000US060014428001,925,55,53,43,7,10,46,43,872,67,195,46,677,77,887
15000US060014429001,684,114,0,12,0,12,0,12,684,114,115,68,569,125,888
15000US060014429002,417,73,12,19,12,19,0,12,405,73,154,69,251,83,889
15000US060014429003,881,127,16,30,0,12,16,30,865,129,200,91,665,145,890
15000US060014429004,372,109,0,12,0,12,0,12,372,109,18,25,354,106,891
15000US060014430011,833,17,28,30,0,12,28,30,805,33,186,49,619,54,892
15000US060014430021,427,83,76,68,0,12,76,68,351,78,63,34,288,76,893
15000US060014430022,708,90,7,12,7,12,0,12,701,91,90,51,611,96,894
15000US060014430023,752,94,11,17,11,17,0,12,741,91,125,52,616,92,895
15000US060014431021,418,68,0,12,0,12,0,12,418,68,54,37,364,69,896
15000US060014431022,279,44,5,9,0,12,5,9,274,44,11,15,263,45,897
15000US060014431023,422,72,8,14,8,14,0,12,414,75,85,48,329,82,898
15000US060014431024,412,66,0,12,0,12,0,12,412,66,80,47,332,67,899
15000US060014431031,308,65,0,12,0,12,0,12,308,65,71,37,237,70,900
15000US060014431032,926,69,18,26,18,26,0,12,908,72,92,46,816,78,901
15000US060014431041,544,82,0,12,0,12,0,12,544,82,137,66,407,82,902
15000US060014431042,416,76,16,21,0,12,16,21,400,76,39,30,361,75,903
15000US060014431043,783,83,40,23,9,14,31,19,743,83,92,44,651,73,904
15000US060014431051,663,74,27,32,19,28,8,14,636,69,73,44,563,75,905
15000US060014431052,773,69,0,12,0,12,0,12,773,69,127,60,646,81,906
15000US060014432001,812,69,0,12,0,12,0,12,812,69,83,54,729,80,907
15000US060014432002,368,57,0,12,0,12,0,12,368,57,29,30,339,65,908
15000US060014433011,316,57,21,27,0,12,21,27,295,59,60,34,235,62,909
15000US060014433012,899,56,0,12,0,12,0,12,899,56,145,61,754,67,910
15000US060014433211,293,56,0,12,0,12,0,12,293,56,37,25,256,62,911
15000US060014433212,863,70,32,27,0,12,32,27,831,79,63,36,768,85,912
15000US060014433221,497,42,23,17,18,16,5,8,474,40,69,28,405,47,913
15000US060014433222,407,38,5,7,0,12,5,7,402,38,94,31,308,37,914
15000US060014441001,1074,118,17,30,0,12,17,30,1057,125,167,86,890,153,915
15000US060014441002,515,109,0,12,0,12,0,12,515,109,89,50,426,111,916
15000US060014441003,444,104,16,27,16,27,0,12,428,106,149,64,279,121,917
15000US060014441004,498,102,0,12,0,12,0,12,498,102,190,87,308,91,918
15000US060014442001,373,79,7,11,0,12,7,11,366,79,124,58,242,76,919
15000US060014442002,683,82,68,40,37,30,31,29,615,77,85,51,530,82,920
15000US060014442003,841,115,16,18,8,15,8,12,825,118,182,68,643,110,921
15000US060014443011,592,67,0,12,0,12,0,12,592,67,156,58,436,75,922
15000US060014443012,580,71,33,32,5,8,28,32,547,69,68,37,479,78,923
15000US060014443021,567,73,26,31,7,11,19,29,541,75,63,42,478,76,924
15000US060014443022,687,86,26,32,0,12,26,32,661,93,131,64,530,83,925
15000US060014444001,399,91,21,23,0,12,21,23,378,89,117,52,261,92,926
15000US060014444002,688,112,29,27,0,12,29,27,659,117,77,55,582,128,927
15000US060014444003,462,86,15,23,15,23,0,12,447,91,83,68,364,93,928
15000US060014445001,228,69,32,45,0,12,32,45,196,60,31,36,165,57,929
15000US060014445002,488,84,30,30,5,7,25,30,458,86,136,61,322,86,930
15000US060014445003,420,67,113,44,35,41,78,53,307,63,79,42,228,69,931
15000US060014445004,902,99,51,42,0,12,51,42,851,107,88,59,763,103,932
15000US060014446011,827,97,22,24,22,24,0,12,805,97,119,48,686,93,933
15000US060014446012,699,98,31,26,0,12,31,26,668,96,143,48,525,98,934
15000US060014446021,1120,95,0,12,0,12,0,12,1120,95,146,59,974,101,935
15000US060014446022,435,78,13,23,0,12,13,23,422,78,105,52,317,80,936
15000US060014501011,1860,108,52,43,26,24,26,42,1808,114,130,60,1678,129,937
15000US060014501021,127,46,0,12,0,12,0,12,127,46,33,36,94,46,938
15000US060014501022,0,12,0,12,0,12,0,12,0,12,0,12,0,12,939
15000US060014501023,1233,71,30,33,14,20,16,24,1203,74,111,53,1092,86,940
15000US060014502001,652,100,0,12,0,12,0,12,652,100,86,60,566,99,941
15000US060014502002,992,133,26,42,0,12,26,42,966,129,126,77,840,135,942
15000US060014502003,802,142,19,29,0,12,19,29,783,139,63,43,720,135,943
15000US060014503001,755,105,6,9,6,9,0,12,749,104,171,97,578,114,944
15000US060014503002,994,104,34,28,8,13,26,25,960,108,145,78,815,123,945
15000US060014504001,723,130,41,46,12,20,29,42,682,137,89,56,593,154,946
15000US060014504002,418,99,0,12,0,12,0,12,418,99,67,51,351,111,947
15000US060014504003,946,124,18,31,0,12,18,31,928,130,206,90,722,148,948
15000US060014505011,255,51,0,12,0,12,0,12,255,51,36,46,219,54,949
15000US060014505012,1052,58,7,11,7,11,0,12,1045,61,177,59,868,78,950
15000US060014505021,789,72,0,12,0,12,0,12,789,72,150,62,639,80,951
15000US060014505022,1014,89,0,12,0,12,0,12,1014,89,109,49,905,85,952
15000US060014506011,258,54,3,5,3,5,0,12,255,54,36,20,219,51,953
15000US060014506012,1093,71,7,11,0,12,7,11,1086,72,122,61,964,85,954
15000US060014506021,522,148,0,12,0,12,0,12,522,148,13,23,509,148,955
15000US060014506022,652,104,0,12,0,12,0,12,652,104,105,57,547,113,956
15000US060014506023,836,128,0,12,0,12,0,12,836,128,199,91,637,125,957
15000US060014506024,288,72,15,24,0,12,15,24,273,70,9,15,264,70,958
15000US060014506025,1051,150,0,12,0,12,0,12,1051,150,162,103,889,165,959
15000US060014506031,411,75,8,13,8,13,0,12,403,78,129,66,274,73,960
15000US060014506032,223,40,0,12,0,12,0,12,223,40,13,15,210,40,961
15000US060014506033,520,81,0,12,0,12,0,12,520,81,86,45,434,90,962
15000US060014506034,476,73,11,16,0,12,11,16,465,72,80,40,385,75,963
15000US060014506041,439,57,0,12,0,12,0,12,439,57,81,50,358,61,964
15000US060014506042,845,89,5,10,0,12,5,10,840,87,173,64,667,88,965
15000US060014506043,295,50,0,12,0,12,0,12,295,50,59,36,236,56,966
15000US060014506044,222,31,0,12,0,12,0,12,222,31,20,20,202,33,967
15000US060014506051,667,65,0,12,0,12,0,12,667,65,119,50,548,59,968
15000US060014506052,347,49,0,12,0,12,0,12,347,49,79,44,268,58,969
15000US060014506053,476,53,11,16,0,12,11,16,465,53,84,39,381,60,970
15000US060014506061,758,97,0,12,0,12,0,12,758,97,65,60,693,86,971
15000US060014506062,469,89,0,12,0,12,0,12,469,89,50,32,419,90,972
15000US060014506063,832,92,0,12,0,12,0,12,832,92,158,52,674,99,973
15000US060014506071,1492,136,37,36,13,21,24,27,1455,139,388,137,1067,168,974
15000US060014506072,798,126,0,12,0,12,0,12,798,126,94,56,704,133,975
15000US060014507011,626,123,0,12,0,12,0,12,626,123,95,100,531,146,976
15000US060014507012,362,91,0,12,0,12,0,12,362,91,115,100,247,79,977
15000US060014507013,1164,105,14,23,0,12,14,23,1150,110,200,97,950,118,978
15000US060014507014,740,117,16,25,16,25,0,12,724,117,72,46,652,123,979
15000US060014507411,642,116,0,12,0,12,0,12,642,116,21,23,621,116,980
15000US060014507412,627,103,19,17,0,12,19,17,608,101,171,62,437,107,981
15000US060014507413,655,81,0,12,0,12,0,12,655,81,109,48,546,90,982
15000US060014507421,769,111,0,12,0,12,0,12,769,111,108,46,661,118,983
15000US060014507422,422,77,0,12,0,12,0,12,422,77,71,35,351,82,984
15000US060014507423,677,92,16,18,8,12,8,12,661,93,161,66,500,96,985
15000US060014507431,634,95,0,12,0,12,0,12,634,95,119,53,515,107,986
15000US060014507432,1469,97,51,60,0,12,51,60,1418,104,81,51,1337,110,987
15000US060014507441,1027,82,17,18,0,12,17,18,1010,87,149,65,861,95,988
15000US060014507442,674,90,0,12,0,12,0,12,674,90,90,47,584,90,989
15000US060014507451,1057,113,22,29,22,29,0,12,1035,116,68,50,967,122,990
15000US060014507452,1152,105,0,12,0,12,0,12,1152,105,213,106,939,126,991
15000US060014507461,1050,84,9,14,9,14,0,12,1041,85,256,58,785,93,992
15000US060014507462,286,82,0,12,0,12,0,12,286,82,49,36,237,80,993
15000US060014507501,2028,108,56,40,26,25,30,33,1972,108,238,90,1734,127,994
15000US060014507511,2227,136,0,17,0,17,0,17,2227,136,147,69,2080,136,995
15000US060014507521,1610,92,19,31,0,17,19,31,1591,92,196,89,1395,121,996
15000US060014511011,835,134,0,12,0,12,0,12,835,134,59,42,776,134,997
15000US060014511012,785,121,22,24,11,17,11,17,763,125,126,93,637,119,998
15000US060014511013,321,76,8,10,1,3,7,9,313,74,37,26,276,69,999
15000US060014511014,0,12,0,12,0,12,0,12,0,12,0,12,0,12,1000
15000US060014511015,514,108,0,12,0,12,0,12,514,108,85,71,429,102,1001
15000US060014511021,434,51,0,12,0,12,0,12,434,51,80,45,354,58,1002
15000US060014511022,959,54,0,12,0,12,0,12,959,54,99,44,860,57,1003
15000US060014512011,1093,135,66,65,22,33,44,58,1027,136,122,56,905,142,1004
15000US060014512012,958,129,17,28,0,12,17,28,941,135,106,76,835,148,1005
15000US060014512013,557,141,0,12,0,12,0,12,557,141,166,90,391,124,1006
15000US060014512021,886,94,9,13,9,13,0,12,877,94,174,65,703,108,1007
15000US060014512022,341,70,0,12,0,12,0,12,341,70,46,35,295,79,1008
15000US060014512023,288,61,12,18,0,12,12,18,276,61,49,29,227,64,1009
15000US060014513001,995,148,54,41,24,28,30,34,941,159,111,68,830,164,1010
15000US060014513002,569,97,0,12,0,12,0,12,569,97,75,50,494,102,1011
15000US060014513003,787,127,0,12,0,12,0,12,787,127,82,56,705,140,1012
15000US060014514011,725,131,46,41,20,31,26,29,679,133,96,83,583,152,1013
15000US060014514012,984,144,14,22,14,22,0,12,970,145,147,74,823,159,1014
15000US060014514013,688,139,51,55,19,30,32,42,637,143,196,102,441,127,1015
15000US060014514031,312,53,7,11,0,12,7,11,305,52,54,25,251,50,1016
15000US060014514032,458,51,25,19,13,15,12,12,433,55,81,29,352,55,1017
15000US060014514041,569,100,12,19,12,19,0,12,557,102,47,41,510,110,1018
15000US060014514042,373,115,48,48,0,12,48,48,325,112,69,50,256,121,1019
15000US060014514043,1091,137,154,106,29,33,125,103,937,148,112,64,825,153,1020
15000US060014515011,847,96,66,42,10,14,56,39,781,99,226,82,555,103,1021
15000US060014515012,926,81,0,12,0,12,0,12,926,81,187,78,739,96,1022
15000US060014515031,1203,134,0,12,0,12,0,12,1203,134,240,118,963,136,1023
15000US060014515032,458,112,16,26,16,26,0,12,442,108,141,98,301,111,1024
15000US060014515033,176,92,0,12,0,12,0,12,176,92,0,12,176,92,1025
15000US060014515034,292,91,117,68,32,38,85,58,175,74,53,48,122,70,1026
15000US060014515041,623,37,7,9,3,6,4,8,616,40,87,37,529,48,1027
15000US060014515051,397,50,11,21,11,21,0,12,386,52,62,33,324,57,1028
15000US060014515052,792,49,39,37,0,12,39,37,753,54,108,58,645,65,1029
15000US060014515061,828,93,32,47,0,12,32,47,796,93,142,57,654,95,1030
15000US060014515062,287,89,53,49,26,30,27,40,234,85,39,33,195,81,1031
15000US060014516011,765,112,20,21,20,21,0,12,745,116,109,55,636,115,1032
15000US060014516012,1214,95,51,54,40,51,11,18,1163,100,121,50,1042,105,1033
15000US060014516021,1215,197,54,72,0,12,54,72,1161,198,352,121,809,171,1034
15000US060014516022,451,137,36,50,0,12,36,50,415,125,154,90,261,119,1035
15000US060014516023,729,131,0,12,0,12,0,12,729,131,81,55,648,143,1036
15000US060014516024,496,106,0,12,0,12,0,12,496,106,138,74,358,118,1037
15000US060014517011,284,73,0,12,0,12,0,12,284,73,36,31,248,71,1038
15000US060014517012,554,79,10,15,10,15,0,12,544,83,132,62,412,84,1039
15000US060014517013,209,51,0,12,0,12,0,12,209,51,27,26,182,50,1040
15000US060014517031,515,84,68,40,36,32,32,35,447,87,23,22,424,87,1041
15000US060014517032,856,94,8,12,8,12,0,12,848,95,221,86,627,107,1042
15000US060014517041,606,80,0,12,0,12,0,12,606,80,42,33,564,88,1043
15000US060014517042,702,82,9,14,0,12,9,14,693,83,105,49,588,87,1044
15000US060014517043,403,74,8,11,8,11,0,12,395,76,117,63,278,82,1045
15000US060019819001,24,11,0,12,0,12,0,12,24,11,3,6,21,10,1046
15000US060019820001,29,12,0,12,0,12,0,12,29,12,3,6,26,13,1047
15000US060019832001,310,38,5,7,0,12,5,7,305,37,9,7,296,38,1048
15000US060019900000,0,12,0,12,0,12,0,12,0,12,0,12,0,12,1049
15000US060030100001,154,44,15,18,11,17,4,7,139,43,62,32,77,35,1050
15000US060030100002,189,43,27,13,20,11,7,6,162,36,30,14,132,31,1051
15000US060050001011,599,106,44,45,44,45,0,12,555,109,203,66,352,87,1052
15000US060050001012,502,132,68,58,30,48,38,32,434,127,101,43,333,128,1053
15000US060050001013,508,120,23,35,23,35,0,12,485,116,118,80,367,108,1054
15000US060050001014,358,97,0,12,0,12,0,12,358,97,211,86,147,78,1055
15000US060050001021,286,56,48,36,48,36,0,12,238,44,98,33,140,39,1056
15000US060050001022,432,69,112,54,76,51,36,31,320,60,146,48,174,54,1057
15000US060050002001,367,132,124,119,124,119,0,12,243,103,95,77,148,84,1058
15000US060050002002,511,106,31,30,5,9,26,30,480,101,152,95,328,94,1059
15000US060050002003,319,87,0,12,0,12,0,12,319,87,136,66,183,79,1060
15000US060050002004,277,82,10,16,10,16,0,12,267,82,116,63,151,64,1061
15000US060050002005,273,97,23,20,20,19,3,6,250,95,40,33,210,92,1062
15000US060050003011,285,60,4,8,0,12,4,8,281,59,121,50,160,55,1063
15000US060050003012,293,60,0,12,0,12,0,12,293,60,135,47,158,42,1064
15000US060050003031,772,141,130,86,32,32,98,83,642,127,182,73,460,132,1065
15000US060050003032,1245,202,94,66,47,44,47,61,1151,205,355,121,796,189,1066
15000US060050003041,748,122,110,70,23,27,87,62,638,117,189,74,449,113,1067
15000US060050003042,857,108,68,50,37,42,31,26,789,113,137,70,652,111,1068
15000US060050004011,613,116,126,120,58,90,68,76,487,108,131,72,356,90,1069
15000US060050004012,391,129,21,33,0,12,21,33,370,127,107,94,263,99,1070
15000US060050004013,742,129,42,33,5,13,37,30,700,131,235,80,465,108,1071
15000US060050004014,460,127,41,55,0,12,41,55,419,122,214,99,205,109,1072
15000US060050004021,794,170,58,69,58,69,0,12,736,157,145,86,591,147,1073
15000US060050004022,479,180,8,13,0,12,8,13,471,181,87,81,384,190,1074
15000US060050004023,348,115,20,26,9,19,11,19,328,113,152,91,176,81,1075
15000US060050004024,370,124,35,42,0,12,35,42,335,126,176,95,159,108,1076
15000US060050005001,577,104,91,54,46,38,45,45,486,101,136,60,350,101,1077
15000US060050005002,345,73,17,19,8,13,9,14,328,72,117,51,211,68,1078
15000US060050005003,497,106,10,19,10,19,0,12,487,105,75,46,412,108,1079
15000US060070001021,565,90,129,86,53,51,76,72,436,92,113,61,323,79,1080
15000US060070001022,533,90,36,30,9,15,27,28,497,90,78,46,419,88,1081
15000US060070001023,469,70,11,17,0,12,11,17,458,69,124,54,334,69,1082
15000US060070001031,1417,82,71,53,35,46,36,27,1346,97,221,82,1125,112,1083
15000US060070001041,701,181,15,25,15,25,0,12,686,182,19,22,667,185,1084
15000US060070001042,1278,231,130,101,63,69,67,68,1148,232,355,164,793,223,1085
15000US060070001043,366,99,10,17,0,12,10,17,356,98,70,48,286,106,1086
15000US060070002011,409,113,54,41,46,46,8,13,355,107,94,40,261,104,1087
15000US060070002012,433,95,44,42,32,37,12,20,389,91,117,43,272,96,1088
15000US060070002013,260,59,4,9,0,12,4,9,256,58,18,21,238,59,1089
15000US060070002014,806,134,121,65,30,31,91,54,685,140,149,97,536,104,1090
15000US060070002021,519,87,95,53,58,41,37,36,424,95,153,68,271,86,1091
15000US060070002022,380,93,74,50,0,12,74,50,306,88,56,38,250,87,1092
15000US060070002023,341,76,87,70,20,18,67,66,254,57,181,57,73,34,1093
15000US060070002024,402,88,75,54,67,52,8,13,327,77,155,63,172,74,1094
15000US060070003001,323,88,21,23,21,23,0,12,302,88,93,45,209,83,1095
15000US060070003002,816,149,155,90,47,53,108,71,661,141,115,63,546,139,1096
15000US060070003003,232,83,72,66,36,45,36,44,160,63,44,22,116,61,1097
15000US060070003004,557,131,76,48,20,23,56,42,481,134,233,105,248,111,1098
15000US060070004011,1215,83,107,60,16,23,91,55,1108,101,152,52,956,103,1099
15000US060070004021,1012,136,18,27,0,12,18,27,994,138,196,108,798,138,1100
15000US060070004022,843,143,77,67,58,59,19,32,766,142,186,78,580,157,1101
15000US060070004023,612,149,91,98,91,98,0,12,521,131,170,80,351,128,1102
15000US060070004024,486,129,18,28,18,28,0,12,468,129,70,53,398,126,1103
15000US060070005011,300,65,26,32,21,28,5,10,274,65,31,29,243,61,1104
15000US060070005012,439,73,30,27,8,12,22,24,409,73,114,72,295,67,1105
15000US060070005013,299,69,0,12,0,12,0,12,299,69,47,43,252,63,1106
15000US060070005014,514,119,32,38,11,17,21,34,482,124,125,62,357,113,1107
15000US060070005021,245,62,7,12,0,12,7,12,238,60,84,45,154,67,1108
15000US060070005022,355,92,123,67,84,55,39,41,232,81,62,54,170,76,1109
15000US060070005023,629,116,156,76,83,65,73,59,473,93,43,30,430,96,1110
15000US060070005024,382,97,23,28,0,12,23,28,359,106,49,42,310,98,1111
15000US060070006011,391,61,7,11,0,12,7,11,384,61,78,38,306,56,1112
15000US060070006012,404,74,17,19,0,12,17,19,387,76,57,39,330,77,1113
15000US060070006013,559,92,38,29,0,12,38,29,521,92,115,49,406,89,1114
15000US060070006031,214,66,22,25,17,24,5,7,192,71,47,37,145,67,1115
15000US060070006032,377,71,21,24,21,24,0,12,356,76,110,58,246,69,1116
15000US060070006033,5,8,0,12,0,12,0,12,5,8,0,12,5,8,1117
15000US060070006034,370,84,7,11,0,12,7,11,363,86,28,22,335,85,1118
15000US060070006041,281,98,100,78,35,44,65,62,181,82,0,12,181,82,1119
15000US060070006042,497,118,101,54,27,25,74,46,396,107,79,49,317,101,1120
15000US060070006043,144,62,43,42,32,39,11,13,101,50,9,14,92,48,1121
15000US060070006044,258,65,31,40,0,12,31,40,227,53,55,31,172,59,1122
15000US060070006045,395,107,102,78,102,78,0,12,293,105,10,17,283,103,1123
15000US060070007001,589,144,29,36,29,36,0,12,560,157,85,59,475,160,1124
15000US060070007002,590,140,54,52,15,25,39,44,536,139,149,104,387,130,1125
15000US060070007003,623,102,37,41,18,29,19,29,586,106,218,93,368,92,1126
15000US060070007004,385,106,82,84,17,26,65,81,303,92,41,39,262,91,1127
15000US060070008001,343,96,16,25,16,25,0,12,327,91,93,66,234,77,1128
15000US060070008002,326,91,0,12,0,12,0,12,326,91,79,70,247,92,1129
15000US060070008003,426,104,0,12,0,12,0,12,426,104,93,42,333,102,1130
15000US060070008004,659,129,16,26,0,12,16,26,643,127,173,95,470,121,1131
15000US060070008005,332,77,0,12,0,12,0,12,332,77,60,38,272,78,1132
15000US060070008006,135,57,11,18,11,18,0,12,124,54,71,60,53,37,1133
15000US060070009011,994,42,48,41,7,10,41,40,946,60,133,44,813,70,1134
15000US060070009031,448,59,37,18,9,8,28,16,411,55,100,25,311,51,1135
15000US060070009032,429,67,39,24,16,16,23,14,390,63,97,32,293,55,1136
15000US060070009033,898,173,109,108,0,12,109,108,789,172,151,85,638,167,1137
15000US060070009034,825,178,69,47,9,13,60,48,756,185,131,81,625,192,1138
15000US060070009041,969,117,29,36,12,23,17,28,940,110,248,112,692,132,1139
15000US060070009042,1231,188,0,12,0,12,0,12,1231,188,334,156,897,172,1140
15000US060070009043,287,110,84,93,84,93,0,12,203,68,27,23,176,74,1141
15000US060070010001,303,114,70,47,9,18,61,43,233,116,35,31,198,119,1142
15000US060070010002,217,95,15,24,0,12,15,24,202,98,37,42,165,98,1143
15000US060070010003,290,99,34,53,0,12,34,53,256,94,77,63,179,66,1144
15000US060070010004,185,129,0,12,0,12,0,12,185,129,0,12,185,129,1145
15000US060070010005,240,113,0,12,0,12,0,12,240,113,0,12,240,113,1146
15000US060070010006,508,139,22,29,9,19,13,20,486,138,70,55,416,138,1147
15000US060070011001,116,71,34,45,0,12,34,45,82,60,0,12,82,60,1148
15000US060070011002,545,73,60,37,23,25,37,28,485,82,120,55,365,78,1149
15000US060070011003,444,126,53,49,3,6,50,49,391,121,81,62,310,118,1150
15000US060070011004,192,59,14,13,5,10,9,15,178,58,24,17,154,63,1151
15000US060070011005,187,83,0,12,0,12,0,12,187,83,0,12,187,83,1152
15000US060070012001,471,75,57,35,27,25,30,28,414,75,137,64,277,73,1153
15000US060070012002,326,81,59,37,23,27,36,36,267,89,38,38,229,87,1154
15000US060070012003,340,70,64,53,30,45,34,39,276,77,45,37,231,74,1155
15000US060070012004,191,66,22,19,8,12,14,14,169,67,37,39,132,58,1156
15000US060070013001,472,83,103,59,48,37,55,44,369,77,103,52,266,85,1157
15000US060070013002,337,60,78,42,36,30,42,35,259,53,98,44,161,49,1158
15000US060070013003,277,52,91,30,40,19,51,27,186,41,66,24,120,37,1159
15000US060070013004,299,80,67,43,21,19,46,39,232,84,56,45,176,77,1160
15000US060070014001,704,119,0,12,0,12,0,12,704,119,90,64,614,119,1161
15000US060070014002,495,138,34,54,0,12,34,54,461,137,95,54,366,141,1162
15000US060070014003,400,91,24,39,24,39,0,12,376,89,98,61,278,87,1163
15000US060070014004,437,93,0,12,0,12,0,12,437,93,83,75,354,89,1164
15000US060070015001,485,115,12,23,0,12,12,23,473,121,117,85,356,124,1165
15000US060070015002,412,132,36,27,36,27,0,12,376,134,137,101,239,105,1166
15000US060070015003,646,128,12,21,0,12,12,21,634,133,149,70,485,137,1167
15000US060070015004,377,110,51,80,0,12,51,80,326,103,120,87,206,88,1168
15000US060070015005,135,77,0,12,0,12,0,12,135,77,0,12,135,77,1169
15000US060070016001,478,106,17,27,17,27,0,12,461,110,135,76,326,95,1170
15000US060070016002,414,130,0,12,0,12,0,12,414,130,76,77,338,122,1171
15000US060070016003,544,166,28,41,0,12,28,41,516,174,176,128,340,137,1172
15000US060070016004,601,130,0,12,0,12,0,12,601,130,92,66,509,134,1173
15000US060070017021,331,115,113,101,113,101,0,12,218,61,125,58,93,59,1174
15000US060070017022,664,121,15,24,0,12,15,24,649,115,224,106,425,130,1175
15000US060070017023,989,153,68,48,31,38,37,34,921,151,361,116,560,148,1176
15000US060070017024,406,89,68,60,30,33,38,51,338,78,156,68,182,66,1177
15000US060070017031,371,78,15,17,15,17,0,12,356,76,60,37,296,71,1178
15000US060070017032,788,95,73,47,0,12,73,47,715,103,342,96,373,96,1179
15000US060070017041,201,77,57,54,37,48,20,22,144,64,71,56,73,40,1180
15000US060070017042,406,64,99,56,41,46,58,48,307,61,101,45,206,61,1181
15000US060070017043,647,103,187,102,112,62,75,80,460,118,180,72,280,113,1182
15000US060070018001,631,97,93,70,41,42,52,55,538,99,287,94,251,85,1183
15000US060070018002,362,117,35,32,35,32,0,12,327,116,75,57,252,125,1184
15000US060070018003,547,126,57,54,28,44,29,33,490,129,310,112,180,80,1185
15000US060070018004,371,106,80,54,57,46,23,28,291,97,30,32,261,101,1186
15000US060070018005,409,120,77,82,10,17,67,80,332,107,81,51,251,102,1187
15000US060070019001,171,37,4,8,4,8,0,12,167,37,70,33,97,40,1188
15000US060070019002,473,68,33,32,33,32,0,12,440,67,193,60,247,74,1189
15000US060070019003,355,82,15,18,8,14,7,11,340,83,96,50,244,92,1190
15000US060070019004,386,81,16,19,16,19,0,12,370,79,160,49,210,70,1191
15000US060070020001,508,109,28,32,0,12,28,32,480,106,200,98,280,102,1192
15000US060070020002,281,84,12,20,0,12,12,20,269,86,98,66,171,77,1193
15000US060070020003,254,63,38,59,38,59,0,12,216,52,52,45,164,57,1194
15000US060070020004,296,70,81,43,30,35,51,43,215,72,58,39,157,63,1195
15000US060070020005,551,103,18,27,18,27,0,12,533,97,235,87,298,91,1196
15000US060070020006,253,92,37,43,37,43,0,12,216,88,62,40,154,87,1197
15000US060070021001,477,212,108,162,63,152,45,73,369,149,229,139,140,92,1198
15000US060070021002,270,108,31,34,31,34,0,12,239,119,119,92,120,84,1199
15000US060070021003,210,60,23,27,23,27,0,12,187,58,84,53,103,52,1200
15000US060070021004,523,124,37,53,0,12,37,53,486,121,231,105,255,100,1201
15000US060070021005,396,108,16,27,0,12,16,27,380,104,86,44,294,107,1202
15000US060070022001,706,142,87,53,45,40,42,41,619,155,341,125,278,129,1203
15000US060070022002,756,103,56,55,56,55,0,12,700,110,151,77,549,126,1204
15000US060070022003,251,66,14,21,14,21,0,12,237,69,103,47,134,72,1205
15000US060070022004,447,105,30,32,30,32,0,12,417,110,128,68,289,106,1206
15000US060070023001,572,114,0,12,0,12,0,12,572,114,183,73,389,116,1207
15000US060070023002,336,81,0,12,0,12,0,12,336,81,73,47,263,85,1208
15000US060070023003,405,132,0,12,0,12,0,12,405,132,244,127,161,103,1209
15000US060070023004,605,124,37,37,37,37,0,12,568,126,224,110,344,119,1210
15000US060070023005,324,75,16,12,10,11,6,9,308,77,89,55,219,70,1211
15000US060070024001,400,66,42,21,32,18,10,11,358,67,109,51,249,65,1212
15000US060070024002,406,77,64,38,28,28,36,28,342,78,133,49,209,68,1213
15000US060070024003,624,122,67,42,0,12,67,42,557,127,284,113,273,93,1214
15000US060070024004,392,71,69,39,46,26,23,25,323,61,134,39,189,51,1215
15000US060070024005,302,99,23,24,4,5,19,24,279,100,61,37,218,108,1216
15000US060070025001,258,90,83,72,29,27,54,69,175,65,88,47,87,57,1217
15000US060070025002,509,110,127,62,47,36,80,54,382,106,116,57,266,99,1218
15000US060070025003,207,84,66,46,9,17,57,50,141,81,73,66,68,56,1219
15000US060070025004,519,81,108,73,16,21,92,68,411,73,155,57,256,69,1220
15000US060070026011,280,68,10,17,0,12,10,17,270,67,103,48,167,58,1221
15000US060070026012,332,69,18,21,9,14,9,15,314,71,177,59,137,54,1222
15000US060070026013,323,66,43,43,9,13,34,41,280,67,63,37,217,64,1223
15000US060070026021,607,95,48,30,18,20,30,29,559,100,178,78,381,90,1224
15000US060070026022,709,101,32,30,0,12,32,30,677,98,202,78,475,95,1225
15000US060070026023,331,87,32,32,14,20,18,25,299,87,94,62,205,80,1226
15000US060070027001,323,79,57,42,34,39,23,40,266,85,107,62,159,75,1227
15000US060070027002,423,139,0,12,0,12,0,12,423,139,106,77,317,135,1228
15000US060070027003,200,99,51,67,10,18,41,65,149,75,40,49,109,75,1229
15000US060070027004,169,65,30,39,18,28,12,24,139,53,21,24,118,52,1230
15000US060070027005,569,119,113,67,80,56,33,37,456,135,140,80,316,117,1231
15000US060070027006,352,125,78,89,61,82,17,34,274,117,89,48,185,124,1232
15000US060070028001,291,79,92,56,17,25,75,52,199,62,103,48,96,49,1233
15000US060070028002,346,93,183,91,32,25,151,88,163,69,108,65,55,37,1234
15000US060070028003,461,86,153,59,110,63,43,34,308,66,127,53,181,61,1235
15000US060070028004,170,67,0,12,0,12,0,12,170,67,46,39,124,62,1236
15000US060070028005,285,89,72,54,72,54,0,12,213,85,65,40,148,79,1237
15000US060070029001,445,61,83,43,67,41,16,16,362,60,80,30,282,60,1238
15000US060070029002,468,64,141,56,53,40,88,47,327,61,179,44,148,49,1239
15000US060070030011,316,97,99,48,91,46,8,13,217,80,119,59,98,51,1240
15000US060070030012,194,64,89,58,42,39,47,44,105,54,53,40,52,39,1241
15000US060070030013,187,84,86,67,55,57,31,36,101,53,77,50,24,26,1242
15000US060070030014,252,91,98,73,54,60,44,56,154,76,69,52,85,68,1243
15000US060070030021,320,86,150,81,66,56,84,59,170,48,63,41,107,40,1244
15000US060070030022,259,70,29,27,29,27,0,12,230,67,85,50,145,61,1245
15000US060070030023,229,60,94,57,49,37,45,48,135,47,66,40,69,35,1246
15000US060070030024,280,78,78,45,58,42,20,18,202,74,141,64,61,51,1247
15000US060070031001,490,80,26,28,26,28,0,12,464,78,136,51,328,81,1248
15000US060070031002,350,78,71,58,18,19,53,54,279,65,84,42,195,63,1249
15000US060070031003,397,95,32,27,0,12,32,27,365,92,93,43,272,98,1250
15000US060070031004,384,78,45,37,22,27,23,24,339,76,142,60,197,60,1251
15000US060070032001,339,86,75,49,50,42,25,25,264,82,122,47,142,70,1252
15000US060070032002,589,100,106,83,75,75,31,37,483,91,186,70,297,94,1253
15000US060070032003,558,106,65,40,46,36,19,21,493,105,208,64,285,100,1254
15000US060070033001,673,87,79,43,32,25,47,36,594,92,193,63,401,84,1255
15000US060070033002,320,71,34,22,27,21,7,8,286,68,150,56,136,51,1256
15000US060070033003,588,99,54,35,46,33,8,12,534,105,292,83,242,77,1257
15000US060070034001,495,64,20,21,9,13,11,16,475,63,195,63,280,73,1258
15000US060070034002,573,69,77,36,37,27,40,24,496,72,128,43,368,72,1259
15000US060070035011,283,76,10,17,0,12,10,17,273,77,84,58,189,69,1260
15000US060070035012,387,113,84,66,33,48,51,51,303,110,82,50,221,112,1261
15000US060070035013,296,84,46,43,0,12,46,43,250,77,105,61,145,70,1262
15000US060070035014,207,60,11,15,11,15,0,12,196,59,29,28,167,63,1263
15000US060070035021,326,55,15,17,0,12,15,17,311,53,155,51,156,61,1264
15000US060070035022,499,121,214,114,76,56,138,97,285,85,95,66,190,85,1265
15000US060070035023,389,99,11,16,0,12,11,16,378,97,86,50,292,101,1266
15000US060070035024,364,89,43,35,22,26,21,23,321,90,128,67,193,88,1267
15000US060070036001,301,59,55,34,11,17,44,30,246,56,101,34,145,49,1268
15000US060070036002,351,61,84,39,32,24,52,34,267,56,112,41,155,49,1269
15000US060070036003,503,79,28,22,5,7,23,21,475,77,174,71,301,69,1270
15000US060070037001,523,106,90,61,36,31,54,60,433,100,184,57,249,82,1271
15000US060070037002,339,92,41,27,41,27,0,12,298,95,169,70,129,68,1272
15000US060070037003,386,85,45,32,27,28,18,16,341,81,171,62,170,83,1273
15000US060070037004,338,109,90,60,37,33,53,50,248,104,87,59,161,83,1274
15000US060090001201,1862,196,94,55,39,47,55,37,1768,196,541,144,1227,153,1275
15000US060090001211,1145,167,21,33,21,33,0,12,1124,173,464,127,660,150,1276
15000US060090001212,892,123,150,79,102,63,48,53,742,126,312,106,430,108,1277
15000US060090001221,946,128,117,75,88,71,29,27,829,118,236,81,593,104,1278
15000US060090001222,213,87,11,17,11,17,0,12,202,89,79,54,123,79,1279
15000US060090001223,497,99,54,62,0,12,54,62,443,97,124,61,319,94,1280
15000US060090002101,1186,187,115,75,31,35,84,76,1071,189,378,119,693,164,1281
15000US060090002102,774,213,72,64,72,64,0,12,702,205,243,133,459,194,1282
15000US060090002103,793,145,40,38,40,38,0,12,753,151,279,114,474,159,1283
15000US060090002104,921,188,18,30,0,12,18,30,903,187,254,135,649,177,1284
15000US060090002201,703,165,120,76,108,68,12,22,583,170,126,74,457,170,1285
15000US060090002202,1389,184,96,98,96,98,0,12,1293,190,432,148,861,179,1286
15000US060090003001,417,141,11,20,11,20,0,12,406,143,115,88,291,120,1287
15000US060090003002,575,168,102,82,83,79,19,28,473,160,255,145,218,106,1288
15000US060090003003,636,174,98,86,37,41,61,76,538,164,164,93,374,156,1289
15000US060090003004,502,148,60,56,10,16,50,61,442,137,99,72,343,124,1290
15000US060090003005,391,172,76,104,76,104,0,12,315,133,167,108,148,90,1291
15000US060090004001,214,74,28,26,0,12,28,26,186,68,40,29,146,65,1292
15000US060090004002,292,74,27,28,27,28,0,12,265,72,131,67,134,70,1293
15000US060090004003,401,104,46,52,46,52,0,12,355,97,146,68,209,83,1294
15000US060090004004,193,66,37,41,20,32,17,26,156,53,54,34,102,52,1295
15000US060090004005,215,66,72,51,49,38,23,37,143,58,34,34,109,50,1296
15000US060090004006,169,68,15,23,0,12,15,23,154,68,27,24,127,70,1297
15000US060090005011,453,114,17,19,0,12,17,19,436,111,146,71,290,112,1298
15000US060090005012,1015,129,66,57,45,51,21,23,949,124,277,88,672,111,1299
15000US060090005031,193,64,0,12,0,12,0,12,193,64,14,17,179,64,1300
15000US060090005032,327,102,48,45,9,14,39,42,279,94,89,53,190,89,1301
15000US060090005033,180,69,0,12,0,12,0,12,180,69,60,30,120,68,1302
15000US060090005041,155,58,40,31,27,23,13,21,115,52,47,37,68,36,1303
15000US060090005042,64,40,0,12,0,12,0,12,64,40,33,32,31,25,1304
15000US060110001001,183,56,23,26,23,26,0,12,160,50,46,40,114,47,1305
15000US060110001002,249,63,29,31,0,12,29,31,220,57,58,37,162,62,1306
15000US060110001003,712,116,61,45,24,31,37,31,651,112,176,71,475,114,1307
15000US060110001004,413,81,0,12,0,12,0,12,413,81,156,68,257,75,1308
15000US060110002001,436,98,62,54,31,34,31,45,374,90,130,73,244,77,1309
15000US060110002002,354,82,34,40,26,39,8,12,320,73,95,63,225,70,1310
15000US060110002003,455,84,34,38,7,11,27,37,421,80,98,41,323,81,1311
15000US060110002004,339,78,49,48,0,12,49,48,290,79,59,47,231,73,1312
15000US060110002005,184,83,73,63,32,39,41,51,111,52,26,35,85,40,1313
15000US060110003001,209,60,4,4,4,4,0,12,205,61,48,31,157,59,1314
15000US060110003002,478,88,32,34,20,29,12,18,446,99,80,52,366,96,1315
15000US060110003003,491,97,83,48,19,24,64,44,408,96,121,66,287,94,1316
15000US060110003004,589,104,70,45,36,32,34,32,519,97,137,69,382,94,1317
15000US060110004001,310,59,30,22,4,6,26,22,280,59,141,53,139,47,1318
15000US060110004002,317,50,25,22,8,13,17,18,292,51,131,40,161,49,1319
15000US060110004003,292,65,29,23,4,5,25,22,263,61,110,47,153,43,1320
15000US060110005001,210,57,61,36,19,24,42,37,149,49,34,22,115,46,1321
15000US060110005002,213,52,29,26,11,16,18,21,184,55,34,24,150,52,1322
15000US060110005003,313,51,33,24,33,24,0,12,280,50,78,39,202,46,1323
15000US060110005004,215,59,32,25,15,23,17,21,183,52,54,29,129,46,1324
15000US060133010001,524,122,33,38,12,17,21,33,491,123,208,101,283,97,1325
15000US060133010002,534,120,10,15,10,15,0,12,524,122,300,117,224,102,1326
15000US060133010003,816,125,31,24,31,24,0,12,785,123,181,69,604,123,1327
15000US060133020051,725,166,43,71,0,12,43,71,682,174,241,151,441,138,1328
15000US060133020052,602,162,55,56,0,12,55,56,547,167,143,77,404,155,1329
15000US060133020053,550,146,32,33,32,33,0,12,518,147,146,80,372,135,1330
15000US060133020054,443,140,37,54,37,54,0,12,406,129,42,51,364,126,1331
15000US060133020061,417,74,16,24,0,12,16,24,401,81,71,65,330,84,1332
15000US060133020062,832,82,64,49,12,20,52,47,768,85,163,57,605,101,1333
15000US060133020071,1139,147,82,55,18,22,64,47,1057,150,277,93,780,153,1334
15000US060133020072,883,140,129,87,40,63,89,63,754,155,225,118,529,132,1335
15000US060133020081,719,149,66,88,12,22,54,84,653,138,169,82,484,124,1336
15000US060133020082,1453,145,122,95,67,56,55,79,1331,169,356,130,975,184,1337
15000US060133020091,848,105,22,25,11,17,11,19,826,109,147,63,679,117,1338
15000US060133020092,1169,119,232,125,127,107,105,84,937,133,182,89,755,129,1339
15000US060133020101,1141,171,0,12,0,12,0,12,1141,171,181,98,960,193,1340
15000US060133020102,716,125,17,28,17,28,0,12,699,126,220,88,479,106,1341
15000US060133020103,443,95,22,35,0,12,22,35,421,98,85,50,336,102,1342
15000US060133020104,913,147,82,67,32,48,50,42,831,150,123,61,708,154,1343
15000US060133031021,1649,143,14,23,0,17,14,23,1635,140,336,125,1299,153,1344
15000US060133031022,819,138,151,92,64,66,87,81,668,139,102,64,566,132,1345
15000US060133031031,675,116,37,34,37,34,0,12,638,126,166,56,472,139,1346
15000US060133031032,848,159,34,53,0,12,34,53,814,158,113,87,701,146,1347
15000US060133031033,747,162,77,81,40,68,37,41,670,142,147,74,523,140,1348
15000US060133031034,1324,165,83,96,29,46,54,85,1241,149,198,81,1043,174,1349
15000US060133032011,975,198,265,197,192,148,73,93,710,146,171,116,539,151,1350
15000US060133032012,934,170,62,66,62,66,0,12,872,172,170,103,702,159,1351
15000US060133032013,1151,128,42,49,20,33,22,36,1109,130,276,134,833,136,1352
15000US060133032021,216,88,18,29,0,12,18,29,198,86,100,60,98,88,1353
15000US060133032022,830,148,41,46,41,46,0,12,789,153,70,59,719,166,1354
15000US060133032023,539,120,0,12,0,12,0,12,539,120,50,41,489,122,1355
15000US060133032024,704,119,0,12,0,12,0,12,704,119,107,62,597,129,1356
15000US060133032031,2927,129,88,84,66,79,22,31,2839,156,845,190,1994,249,1357
15000US060133032041,422,93,27,22,20,20,7,11,395,96,208,81,187,71,1358
15000US060133032042,411,76,69,62,0,12,69,62,342,78,89,46,253,80,1359
15000US060133032043,757,90,41,36,13,20,28,32,716,91,145,55,571,102,1360
15000US060133032051,1976,167,24,22,0,12,24,22,1952,165,762,149,1190,174,1361
15000US060133032052,1306,177,49,54,30,41,19,32,1257,193,204,111,1053,190,1362
15000US060133040011,1412,101,7,13,7,13,0,12,1405,104,302,102,1103,137,1363
15000US060133040021,451,48,17,23,4,7,13,21,434,53,107,44,327,57,1364
15000US060133040031,887,97,0,12,0,12,0,12,887,97,109,47,778,94,1365
15000US060133040032,275,46,0,12,0,12,0,12,275,46,98,47,177,54,1366
15000US060133040033,341,72,10,15,0,12,10,15,331,73,65,30,266,77,1367
15000US060133040041,1094,94,47,55,0,12,47,55,1047,91,178,70,869,105,1368
15000US060133040042,501,75,38,35,9,15,29,31,463,77,92,53,371,86,1369
15000US060133040051,1509,146,41,27,36,26,5,9,1468,151,213,74,1255,151,1370
15000US060133040052,689,125,21,30,3,6,18,30,668,124,57,35,611,124,1371
15000US060133050001,562,137,128,95,128,95,0,12,434,142,174,105,260,129,1372
15000US060133050002,353,144,58,64,36,56,22,35,295,148,162,123,133,96,1373
15000US060133050003,340,137,107,107,87,104,20,32,233,99,15,25,218,97,1374
15000US060133050004,490,121,160,81,80,60,80,64,330,115,100,58,230,103,1375
15000US060133050005,527,149,45,45,26,35,19,30,482,152,216,122,266,110,1376
15000US060133060021,488,83,25,27,0,12,25,27,463,83,82,37,381,83,1377
15000US060133060022,548,92,66,51,13,22,53,46,482,98,213,81,269,105,1378
15000US060133060031,561,102,78,73,20,33,58,65,483,104,45,34,438,108,1379
15000US060133060032,585,117,40,48,11,19,29,44,545,114,177,95,368,119,1380
15000US060133060033,549,107,157,65,0,12,157,65,392,123,202,87,190,83,1381
15000US060133060041,764,107,88,66,27,32,61,56,676,106,297,89,379,93,1382
15000US060133060042,438,97,17,25,9,16,8,16,421,101,131,73,290,98,1383
15000US060133071011,668,119,158,85,158,85,0,12,510,121,263,116,247,93,1384
15000US060133071012,382,106,60,57,34,39,26,39,322,104,87,53,235,106,1385
15000US060133071013,393,89,30,34,18,26,12,20,363,88,97,56,266,71,1386
15000US060133071021,260,77,51,40,4,8,47,39,209,78,76,56,133,65,1387
15000US060133071022,422,120,26,28,26,28,0,12,396,120,98,73,298,120,1388
15000US060133071023,485,126,65,62,0,12,65,62,420,121,147,75,273,110,1389
15000US060133071024,521,108,124,63,81,59,43,28,397,98,110,47,287,91,1390
15000US060133072011,616,83,53,49,35,40,18,26,563,92,163,82,400,103,1391
15000US060133072012,498,91,196,81,86,62,110,64,302,96,106,60,196,80,1392
15000US060133072021,529,102,170,80,74,56,96,65,359,92,145,80,214,80,1393
15000US060133072022,262,90,122,73,19,24,103,66,140,70,40,33,100,68,1394
15000US060133072023,698,110,270,110,66,51,204,98,428,110,152,68,276,105,1395
15000US060133072041,421,87,48,46,14,21,34,37,373,87,117,53,256,74,1396
15000US060133072042,278,66,6,10,0,12,6,10,272,68,117,60,155,59,1397
15000US060133072043,540,80,58,33,33,27,25,23,482,82,202,72,280,88,1398
15000US060133072051,662,148,0,12,0,12,0,12,662,148,253,129,409,132,1399
15000US060133072052,789,187,240,104,52,68,188,101,549,165,299,144,250,110,1400
15000US060133072053,422,131,0,12,0,12,0,12,422,131,226,137,196,86,1401
15000US060133072054,620,165,32,40,12,20,20,35,588,165,125,71,463,169,1402
15000US060133080011,628,157,59,57,59,57,0,12,569,159,279,141,290,111,1403
15000US060133080012,913,137,30,53,30,53,0,12,883,129,277,116,606,142,1404
15000US060133080013,523,124,30,36,12,19,18,30,493,126,171,93,322,127,1405
15000US060133080014,367,119,20,30,0,12,20,30,347,118,118,75,229,118,1406
15000US060133080021,898,122,120,66,85,62,35,38,778,127,189,92,589,109,1407
15000US060133080022,499,80,14,20,2,7,12,19,485,79,144,58,341,79,1408
15000US060133090001,1021,85,215,80,62,50,153,63,806,110,246,81,560,103,1409
15000US060133090002,230,57,29,30,0,12,29,30,201,55,87,55,114,49,1410
15000US060133100001,447,102,82,70,20,22,62,65,365,83,158,68,207,73,1411
15000US060133100002,313,104,62,44,12,20,50,37,251,95,138,64,113,87,1412
15000US060133100003,943,111,328,121,188,98,140,69,615,129,275,109,340,96,1413
15000US060133110001,358,82,45,44,0,12,45,44,313,76,63,53,250,69,1414
15000US060133110002,473,88,129,61,71,46,58,42,344,89,145,53,199,71,1415
15000US060133110003,653,96,160,86,64,53,96,71,493,97,236,95,257,79,1416
15000US060133120001,781,58,220,59,108,46,112,38,561,71,255,61,306,71,1417
15000US060133131011,501,123,60,54,60,54,0,12,441,114,140,81,301,123,1418
15000US060133131012,766,160,52,54,35,47,17,27,714,159,262,110,452,133,1419
15000US060133131013,826,146,144,76,89,71,55,50,682,131,283,104,399,130,1420
15000US060133131014,496,153,118,97,48,52,70,77,378,137,69,78,309,117,1421
15000US060133131021,901,127,113,98,27,28,86,88,788,140,148,77,640,138,1422
15000US060133131022,571,120,66,57,37,36,29,45,505,127,225,70,280,127,1423
15000US060133131031,1776,138,151,118,79,86,72,79,1625,182,423,134,1202,193,1424
15000US060133131032,451,80,33,25,12,18,21,19,418,80,183,67,235,81,1425
15000US060133131033,413,87,61,53,43,44,18,29,352,89,146,86,206,63,1426
15000US060133132031,457,58,37,23,18,23,19,19,420,56,92,32,328,60,1427
15000US060133132032,187,45,20,26,0,12,20,26,167,45,22,18,145,44,1428
15000US060133132033,270,62,25,25,16,22,9,9,245,55,71,33,174,51,1429
15000US060133132041,615,85,117,65,0,12,117,65,498,101,136,75,362,98,1430
15000US060133132042,564,100,26,25,7,12,19,22,538,100,77,38,461,103,1431
15000US060133132043,529,105,29,24,19,18,10,16,500,109,192,81,308,98,1432
15000US060133132051,506,34,4,6,4,6,0,12,502,34,108,39,394,39,1433
15000US060133132061,415,98,14,16,0,12,14,16,401,100,134,75,267,82,1434
15000US060133132062,784,106,239,103,137,83,102,81,545,114,122,66,423,106,1435
15000US060133132063,393,84,0,12,0,12,0,12,393,84,106,51,287,81,1436
15000US060133141021,531,101,160,92,63,66,97,71,371,92,97,55,274,90,1437
15000US060133141022,287,74,42,43,13,20,29,37,245,74,137,60,108,50,1438
15000US060133141023,844,98,98,62,61,50,37,45,746,99,97,49,649,99,1439
15000US060133141031,665,98,181,68,104,64,77,42,484,90,155,71,329,92,1440
15000US060133141032,425,78,62,48,58,47,4,9,363,71,115,58,248,59,1441
15000US060133141033,663,93,234,76,80,57,154,60,429,100,75,38,354,95,1442
15000US060133141041,665,175,168,160,90,98,78,115,497,156,134,85,363,132,1443
15000US060133141042,917,184,85,82,40,66,45,42,832,190,259,158,573,167,1444
15000US060133141043,470,150,13,21,0,12,13,21,457,154,162,103,295,145,1445
15000US060133141044,395,105,129,77,0,12,129,77,266,113,99,78,167,88,1446
15000US060133142001,539,111,84,39,14,17,70,38,455,114,48,57,407,111,1447
15000US060133142002,726,126,84,69,20,32,64,63,642,111,277,108,365,100,1448
15000US060133142003,465,85,65,55,40,42,25,37,400,86,203,82,197,73,1449
15000US060133150001,333,78,4,13,4,13,0,12,329,78,23,24,306,76,1450
15000US060133150002,882,89,51,41,5,10,46,38,831,93,210,79,621,108,1451
15000US060133160001,465,39,53,33,25,24,28,19,412,49,188,57,224,55,1452
15000US060133170001,542,84,0,12,0,12,0,12,542,84,137,80,405,96,1453
15000US060133170002,532,86,41,53,6,10,35,52,491,87,104,63,387,91,1454
15000US060133180001,432,81,40,41,20,26,20,32,392,72,35,27,357,76,1455
15000US060133180002,514,94,14,21,14,21,0,12,500,97,112,54,388,92,1456
15000US060133180003,529,74,42,36,33,33,9,14,487,78,81,39,406,88,1457
15000US060133190001,415,93,25,31,8,16,17,27,390,90,182,92,208,84,1458
15000US060133190002,773,113,163,99,69,71,94,89,610,133,130,82,480,133,1459
15000US060133190003,599,140,73,85,54,82,19,31,526,130,125,70,401,124,1460
15000US060133190004,198,90,12,20,0,12,12,20,186,89,18,30,168,84,1461
15000US060133190005,352,84,0,12,0,12,0,12,352,84,47,52,305,78,1462
15000US060133190006,825,158,16,25,0,12,16,25,809,159,156,94,653,176,1463
15000US060133200011,459,88,60,56,53,54,7,14,399,82,158,67,241,79,1464
15000US060133200012,795,97,138,74,98,59,40,41,657,104,162,72,495,114,1465
15000US060133200031,1064,38,24,24,16,20,8,13,1040,47,157,49,883,64,1466
15000US060133200041,1207,157,27,34,0,12,27,34,1180,157,282,144,898,146,1467
15000US060133200042,724,162,36,40,18,29,18,28,688,169,121,75,567,167,1468
15000US060133200043,611,102,23,28,23,28,0,12,588,106,48,45,540,114,1469
15000US060133211011,824,125,112,75,96,75,16,29,712,124,128,86,584,135,1470
15000US060133211012,429,87,20,30,5,15,15,27,409,88,90,52,319,94,1471
15000US060133211013,709,119,8,14,0,12,8,14,701,119,156,83,545,139,1472
15000US060133211014,617,118,25,27,9,18,16,24,592,121,138,84,454,126,1473
15000US060133211021,425,81,0,12,0,12,0,12,425,81,63,45,362,94,1474
15000US060133211022,691,98,0,12,0,12,0,12,691,98,41,38,650,104,1475
15000US060133211023,562,80,0,12,0,12,0,12,562,80,100,77,462,72,1476
15000US060133211024,997,109,13,22,0,12,13,22,984,114,169,103,815,126,1477
15000US060133211031,810,80,0,12,0,12,0,12,810,80,144,55,666,78,1478
15000US060133211032,678,81,9,14,9,14,0,12,669,80,100,44,569,83,1479
15000US060133211033,295,57,0,12,0,12,0,12,295,57,75,37,220,72,1480
15000US060133212001,559,131,82,69,25,41,57,55,477,119,174,108,303,95,1481
15000US060133212002,1002,146,38,43,25,38,13,21,964,155,206,80,758,159,1482
15000US060133212003,618,150,0,12,0,12,0,12,618,150,95,70,523,132,1483
15000US060133220001,338,70,102,81,38,34,64,83,236,67,46,39,190,66,1484
15000US060133220002,275,70,13,20,13,20,0,12,262,72,45,34,217,80,1485
15000US060133220003,1010,117,0,12,0,12,0,12,1010,117,303,106,707,137,1486
15000US060133220004,576,99,0,12,0,12,0,12,576,99,108,60,468,103,1487
15000US060133220005,257,64,0,12,0,12,0,12,257,64,75,64,182,67,1488
15000US060133230001,455,65,8,14,0,12,8,14,447,65,86,43,361,76,1489
15000US060133230002,357,64,16,18,0,12,16,18,341,63,18,21,323,62,1490
15000US060133230003,547,72,10,14,0,12,10,14,537,76,124,61,413,75,1491
15000US060133230004,355,54,10,17,0,12,10,17,345,54,95,43,250,62,1492
15000US060133240011,239,92,17,27,0,12,17,27,222,89,0,12,222,89,1493
15000US060133240012,1069,148,32,37,18,27,14,22,1037,149,219,76,818,157,1494
15000US060133240013,1362,207,17,29,0,12,17,29,1345,209,88,64,1257,209,1495
15000US060133240014,324,123,0,12,0,12,0,12,324,123,75,54,249,129,1496
15000US060133240021,876,139,15,24,0,12,15,24,861,140,240,89,621,147,1497
15000US060133240022,530,124,0,12,0,12,0,12,530,124,96,70,434,124,1498
15000US060133240023,1014,159,38,47,38,47,0,12,976,162,194,75,782,175,1499
15000US060133250001,525,116,0,12,0,12,0,12,525,116,197,97,328,114,1500
15000US060133250002,377,98,14,22,4,11,10,18,363,96,132,57,231,94,1501
15000US060133250003,547,97,0,12,0,12,0,12,547,97,71,63,476,107,1502
15000US060133250004,411,90,0,12,0,12,0,12,411,90,148,68,263,91,1503
15000US060133250005,301,69,0,12,0,12,0,12,301,69,29,32,272,81,1504
15000US060133260001,929,80,0,12,0,12,0,12,929,80,336,82,593,91,1505
15000US060133260002,416,57,0,12,0,12,0,12,416,57,47,31,369,65,1506
15000US060133270001,898,164,32,39,0,12,32,39,866,163,217,102,649,149,1507
15000US060133270002,197,106,37,43,37,43,0,12,160,109,104,97,56,50,1508
15000US060133270003,601,165,74,92,74,92,0,12,527,156,64,47,463,163,1509
15000US060133270004,383,127,53,60,0,12,53,60,330,122,58,45,272,113,1510
15000US060133270005,758,161,79,75,16,25,63,75,679,176,172,108,507,174,1511
15000US060133280001,597,85,29,25,14,18,15,24,568,89,296,91,272,83,1512
15000US060133280002,858,89,16,18,16,18,0,12,842,91,255,87,587,95,1513
15000US060133290001,475,146,0,12,0,12,0,12,475,146,115,55,360,137,1514
15000US060133290002,660,131,27,23,12,19,15,24,633,133,178,101,455,145,1515
15000US060133290003,385,126,0,12,0,12,0,12,385,126,16,26,369,124,1516
15000US060133290004,642,135,89,75,46,54,43,66,553,135,136,98,417,130,1517
15000US060133300001,382,75,7,11,7,11,0,12,375,75,93,45,282,87,1518
15000US060133300002,623,89,80,54,31,23,49,49,543,93,183,70,360,75,1519
15000US060133300003,342,57,46,45,46,45,0,12,296,61,61,48,235,56,1520
15000US060133300004,531,95,0,12,0,12,0,12,531,95,159,73,372,89,1521
15000US060133310001,329,96,60,53,0,12,60,53,269,82,115,59,154,62,1522
15000US060133310002,585,110,16,24,0,12,16,24,569,114,114,66,455,129,1523
15000US060133310003,381,84,0,12,0,12,0,12,381,84,99,64,282,90,1524
15000US060133310004,387,136,93,106,74,107,19,29,294,101,92,54,202,96,1525
15000US060133310005,570,103,60,72,46,68,14,22,510,98,103,58,407,90,1526
15000US060133310006,540,130,54,64,0,12,54,64,486,135,40,34,446,146,1527
15000US060133320001,731,100,0,12,0,12,0,12,731,100,222,83,509,114,1528
15000US060133320002,300,76,0,12,0,12,0,12,300,76,117,66,183,75,1529
15000US060133320003,467,108,0,12,0,12,0,12,467,108,47,44,420,121,1530
15000US060133320004,477,95,21,36,21,36,0,12,456,103,143,79,313,94,1531
15000US060133320005,324,86,36,41,36,41,0,12,288,89,91,57,197,92,1532
15000US060133320006,336,127,82,104,82,104,0,12,254,73,70,56,184,67,1533
15000US060133320007,264,98,32,41,0,12,32,41,232,97,79,103,153,82,1534
15000US060133331011,295,72,17,19,9,14,8,13,278,74,120,54,158,66,1535
15000US060133331012,740,82,46,50,0,12,46,50,694,91,169,66,525,87,1536
15000US060133331013,477,77,88,60,72,59,16,19,389,75,175,73,214,65,1537
15000US060133331021,478,74,0,12,0,12,0,12,478,74,154,60,324,74,1538
15000US060133331022,335,85,3,8,3,8,0,12,332,85,97,47,235,85,1539
15000US060133331023,695,103,13,20,0,12,13,20,682,102,79,37,603,99,1540
15000US060133332001,210,78,0,12,0,12,0,12,210,78,53,50,157,77,1541
15000US060133332002,353,90,0,12,0,12,0,12,353,90,54,43,299,88,1542
15000US060133332003,562,116,0,12,0,12,0,12,562,116,145,70,417,120,1543
15000US060133332004,500,146,0,12,0,12,0,12,500,146,0,12,500,146,1544
15000US060133332005,631,126,59,62,26,41,33,47,572,130,107,77,465,130,1545
15000US060133340011,804,117,28,32,0,12,28,32,776,115,276,77,500,105,1546
15000US060133340012,745,110,21,23,0,12,21,23,724,112,145,80,579,108,1547
15000US060133340041,704,147,67,58,45,54,22,26,637,145,115,76,522,145,1548
15000US060133340042,808,144,15,23,15,23,0,12,793,146,201,104,592,140,1549
15000US060133340043,1118,177,92,68,74,63,18,30,1026,182,362,152,664,150,1550
15000US060133340044,471,88,10,20,10,20,0,12,461,92,87,50,374,91,1551
15000US060133340061,344,68,0,12,0,12,0,12,344,68,42,30,302,68,1552
15000US060133340062,911,74,0,12,0,12,0,12,911,74,155,62,756,96,1553
15000US060133340063,421,59,0,12,0,12,0,12,421,59,98,57,323,65,1554
15000US060133342001,561,98,0,12,0,12,0,12,561,98,57,47,504,114,1555
15000US060133342002,510,129,0,12,0,12,0,12,510,129,111,72,399,145,1556
15000US060133342003,1012,138,0,12,0,12,0,12,1012,138,231,95,781,136,1557
15000US060133342004,271,72,0,12,0,12,0,12,271,72,0,12,271,72,1558
15000US060133342005,427,77,0,12,0,12,0,12,427,77,73,54,354,79,1559
15000US060133350001,521,86,10,15,10,15,0,12,511,87,146,59,365,94,1560
15000US060133350002,460,76,49,56,13,21,36,52,411,90,76,44,335,88,1561
15000US060133350003,255,70,14,23,0,12,14,23,241,70,38,30,203,68,1562
15000US060133361011,524,104,26,24,16,17,10,17,498,103,124,64,374,114,1563
15000US060133361012,583,104,107,70,0,12,107,70,476,111,64,60,412,109,1564
15000US060133361013,399,98,61,44,15,17,46,41,338,95,54,43,284,102,1565
15000US060133361021,680,143,101,78,31,37,70,67,579,144,110,89,469,142,1566
15000US060133361022,643,154,206,136,22,37,184,133,437,154,150,96,287,139,1567
15000US060133361023,540,170,205,115,46,62,159,103,335,125,169,101,166,88,1568
15000US060133361024,766,146,41,49,25,42,16,25,725,148,313,126,412,131,1569
15000US060133362011,509,95,40,38,40,38,0,12,469,88,155,60,314,87,1570
15000US060133362012,407,81,64,58,64,58,0,12,343,80,122,63,221,73,1571
15000US060133362013,282,68,58,51,0,12,58,51,224,75,96,48,128,63,1572
15000US060133362021,833,115,193,88,14,20,179,84,640,100,98,42,542,104,1573
15000US060133362022,241,85,42,36,14,20,28,34,199,83,94,71,105,62,1574
15000US060133362023,622,114,137,74,17,24,120,74,485,130,59,60,426,127,1575
15000US060133371001,603,90,0,12,0,12,0,12,603,90,179,59,424,85,1576
15000US060133371002,641,85,0,12,0,12,0,12,641,85,197,74,444,91,1577
15000US060133372001,305,121,26,32,0,12,26,32,279,116,81,83,198,93,1578
15000US060133372002,880,140,125,79,50,49,75,58,755,158,266,129,489,171,1579
15000US060133372003,419,136,54,72,12,19,42,70,365,132,124,86,241,108,1580
15000US060133372004,225,64,17,29,17,29,0,12,208,67,12,19,196,68,1581
15000US060133372005,519,107,32,52,0,12,32,52,487,105,62,48,425,105,1582
15000US060133372006,675,137,0,12,0,12,0,12,675,137,62,48,613,139,1583
15000US060133373001,398,79,0,12,0,12,0,12,398,79,147,76,251,81,1584
15000US060133373002,599,119,18,30,14,27,4,11,581,126,155,92,426,127,1585
15000US060133373003,276,85,0,12,0,12,0,12,276,85,95,66,181,80,1586
15000US060133373004,267,72,15,23,15,23,0,12,252,76,36,45,216,71,1587
15000US060133373005,266,51,0,12,0,12,0,12,266,51,51,42,215,61,1588
15000US060133373006,473,109,0,12,0,12,0,12,473,109,175,106,298,105,1589
15000US060133381011,303,64,42,34,21,25,21,22,261,70,115,58,146,66,1590
15000US060133381012,271,76,14,22,0,12,14,22,257,81,57,44,200,78,1591
15000US060133381013,1181,108,217,94,114,76,103,62,964,130,303,109,661,131,1592
15000US060133381021,458,79,0,12,0,12,0,12,458,79,155,79,303,75,1593
15000US060133381022,230,56,0,12,0,12,0,12,230,56,26,30,204,59,1594
15000US060133381023,685,82,21,29,0,12,21,29,664,80,98,41,566,81,1595
15000US060133382011,772,61,8,13,8,13,0,12,764,62,147,57,617,74,1596
15000US060133382012,626,64,38,46,9,14,29,43,588,64,170,77,418,90,1597
15000US060133382031,1054,120,0,12,0,12,0,12,1054,120,108,66,946,145,1598
15000US060133382032,1192,183,44,47,44,47,0,12,1148,186,89,56,1059,193,1599
15000US060133382033,417,65,0,12,0,12,0,12,417,65,96,61,321,68,1600
15000US060133382041,1047,131,0,12,0,12,0,12,1047,131,142,71,905,146,1601
15000US060133382042,390,114,0,12,0,12,0,12,390,114,26,28,364,116,1602
15000US060133382043,582,90,15,24,0,12,15,24,567,93,99,60,468,100,1603
15000US060133382044,673,121,11,19,11,19,0,12,662,123,179,90,483,135,1604
15000US060133383011,544,64,0,12,0,12,0,12,544,64,165,62,379,64,1605
15000US060133383012,527,67,0,12,0,12,0,12,527,67,186,62,341,66,1606
15000US060133383021,729,93,0,12,0,12,0,12,729,93,133,54,596,97,1607
15000US060133383022,522,104,0,12,0,12,0,12,522,104,179,104,343,91,1608
15000US060133383023,868,119,34,37,0,12,34,37,834,123,133,71,701,133,1609
15000US060133390011,973,114,6,10,6,10,0,12,967,113,140,78,827,119,1610
15000US060133390012,848,101,24,23,9,14,15,18,824,104,83,58,741,116,1611
15000US060133390021,808,157,50,74,50,74,0,12,758,159,177,83,581,161,1612
15000US060133390022,930,156,64,63,27,43,37,44,866,163,187,137,679,148,1613
15000US060133390023,1335,199,101,110,0,12,101,110,1234,217,403,161,831,180,1614
15000US060133390024,457,124,43,55,0,12,43,55,414,115,105,73,309,105,1615
15000US060133400011,220,65,0,12,0,12,0,12,220,65,27,33,193,68,1616
15000US060133400012,883,151,27,28,13,20,14,21,856,149,115,99,741,144,1617
15000US060133400013,692,164,58,87,0,12,58,87,634,147,98,88,536,151,1618
15000US060133400014,594,151,31,36,0,12,31,36,563,155,252,143,311,92,1619
15000US060133400021,364,77,0,12,0,12,0,12,364,77,61,55,303,80,1620
15000US060133400022,278,65,0,12,0,12,0,12,278,65,73,61,205,58,1621
15000US060133400023,677,113,0,12,0,12,0,12,677,113,29,33,648,119,1622
15000US060133400024,649,122,28,34,16,25,12,22,621,122,77,65,544,132,1623
15000US060133400025,240,86,0,12,0,12,0,12,240,86,33,38,207,82,1624
15000US060133400026,728,127,13,21,13,21,0,12,715,130,88,57,627,142,1625
15000US060133410001,681,88,0,12,0,12,0,12,681,88,112,55,569,107,1626
15000US060133410002,493,79,0,12,0,12,0,12,493,79,14,22,479,78,1627
15000US060133410003,934,116,32,37,0,12,32,37,902,109,65,60,837,126,1628
15000US060133430011,306,61,0,12,0,12,0,12,306,61,73,49,233,69,1629
15000US060133430012,275,69,11,20,0,12,11,20,264,71,48,55,216,78,1630
15000US060133430013,868,121,54,44,37,41,17,27,814,126,212,109,602,124,1631
15000US060133430014,645,96,14,25,0,12,14,25,631,99,244,92,387,109,1632
15000US060133430021,934,119,15,24,15,24,0,12,919,124,104,55,815,130,1633
15000US060133430022,960,130,0,12,0,12,0,12,960,130,184,66,776,114,1634
15000US060133430031,820,93,0,12,0,12,0,12,820,93,129,58,691,97,1635
15000US060133430032,666,86,12,18,0,12,12,18,654,88,149,91,505,104,1636
15000US060133451011,250,53,0,12,0,12,0,12,250,53,111,71,139,74,1637
15000US060133451012,629,96,0,12,0,12,0,12,629,96,89,57,540,113,1638
15000US060133451013,241,78,0,12,0,12,0,12,241,78,26,30,215,77,1639
15000US060133451014,731,107,5,12,5,12,0,12,726,109,29,38,697,117,1640
15000US060133451021,346,65,0,12,0,12,0,12,346,65,71,45,275,66,1641
15000US060133451022,568,60,7,12,0,12,7,12,561,62,112,55,449,70,1642
15000US060133451023,303,51,0,12,0,12,0,12,303,51,31,29,272,53,1643
15000US060133451031,726,71,18,20,18,20,0,12,708,73,243,86,465,71,1644
15000US060133451032,320,56,0,12,0,12,0,12,320,56,61,34,259,62,1645
15000US060133451033,718,68,0,12,0,12,0,12,718,68,81,39,637,78,1646
15000US060133451051,1110,133,0,12,0,12,0,12,1110,133,300,110,810,130,1647
15000US060133451052,457,68,0,12,0,12,0,12,457,68,104,58,353,73,1648
15000US060133451053,252,65,0,12,0,12,0,12,252,65,51,45,201,63,1649
15000US060133451054,427,85,0,12,0,12,0,12,427,85,84,57,343,99,1650
15000US060133451081,896,103,17,27,0,12,17,27,879,104,131,67,748,124,1651
15000US060133451082,1044,127,13,22,0,12,13,22,1031,129,74,54,957,146,1652
15000US060133451083,681,127,0,12,0,12,0,12,681,127,71,47,610,129,1653
15000US060133451084,511,85,0,12,0,12,0,12,511,85,46,46,465,84,1654
15000US060133451111,491,62,0,12,0,12,0,12,491,62,105,56,386,65,1655
15000US060133451112,1101,87,10,15,0,12,10,15,1091,89,75,54,1016,110,1656
15000US060133451113,273,62,0,12,0,12,0,12,273,62,16,14,257,62,1657
15000US060133451121,855,139,0,12,0,12,0,12,855,139,67,50,788,140,1658
15000US060133451122,1223,149,15,26,0,12,15,26,1208,152,101,58,1107,164,1659
15000US060133451131,547,62,0,12,0,12,0,12,547,62,84,45,463,67,1660
15000US060133451132,900,67,8,13,8,13,0,12,892,67,95,48,797,75,1661
15000US060133451141,538,97,0,12,0,12,0,12,538,97,94,53,444,111,1662
15000US060133451142,697,127,0,12,0,12,0,12,697,127,113,59,584,129,1663
15000US060133451143,1045,114,0,12,0,12,0,12,1045,114,194,71,851,129,1664
15000US060133451144,276,55,0,12,0,12,0,12,276,55,63,55,213,64,1665
15000US060133451151,1344,81,0,12,0,12,0,12,1344,81,161,66,1183,84,1666
15000US060133451152,551,75,0,12,0,12,0,12,551,75,107,44,444,77,1667
15000US060133451161,367,43,0,12,0,12,0,12,367,43,96,39,271,45,1668
15000US060133451162,531,44,6,10,6,10,0,12,525,44,64,29,461,47,1669
15000US060133452021,1245,150,0,12,0,12,0,12,1245,150,246,100,999,167,1670
15000US060133452022,867,139,29,33,0,12,29,33,838,139,19,33,819,141,1671
15000US060133452023,1007,171,0,12,0,12,0,12,1007,171,186,91,821,162,1672
15000US060133452031,957,125,0,12,0,12,0,12,957,125,115,65,842,132,1673
15000US060133452032,441,99,0,12,0,12,0,12,441,99,143,66,298,97,1674
15000US060133452033,437,118,13,21,13,21,0,12,424,117,132,95,292,132,1675
15000US060133452034,821,147,0,12,0,12,0,12,821,147,118,82,703,139,1676
15000US060133452041,751,76,8,12,8,12,0,12,743,73,130,49,613,76,1677
15000US060133452042,501,61,0,12,0,12,0,12,501,61,62,38,439,62,1678
15000US060133461011,885,70,8,13,0,12,8,13,877,71,85,44,792,67,1679
15000US060133461012,416,71,0,12,0,12,0,12,416,71,68,50,348,67,1680
15000US060133461021,648,95,0,12,0,12,0,12,648,95,152,74,496,85,1681
15000US060133461022,1079,104,0,12,0,12,0,12,1079,104,136,59,943,110,1682
15000US060133461023,271,52,0,12,0,12,0,12,271,52,55,47,216,45,1683
15000US060133462011,511,88,0,12,0,12,0,12,511,88,103,57,408,105,1684
15000US060133462012,772,135,16,25,16,25,0,12,756,137,115,65,641,130,1685
15000US060133462013,1082,149,0,12,0,12,0,12,1082,149,345,162,737,123,1686
15000US060133462014,386,74,0,12,0,12,0,12,386,74,49,44,337,82,1687
15000US060133462031,991,88,0,12,0,12,0,12,991,88,146,58,845,91,1688
15000US060133462032,386,60,0,12,0,12,0,12,386,60,109,43,277,57,1689
15000US060133462041,1048,121,0,12,0,12,0,12,1048,121,114,61,934,129,1690
15000US060133462042,779,99,0,12,0,12,0,12,779,99,71,41,708,106,1691
15000US060133462043,693,114,15,23,15,23,0,12,678,116,69,77,609,115,1692
15000US060133470001,954,112,0,12,0,12,0,12,954,112,169,109,785,129,1693
15000US060133470002,752,103,12,20,0,12,12,20,740,102,147,59,593,111,1694
15000US060133470003,676,101,37,39,28,40,9,15,639,101,92,90,547,103,1695
15000US060133480001,293,46,0,12,0,12,0,12,293,46,44,34,249,48,1696
15000US060133480002,717,79,0,12,0,12,0,12,717,79,143,47,574,80,1697
15000US060133480003,658,79,8,13,8,13,0,12,650,79,68,35,582,81,1698
15000US060133490001,892,110,0,12,0,12,0,12,892,110,152,93,740,101,1699
15000US060133490002,578,90,15,16,6,10,9,14,563,94,104,66,459,85,1700
15000US060133490003,571,88,10,15,0,12,10,15,561,88,53,31,508,89,1701
15000US060133500001,914,134,38,43,18,29,20,32,876,141,80,54,796,142,1702
15000US060133500002,423,105,0,12,0,12,0,12,423,105,18,25,405,110,1703
15000US060133500003,538,79,0,12,0,12,0,12,538,79,112,89,426,95,1704
15000US060133500004,716,130,0,12,0,12,0,12,716,130,92,56,624,134,1705
15000US060133511011,677,72,0,12,0,12,0,12,677,72,171,57,506,82,1706
15000US060133511012,286,53,0,12,0,12,0,12,286,53,51,31,235,61,1707
15000US060133511013,963,67,0,12,0,12,0,12,963,67,351,77,612,90,1708
15000US060133511021,1333,121,15,23,15,23,0,12,1318,128,562,129,756,143,1709
15000US060133511022,508,81,0,12,0,12,0,12,508,81,201,90,307,78,1710
15000US060133511023,856,103,0,12,0,12,0,12,856,103,337,101,519,110,1711
15000US060133511031,541,59,0,12,0,12,0,12,541,59,187,59,354,63,1712
15000US060133511032,735,72,0,12,0,12,0,12,735,72,338,74,397,77,1713
15000US060133512001,460,73,0,12,0,12,0,12,460,73,44,36,416,76,1714
15000US060133512002,785,92,0,12,0,12,0,12,785,92,93,49,692,99,1715
15000US060133512003,887,113,0,12,0,12,0,12,887,113,89,58,798,118,1716
15000US060133521011,609,62,0,12,0,12,0,12,609,62,80,50,529,61,1717
15000US060133521012,188,30,0,12,0,12,0,12,188,30,42,25,146,31,1718
15000US060133521021,445,66,0,12,0,12,0,12,445,66,88,43,357,73,1719
15000US060133521022,336,52,0,12,0,12,0,12,336,52,67,35,269,51,1720
15000US060133521023,741,68,0,12,0,12,0,12,741,68,161,73,580,81,1721
15000US060133521024,266,52,0,12,0,12,0,12,266,52,30,25,236,59,1722
15000US060133522011,1120,129,0,12,0,12,0,12,1120,129,31,37,1089,133,1723
15000US060133522012,432,61,0,12,0,12,0,12,432,61,84,55,348,75,1724
15000US060133522013,790,104,0,12,0,12,0,12,790,104,160,80,630,117,1725
15000US060133522021,1032,51,15,16,5,7,10,14,1017,53,145,57,872,76,1726
15000US060133530011,500,54,0,12,0,12,0,12,500,54,162,50,338,72,1727
15000US060133530012,817,79,0,12,0,12,0,12,817,79,153,55,664,86,1728
15000US060133530021,279,49,0,12,0,12,0,12,279,49,42,28,237,49,1729
15000US060133530022,478,59,0,12,0,12,0,12,478,59,91,35,387,64,1730
15000US060133530023,476,68,0,12,0,12,0,12,476,68,11,17,465,69,1731
15000US060133530024,300,51,0,12,0,12,0,12,300,51,81,40,219,49,1732
15000US060133540011,731,40,19,17,6,9,13,14,712,40,88,36,624,42,1733
15000US060133540021,1056,117,0,12,0,12,0,12,1056,117,200,98,856,144,1734
15000US060133540022,293,70,0,12,0,12,0,12,293,70,29,33,264,75,1735
15000US060133540023,527,97,0,12,0,12,0,12,527,97,72,43,455,102,1736
15000US060133540024,719,111,24,31,0,12,24,31,695,114,182,92,513,114,1737
15000US060133551071,1205,88,52,64,52,64,0,12,1153,99,278,90,875,121,1738
15000US060133551072,499,81,50,53,11,17,39,50,449,81,95,58,354,73,1739
15000US060133551081,1282,212,77,97,77,97,0,12,1205,197,380,150,825,199,1740
15000US060133551082,1381,243,173,122,53,57,120,108,1208,234,293,134,915,233,1741
15000US060133551083,1062,217,72,62,20,31,52,51,990,220,341,136,649,207,1742
15000US060133551091,1041,124,65,64,18,30,47,62,976,123,268,114,708,146,1743
15000US060133551092,232,96,40,62,0,12,40,62,192,78,0,12,192,78,1744
15000US060133551093,945,140,182,119,109,78,73,85,763,137,268,118,495,145,1745
15000US060133551101,585,130,74,66,74,66,0,12,511,121,68,47,443,118,1746
15000US060133551102,527,136,106,68,87,67,19,22,421,133,94,61,327,114,1747
15000US060133551111,1091,102,121,85,54,53,67,68,970,111,143,62,827,112,1748
15000US060133551112,832,123,66,68,18,24,48,64,766,120,199,85,567,110,1749
15000US060133551121,468,103,40,58,40,58,0,12,428,109,50,49,378,111,1750
15000US060133551122,665,105,0,12,0,12,0,12,665,105,35,41,630,111,1751
15000US060133551123,961,132,0,12,0,12,0,12,961,132,222,92,739,151,1752
15000US060133551131,654,78,8,14,8,14,0,12,646,80,80,39,566,80,1753
15000US060133551132,631,71,0,12,0,12,0,12,631,71,63,35,568,72,1754
15000US060133551133,422,77,0,12,0,12,0,12,422,77,35,49,387,76,1755
15000US060133551141,629,97,0,12,0,12,0,12,629,97,258,105,371,78,1756
15000US060133551142,811,138,0,12,0,12,0,12,811,138,61,42,750,143,1757
15000US060133551143,2021,151,21,33,0,17,21,33,2000,151,195,97,1805,165,1758
15000US060133551151,2514,73,148,83,24,31,124,84,2366,113,299,124,2067,154,1759
15000US060133551161,2167,49,15,24,0,17,15,24,2152,53,62,37,2090,66,1760
15000US060133551171,1902,100,0,17,0,17,0,17,1902,100,56,32,1846,103,1761
15000US060133552001,678,154,0,12,0,12,0,12,678,154,178,145,500,126,1762
15000US060133552002,2014,145,122,99,97,92,25,39,1892,175,435,154,1457,205,1763
15000US060133553011,1137,124,0,12,0,12,0,12,1137,124,99,63,1038,138,1764
15000US060133553012,567,117,0,12,0,12,0,12,567,117,185,121,382,102,1765
15000US060133553013,716,142,30,34,0,12,30,34,686,147,140,97,546,148,1766
15000US060133553014,450,79,0,12,0,12,0,12,450,79,31,32,419,78,1767
15000US060133553021,299,54,0,12,0,12,0,12,299,54,86,44,213,55,1768
15000US060133553022,394,64,0,12,0,12,0,12,394,64,75,44,319,70,1769
15000US060133553023,505,63,21,31,0,12,21,31,484,65,52,31,432,63,1770
15000US060133553041,850,133,0,12,0,12,0,12,850,133,133,76,717,157,1771
15000US060133553042,600,107,0,12,0,12,0,12,600,107,257,106,343,92,1772
15000US060133553043,371,93,0,12,0,12,0,12,371,93,36,29,335,99,1773
15000US060133553044,974,120,25,38,0,12,25,38,949,125,270,125,679,124,1774
15000US060133553045,370,86,13,22,13,22,0,12,357,90,24,29,333,99,1775
15000US060133553061,361,80,19,29,0,12,19,29,342,79,25,22,317,80,1776
15000US060133553062,374,78,0,12,0,12,0,12,374,78,64,38,310,83,1777
15000US060133553063,434,60,0,12,0,12,0,12,434,60,62,37,372,68,1778
15000US060133553064,407,81,0,12,0,12,0,12,407,81,97,57,310,83,1779
15000US060133553065,250,41,0,12,0,12,0,12,250,41,36,26,214,43,1780
15000US060133560011,288,65,14,23,14,23,0,12,274,64,38,36,236,67,1781
15000US060133560012,478,87,26,29,0,12,26,29,452,84,161,68,291,81,1782
15000US060133560013,474,110,12,23,12,23,0,12,462,115,148,67,314,93,1783
15000US060133560021,806,118,14,14,0,12,14,14,792,116,57,42,735,118,1784
15000US060133560022,246,53,19,20,0,12,19,20,227,56,60,38,167,56,1785
15000US060133560023,174,60,0,12,0,12,0,12,174,60,10,15,164,63,1786
15000US060133560024,666,82,10,16,10,16,0,12,656,82,210,68,446,95,1787
15000US060133570001,421,74,111,60,20,21,91,58,310,73,60,44,250,72,1788
15000US060133570002,501,102,0,12,0,12,0,12,501,102,79,41,422,109,1789
15000US060133570003,560,89,25,22,11,16,14,15,535,87,61,28,474,86,1790
15000US060133580001,438,96,38,32,38,32,0,12,400,98,76,43,324,103,1791
15000US060133580002,317,82,50,40,7,12,43,39,267,81,53,38,214,80,1792
15000US060133580003,385,84,26,42,0,12,26,42,359,74,80,58,279,88,1793
15000US060133580004,557,116,123,85,107,83,16,18,434,97,93,65,341,88,1794
15000US060133580005,376,110,150,102,24,30,126,103,226,58,88,52,138,53,1795
15000US060133591021,344,81,18,29,0,12,18,29,326,83,80,36,246,81,1796
15000US060133591022,780,102,96,49,53,38,43,36,684,99,231,94,453,90,1797
15000US060133591023,768,115,18,19,9,14,9,14,750,118,214,84,536,119,1798
15000US060133591031,519,79,44,42,32,38,12,18,475,81,123,57,352,82,1799
15000US060133591032,436,71,52,56,43,55,9,14,384,63,59,33,325,63,1800
15000US060133591033,1029,111,50,34,6,11,44,34,979,105,245,104,734,112,1801
15000US060133591041,889,51,48,33,35,30,13,13,841,60,72,35,769,68,1802
15000US060133591051,1522,71,17,26,14,22,3,12,1505,75,343,126,1162,136,1803
15000US060133592021,838,134,85,97,0,12,85,97,753,152,298,124,455,124,1804
15000US060133592022,891,124,37,41,19,29,18,27,854,134,343,120,511,133,1805
15000US060133592023,481,84,0,12,0,12,0,12,481,84,127,68,354,104,1806
15000US060133592031,418,104,43,43,0,12,43,43,375,100,108,56,267,101,1807
15000US060133592032,602,123,0,12,0,12,0,12,602,123,106,67,496,117,1808
15000US060133592033,318,91,82,84,0,12,82,84,236,93,79,79,157,74,1809
15000US060133592034,708,128,21,34,21,34,0,12,687,131,114,97,573,139,1810
15000US060133592035,245,103,0,12,0,12,0,12,245,103,72,83,173,72,1811
15000US060133592041,266,65,7,11,7,11,0,12,259,65,7,11,252,66,1812
15000US060133592042,402,68,8,15,0,12,8,15,394,70,95,42,299,77,1813
15000US060133592043,819,88,8,13,0,12,8,13,811,87,191,62,620,95,1814
15000US060133601011,346,67,0,12,0,12,0,12,346,67,121,55,225,73,1815
15000US060133601012,669,75,27,26,17,18,10,19,642,80,128,62,514,105,1816
15000US060133601013,639,86,8,12,8,12,0,12,631,85,151,59,480,92,1817
15000US060133601021,742,73,6,10,0,12,6,10,736,73,218,80,518,90,1818
15000US060133601022,506,73,18,25,18,25,0,12,488,80,71,46,417,81,1819
15000US060133601023,241,57,25,32,25,32,0,12,216,51,50,33,166,49,1820
15000US060133602001,628,89,70,60,61,59,9,13,558,80,224,76,334,75,1821
15000US060133602002,615,112,78,70,14,20,64,70,537,110,278,88,259,92,1822
15000US060133602003,501,88,30,27,18,20,12,18,471,93,52,37,419,93,1823
15000US060133610001,391,65,55,45,19,21,36,41,336,64,108,59,228,68,1824
15000US060133610002,724,83,56,35,0,12,56,35,668,88,214,81,454,99,1825
15000US060133610003,624,94,109,61,0,12,109,61,515,82,120,48,395,88,1826
15000US060133620001,378,70,30,27,22,25,8,12,348,74,46,32,302,67,1827
15000US060133620002,412,68,21,27,21,27,0,12,391,70,54,32,337,74,1828
15000US060133620003,423,67,0,12,0,12,0,12,423,67,113,58,310,73,1829
15000US060133630001,684,158,33,45,11,17,22,41,651,149,127,89,524,140,1830
15000US060133630002,779,155,21,32,0,12,21,32,758,162,202,98,556,158,1831
15000US060133630003,800,162,23,36,23,36,0,12,777,168,288,152,489,119,1832
15000US060133630004,466,99,0,12,0,12,0,12,466,99,158,67,308,90,1833
15000US060133640021,858,120,99,71,14,22,85,71,759,118,346,113,413,91,1834
15000US060133640022,524,100,19,23,19,23,0,12,505,105,153,90,352,102,1835
15000US060133640023,428,97,31,47,0,12,31,47,397,94,138,73,259,78,1836
15000US060133650021,624,98,132,88,90,75,42,39,492,97,115,58,377,97,1837
15000US060133650022,443,102,98,72,74,65,24,29,345,93,95,54,250,93,1838
15000US060133650023,507,123,226,116,96,75,130,92,281,91,101,59,180,78,1839
15000US060133650031,705,108,0,12,0,12,0,12,705,108,166,88,539,118,1840
15000US060133650032,502,148,21,24,0,12,21,24,481,151,223,133,258,122,1841
15000US060133650033,1041,150,9,26,0,12,9,26,1032,154,232,110,800,175,1842
15000US060133660011,438,113,126,90,20,30,106,80,312,112,73,51,239,106,1843
15000US060133660012,552,129,114,90,34,52,80,75,438,106,42,29,396,99,1844
15000US060133660013,334,110,16,24,0,12,16,24,318,116,75,54,243,115,1845
15000US060133660021,426,100,30,30,18,22,12,19,396,96,118,61,278,92,1846
15000US060133660022,517,101,57,49,16,23,41,46,460,93,113,61,347,93,1847
15000US060133660023,742,113,131,77,71,65,60,45,611,115,154,57,457,111,1848
15000US060133671001,591,90,79,61,0,12,79,61,512,103,107,52,405,113,1849
15000US060133671002,228,60,10,15,0,12,10,15,218,59,83,46,135,52,1850
15000US060133671003,723,94,160,83,8,13,152,81,563,106,113,67,450,101,1851
15000US060133671004,402,98,37,52,0,12,37,52,365,92,66,36,299,83,1852
15000US060133672001,554,94,116,65,36,35,80,55,438,96,139,59,299,102,1853
15000US060133672002,934,107,53,39,14,22,39,33,881,112,312,100,569,106,1854
15000US060133672003,249,65,50,48,42,46,8,12,199,54,119,54,80,42,1855
15000US060133680011,285,82,0,12,0,12,0,12,285,82,52,43,233,91,1856
15000US060133680012,513,106,132,72,78,51,54,52,381,93,84,52,297,89,1857
15000US060133680013,246,67,20,33,20,33,0,12,226,64,73,53,153,72,1858
15000US060133680014,276,86,28,39,0,12,28,39,248,81,121,62,127,67,1859
15000US060133680021,392,67,51,39,14,12,37,39,341,62,112,45,229,63,1860
15000US060133680022,556,71,37,25,4,8,33,24,519,76,164,58,355,77,1861
15000US060133690011,617,152,62,64,0,12,62,64,555,170,81,55,474,168,1862
15000US060133690012,736,138,143,102,74,84,69,67,593,145,156,103,437,139,1863
15000US060133690013,403,105,140,78,71,60,69,80,263,90,27,30,236,86,1864
15000US060133690014,670,138,101,78,34,36,67,67,569,141,216,105,353,134,1865
15000US060133690021,365,98,75,68,0,12,75,68,290,78,91,52,199,78,1866
15000US060133690022,286,66,26,32,0,12,26,32,260,62,43,30,217,62,1867
15000US060133690023,329,82,40,36,10,15,30,33,289,79,87,47,202,75,1868
15000US060133700001,604,72,0,12,0,12,0,12,604,72,128,60,476,73,1869
15000US060133700002,264,60,0,12,0,12,0,12,264,60,40,33,224,61,1870
15000US060133700003,244,65,29,33,29,33,0,12,215,55,18,22,197,58,1871
15000US060133710001,342,70,19,22,6,11,13,19,323,74,82,55,241,88,1872
15000US060133710002,279,94,33,34,8,12,25,33,246,98,31,25,215,100,1873
15000US060133710003,388,83,24,35,22,34,2,6,364,88,16,17,348,90,1874
15000US060133710004,400,92,57,53,31,40,26,34,343,96,122,62,221,88,1875
15000US060133710005,333,78,41,38,0,12,41,38,292,75,77,48,215,77,1876
15000US060133710006,223,44,13,16,7,12,6,10,210,46,25,22,185,50,1877
15000US060133720001,241,88,0,12,0,12,0,12,241,88,70,59,171,103,1878
15000US060133720002,460,102,78,82,36,52,42,63,382,118,88,55,294,125,1879
15000US060133720003,337,98,40,63,0,12,40,63,297,95,43,40,254,98,1880
15000US060133720004,287,84,19,28,19,28,0,12,268,83,27,27,241,88,1881
15000US060133720005,343,110,10,15,0,12,10,15,333,111,181,125,152,84,1882
15000US060133720006,410,105,0,12,0,12,0,12,410,105,61,46,349,104,1883
15000US060133720007,157,72,0,12,0,12,0,12,157,72,64,39,93,69,1884
15000US060133730001,489,90,26,25,0,12,26,25,463,91,132,69,331,91,1885
15000US060133730002,313,74,47,50,0,12,47,50,266,70,68,45,198,69,1886
15000US060133730003,310,75,82,51,21,28,61,42,228,70,66,53,162,72,1887
15000US060133740001,368,83,0,12,0,12,0,12,368,83,123,73,245,66,1888
15000US060133740002,379,83,75,47,18,19,57,41,304,86,75,44,229,87,1889
15000US060133740003,454,110,30,37,9,14,21,33,424,107,201,96,223,79,1890
15000US060133740004,501,104,44,42,6,9,38,41,457,99,144,65,313,105,1891
15000US060133750001,594,95,120,73,81,67,39,40,474,96,152,74,322,94,1892
15000US060133750002,328,96,86,54,17,28,69,47,242,93,76,64,166,81,1893
15000US060133750003,217,73,36,34,0,12,36,34,181,69,56,37,125,64,1894
15000US060133760001,390,88,93,64,18,29,75,58,297,75,116,58,181,72,1895
15000US060133760002,603,110,39,38,39,38,0,12,564,106,85,46,479,104,1896
15000US060133760003,424,92,45,43,30,37,15,25,379,92,172,84,207,79,1897
15000US060133760004,340,94,91,52,38,43,53,50,249,87,86,54,163,71,1898
15000US060133770001,226,100,9,14,9,14,0,12,217,103,84,73,133,82,1899
15000US060133770002,261,88,49,62,14,24,35,57,212,83,59,66,153,78,1900
15000US060133770003,381,113,140,87,0,12,140,87,241,105,92,67,149,92,1901
15000US060133770004,527,121,108,76,83,65,25,41,419,116,102,73,317,117,1902
15000US060133770005,782,148,133,99,0,12,133,99,649,167,132,88,517,136,1903
15000US060133780001,765,85,34,29,16,22,18,21,731,86,142,66,589,95,1904
15000US060133780002,934,98,0,12,0,12,0,12,934,98,116,59,818,106,1905
15000US060133790001,340,83,93,53,41,38,52,46,247,80,69,52,178,69,1906
15000US060133790002,467,77,97,51,37,40,60,44,370,93,176,76,194,88,1907
15000US060133790003,443,90,138,73,61,44,77,64,305,86,112,64,193,77,1908
15000US060133790004,643,116,129,78,90,68,39,41,514,115,169,91,345,105,1909
15000US060133800001,1919,175,56,48,16,26,40,40,1863,191,84,62,1779,194,1910
15000US060133800002,476,197,50,67,16,26,34,63,426,193,123,125,303,153,1911
15000US060133800003,483,109,25,38,25,38,0,12,458,111,159,70,299,95,1912
15000US060133810001,309,79,45,37,15,18,30,34,264,77,60,37,204,75,1913
15000US060133810002,464,98,71,56,71,56,0,12,393,94,147,61,246,78,1914
15000US060133810003,626,110,226,95,117,76,109,68,400,105,147,65,253,93,1915
15000US060133810004,382,82,97,63,52,41,45,50,285,82,44,39,241,85,1916
15000US060133810005,247,67,54,48,35,38,19,29,193,58,60,34,133,54,1917
15000US060133820001,307,83,57,67,43,65,14,23,250,73,74,65,176,54,1918
15000US060133820002,1041,208,358,173,147,127,211,134,683,194,113,73,570,185,1919
15000US060133820003,789,159,173,112,142,116,31,34,616,123,172,100,444,137,1920
15000US060133820004,587,128,81,94,50,78,31,52,506,121,128,91,378,104,1921
15000US060133830001,665,119,59,56,59,56,0,12,606,112,110,69,496,118,1922
15000US060133830002,662,111,44,39,16,26,28,43,618,108,126,61,492,108,1923
15000US060133830003,622,89,15,23,0,12,15,23,607,94,81,40,526,87,1924
15000US060133840001,350,69,11,12,0,12,11,12,339,68,35,27,304,70,1925
15000US060133840002,418,57,41,31,24,24,17,19,377,59,75,45,302,57,1926
15000US060133840003,603,67,0,12,0,12,0,12,603,67,92,44,511,79,1927
15000US060133840004,255,47,0,12,0,12,0,12,255,47,65,35,190,45,1928
15000US060133851001,773,55,8,10,8,10,0,12,765,56,187,63,578,85,1929
15000US060133851002,348,51,0,12,0,12,0,12,348,51,65,33,283,56,1930
15000US060133852001,286,41,0,12,0,12,0,12,286,41,76,38,210,47,1931
15000US060133852002,241,35,0,12,0,12,0,12,241,35,47,24,194,36,1932
15000US060133860001,324,82,42,36,0,12,42,36,282,77,29,36,253,76,1933
15000US060133860002,271,70,11,18,11,18,0,12,260,72,99,56,161,92,1934
15000US060133860003,293,54,0,12,0,12,0,12,293,54,73,42,220,59,1935
15000US060133860004,587,92,29,33,0,12,29,33,558,95,161,68,397,86,1936
15000US060133870001,382,59,7,11,0,12,7,11,375,60,82,47,293,61,1937
15000US060133870002,309,70,11,16,11,16,0,12,298,71,62,57,236,63,1938
15000US060133870003,387,65,0,12,0,12,0,12,387,65,72,45,315,66,1939
15000US060133880001,553,71,23,26,13,20,10,16,530,75,78,44,452,84,1940
15000US060133880002,537,70,7,13,7,13,0,12,530,72,107,46,423,65,1941
15000US060133891001,469,42,5,8,5,8,0,12,464,44,51,29,413,46,1942
15000US060133891002,390,40,8,6,0,12,8,6,382,42,76,26,306,43,1943
15000US060133892001,289,47,21,18,6,9,15,16,268,46,21,17,247,48,1944
15000US060133892002,431,48,24,25,5,8,19,23,407,47,44,26,363,52,1945
15000US060133901001,274,27,0,12,0,12,0,12,274,27,21,18,253,26,1946
15000US060133901002,372,39,18,16,0,12,18,16,354,43,67,26,287,47,1947
15000US060133901003,269,39,0,12,0,12,0,12,269,39,69,30,200,37,1948
15000US060133902001,432,48,7,9,7,9,0,12,425,51,89,27,336,51,1949
15000US060133902002,303,40,0,12,0,12,0,12,303,40,41,20,262,41,1950
15000US060133910001,761,63,0,12,0,12,0,12,761,63,144,44,617,69,1951
15000US060133910002,360,56,6,10,6,10,0,12,354,56,107,55,247,60,1952
15000US060133920001,544,51,0,12,0,12,0,12,544,51,62,43,482,63,1953
15000US060133920002,321,43,8,12,0,12,8,12,313,45,85,46,228,52,1954
15000US060133920003,300,49,0,12,0,12,0,12,300,49,25,23,275,52,1955
15000US060133922001,530,128,0,12,0,12,0,12,530,128,188,111,342,131,1956
15000US060133922002,1705,181,140,91,110,79,30,46,1565,193,423,141,1142,183,1957
15000US060133922003,583,92,0,12,0,12,0,12,583,92,185,76,398,90,1958
15000US060133922004,387,109,13,21,13,21,0,12,374,111,84,42,290,111,1959
15000US060133923001,888,45,72,37,22,17,50,33,816,55,271,63,545,71,1960
15000US060139900000,0,12,0,12,0,12,0,12,0,12,0,12,0,12,1961
15000US060150001011,922,183,158,79,65,47,93,65,764,185,317,124,447,139,1962
15000US060150001012,690,171,266,105,167,77,99,69,424,136,180,110,244,107,1963
15000US060150001021,660,114,90,50,48,44,42,34,570,112,157,71,413,102,1964
15000US060150001022,682,112,97,51,34,29,63,45,585,123,348,104,237,83,1965
15000US060150001041,750,95,158,78,81,49,77,59,592,107,252,68,340,96,1966
15000US060150001051,600,143,81,74,58,66,23,35,519,148,269,108,250,112,1967
15000US060150001052,472,156,29,42,0,12,29,42,443,152,124,80,319,155,1968
15000US060150001053,507,140,0,12,0,12,0,12,507,140,89,60,418,155,1969
15000US060150001054,178,93,0,12,0,12,0,12,178,93,25,29,153,92,1970
15000US060150001055,794,158,105,82,54,46,51,66,689,155,227,108,462,131,1971
15000US060150002011,385,113,74,64,13,19,61,61,311,112,89,63,222,103,1972
15000US060150002012,386,72,32,37,13,18,19,30,354,76,140,57,214,76,1973
15000US060150002013,449,118,37,38,30,34,7,11,412,118,190,86,222,100,1974
15000US060150002014,71,34,0,12,0,12,0,12,71,34,27,31,44,31,1975
15000US060150002021,505,99,51,40,41,39,10,9,454,92,131,55,323,93,1976
15000US060150002022,254,76,11,14,11,14,0,12,243,74,106,62,137,51,1977
15000US060150002023,358,99,39,41,39,41,0,12,319,92,148,69,171,72,1978
15000US060150002024,366,79,12,15,12,15,0,12,354,79,92,55,262,70,1979
15000US060150002031,414,48,119,41,81,35,38,19,295,37,175,35,120,25,1980
15000US060159900000,0,12,0,12,0,12,0,12,0,12,0,12,0,12,1981
15000US060170302001,656,128,98,52,75,48,23,28,558,133,134,70,424,125,1982
15000US060170302002,358,96,21,24,21,24,0,12,337,97,77,57,260,92,1983
15000US060170302003,341,85,0,12,0,12,0,12,341,85,84,51,257,76,1984
15000US060170302004,179,62,35,40,12,20,23,34,144,60,76,49,68,41,1985
15000US060170302005,219,83,0,12,0,12,0,12,219,83,33,31,186,83,1986
15000US060170303011,316,121,56,64,18,24,38,59,260,106,100,79,160,93,1987
15000US060170303012,311,113,22,28,7,15,15,23,289,112,95,66,194,95,1988
15000US060170303013,286,106,91,80,37,59,54,57,195,81,53,39,142,71,1989
15000US060170303021,330,85,63,53,9,15,54,51,267,78,77,50,190,74,1990
15000US060170303022,338,110,12,19,12,19,0,12,326,111,37,46,289,99,1991
15000US060170303023,210,80,0,12,0,12,0,12,210,80,27,32,183,77,1992
15000US060170303024,296,79,50,52,50,52,0,12,246,75,52,49,194,77,1993
15000US060170304011,447,126,0,12,0,12,0,12,447,126,132,82,315,104,1994
15000US060170304012,301,112,23,35,23,35,0,12,278,107,11,15,267,108,1995
15000US060170304013,268,102,0,12,0,12,0,12,268,102,17,29,251,100,1996
15000US060170304014,335,122,0,12,0,12,0,12,335,122,46,48,289,114,1997
15000US060170304015,268,90,38,60,0,12,38,60,230,68,63,45,167,65,1998
15000US060170304021,178,89,24,25,13,20,11,17,154,86,22,24,132,84,1999
15000US060170304022,365,94,40,34,11,19,29,29,325,102,192,100,133,56,2000
15000US060170304023,419,114,80,61,25,29,55,53,339,120,119,79,220,90,2001
15000US060170304024,351,95,24,25,0,12,24,25,327,102,116,68,211,78,2002
15000US060170304025,256,95,35,43,0,12,35,43,221,84,64,47,157,79,2003
15000US060170305021,328,87,8,14,1,10,7,11,320,89,64,52,256,85,2004
15000US060170305022,284,89,6,11,6,11,0,12,278,89,49,48,229,74,2005
15000US060170305023,310,76,0,12,0,12,0,12,310,76,36,34,274,78,2006
15000US060170305041,477,111,19,32,19,32,0,12,458,108,111,65,347,91,2007
15000US060170305042,206,68,8,12,8,12,0,12,198,67,9,14,189,66,2008
15000US060170305043,273,76,0,12,0,12,0,12,273,76,84,43,189,68,2009
15000US060170305051,434,103,7,11,0,12,7,11,427,102,84,50,343,94,2010
15000US060170305052,197,72,11,13,0,12,11,13,186,73,14,17,172,72,2011
15000US060170305053,343,81,24,28,0,12,24,28,319,81,42,30,277,77,2012
15000US060170306011,1114,124,109,88,47,56,62,64,1005,153,175,79,830,170,2013
15000US060170306012,810,141,32,36,32,36,0,12,778,138,201,87,577,151,2014
15000US060170306021,266,136,0,12,0,12,0,12,266,136,37,36,229,138,2015
15000US060170306022,939,184,123,89,41,64,82,63,816,185,314,150,502,157,2016
15000US060170306023,442,162,16,26,16,26,0,12,426,159,77,44,349,164,2017
15000US060170306024,561,141,0,12,0,12,0,12,561,141,265,134,296,101,2018
15000US060170306025,310,104,15,28,0,12,15,28,295,102,116,90,179,101,2019
15000US060170306031,327,78,19,20,10,14,9,14,308,75,97,58,211,76,2020
15000US060170306032,365,84,49,43,41,43,8,13,316,77,103,50,213,65,2021
15000US060170306033,606,100,65,60,16,19,49,56,541,96,157,53,384,87,2022
15000US060170306034,26,17,0,12,0,12,0,12,26,17,7,8,19,16,2023
15000US060170307011,1103,121,16,25,0,12,16,25,1087,124,150,78,937,143,2024
15000US060170307012,946,135,0,12,0,12,0,12,946,135,140,81,806,143,2025
15000US060170307041,1471,159,4,15,0,12,4,15,1467,160,298,117,1169,154,2026
15000US060170307042,1093,127,70,69,49,59,21,32,1023,127,322,121,701,118,2027
15000US060170307061,1094,130,29,35,16,27,13,21,1065,141,126,67,939,147,2028
15000US060170307062,992,125,0,12,0,12,0,12,992,125,147,61,845,136,2029
15000US060170307091,769,77,9,14,9,14,0,12,760,77,78,42,682,80,2030
15000US060170307092,768,78,0,12,0,12,0,12,768,78,64,36,704,87,2031
15000US060170307101,933,67,24,27,24,27,0,12,909,71,161,63,748,77,2032
15000US060170307102,294,54,0,12,0,12,0,12,294,54,59,39,235,59,2033
15000US060170307103,545,80,0,12,0,12,0,12,545,80,77,46,468,92,2034
15000US060170308011,929,98,34,28,8,12,26,27,895,103,235,78,660,106,2035
15000US060170308012,503,87,0,12,0,12,0,12,503,87,138,52,365,90,2036
15000US060170308031,1520,139,89,59,72,54,17,26,1431,147,333,92,1098,180,2037
15000US060170308032,727,129,0,12,0,12,0,12,727,129,157,65,570,136,2038
15000US060170308033,797,131,0,12,0,12,0,12,797,131,303,100,494,129,2039
15000US060170308041,963,110,24,38,0,12,24,38,939,112,293,122,646,114,2040
15000US060170308042,470,100,0,12,0,12,0,12,470,100,125,80,345,93,2041
15000US060170308043,876,139,71,83,54,80,17,28,805,119,258,97,547,108,2042
15000US060170308071,811,77,45,47,22,31,23,36,766,80,130,58,636,75,2043
15000US060170308072,628,80,22,26,8,12,14,24,606,83,80,38,526,85,2044
15000US060170308081,639,139,48,49,48,49,0,12,591,155,298,163,293,132,2045
15000US060170308082,1031,137,0,12,0,12,0,12,1031,137,161,86,870,140,2046
15000US060170308083,643,132,40,63,0,12,40,63,603,130,132,81,471,140,2047
15000US060170308091,311,51,16,23,0,12,16,23,295,50,100,46,195,37,2048
15000US060170308092,576,65,46,38,5,9,41,37,530,67,121,39,409,65,2049
15000US060170308101,952,82,140,71,55,42,85,62,812,101,178,71,634,107,2050
15000US060170308102,390,74,42,45,42,45,0,12,348,66,54,36,294,74,2051
15000US060170309011,779,78,31,29,20,24,11,17,748,83,109,50,639,92,2052
15000US060170309012,489,76,11,17,0,12,11,17,478,77,118,60,360,78,2053
15000US060170309021,706,98,1,3,0,12,1,3,705,99,215,76,490,84,2054
15000US060170309022,487,74,32,30,10,16,22,25,455,74,143,71,312,63,2055
15000US060170309023,586,89,30,32,16,24,14,20,556,80,51,33,505,86,2056
15000US060170310001,260,74,15,23,0,12,15,23,245,70,68,39,177,74,2057
15000US060170310002,586,107,64,82,0,12,64,82,522,92,235,97,287,78,2058
15000US060170310003,899,143,48,46,0,12,48,46,851,144,126,81,725,134,2059
15000US060170310004,502,113,100,50,26,28,74,40,402,121,134,85,268,100,2060
15000US060170311001,953,170,157,98,63,66,94,75,796,176,289,137,507,138,2061
15000US060170311002,502,130,22,27,0,12,22,27,480,134,150,82,330,140,2062
15000US060170311003,670,152,95,90,33,52,62,71,575,131,175,95,400,114,2063
15000US060170312001,779,116,65,47,32,32,33,33,714,115,179,86,535,123,2064
15000US060170312002,945,144,90,75,21,22,69,71,855,127,293,112,562,124,2065
15000US060170312003,224,82,27,22,11,18,16,23,197,80,12,19,185,80,2066
15000US060170313011,432,87,39,51,0,12,39,51,393,80,127,72,266,67,2067
15000US060170313012,333,69,25,23,19,21,6,9,308,71,60,34,248,73,2068
15000US060170313013,576,84,64,48,14,21,50,44,512,83,176,61,336,78,2069
15000US060170313021,389,129,27,29,0,12,27,29,362,127,120,92,242,97,2070
15000US060170313022,738,125,22,26,22,26,0,12,716,122,265,128,451,107,2071
15000US060170313023,819,175,152,119,47,77,105,91,667,188,172,107,495,174,2072
15000US060170314021,719,163,30,28,0,12,30,28,689,162,211,93,478,165,2073
15000US060170314022,552,123,40,44,25,38,15,19,512,127,194,73,318,118,2074
15000US060170314023,529,157,18,22,15,21,3,6,511,161,184,114,327,137,2075
15000US060170314024,286,112,0,12,0,12,0,12,286,112,63,60,223,102,2076
15000US060170314041,556,60,39,50,35,49,4,7,517,51,165,52,352,57,2077
15000US060170314042,366,57,18,19,0,12,18,19,348,57,83,25,265,56,2078
15000US060170314051,909,77,53,35,15,16,38,33,856,83,268,64,588,96,2079
15000US060170314061,246,62,12,20,12,20,0,12,234,65,117,56,117,62,2080
15000US060170314062,903,127,62,50,15,24,47,43,841,130,310,100,531,136,2081
15000US060170314063,350,87,26,32,12,20,14,24,324,86,106,61,218,91,2082
15000US060170314064,530,121,64,76,21,35,43,69,466,126,118,76,348,110,2083
15000US060170315021,925,134,196,93,92,54,104,87,729,163,298,122,431,121,2084
15000US060170315022,1148,157,183,105,124,94,59,49,965,153,297,115,668,149,2085
15000US060170315023,443,131,19,31,19,31,0,12,424,145,88,79,336,138,2086
15000US060170315031,326,63,11,17,11,17,0,12,315,69,25,21,290,68,2087
15000US060170315032,775,93,43,55,7,12,36,54,732,101,168,65,564,106,2088
15000US060170315041,672,94,10,19,10,19,0,12,662,97,249,101,413,96,2089
15000US060170315042,308,110,0,12,0,12,0,12,308,110,83,82,225,91,2090
15000US060170315043,370,109,0,12,0,12,0,12,370,109,114,82,256,84,2091
15000US060170315044,695,133,105,65,81,65,24,32,590,132,260,106,330,119,2092
15000US060170316001,375,119,11,17,0,12,11,17,364,116,99,86,265,97,2093
15000US060170316002,149,88,10,17,0,12,10,17,139,85,85,71,54,51,2094
15000US060170316003,262,109,44,53,0,12,44,53,218,96,15,23,203,92,2095
15000US060170316004,354,111,79,70,79,70,0,12,275,99,45,55,230,103,2096
15000US060170316005,239,95,52,44,24,27,28,32,187,91,42,37,145,81,2097
15000US060170317001,882,38,5,8,0,12,5,8,877,39,115,42,762,57,2098
15000US060170318001,267,67,0,12,0,12,0,12,267,67,22,34,245,69,2099
15000US060170318002,1219,144,43,41,0,12,43,41,1176,152,128,85,1048,152,2100
15000US060170318003,732,129,0,12,0,12,0,12,732,129,144,97,588,113,2101
15000US060170319001,45,12,2,3,1,2,1,2,43,11,11,4,32,12,2102
15000US060170320001,257,79,15,24,15,24,0,12,242,75,71,45,171,66,2103
15000US060170320002,28,22,0,12,0,12,0,12,28,22,18,22,10,2,2104
15000US060170320003,37,32,0,12,0,12,0,12,37,32,19,22,18,24,2105
15000US060179900000,0,12,0,12,0,12,0,12,0,12,0,12,0,12,2106
15000US060190001001,514,73,87,46,34,31,53,41,427,81,224,61,203,64,2107
15000US060190002001,207,46,109,42,14,17,95,41,98,37,39,25,59,34,2108
15000US060190002002,231,44,86,39,25,16,61,35,145,42,64,33,81,34,2109
15000US060190002003,392,54,217,51,40,26,177,55,175,47,71,34,104,41,2110
15000US060190003001,549,95,171,105,50,73,121,87,378,94,154,84,224,113,2111
15000US060190003002,204,91,109,75,35,50,74,67,95,47,24,28,71,39,2112
15000US060190003003,302,83,141,65,70,76,71,60,161,69,69,48,92,54,2113
15000US060190004001,372,95,124,57,58,44,66,42,248,90,91,60,157,70,2114
15000US060190004002,344,92,221,92,87,69,134,68,123,66,40,35,83,57,2115
15000US060190004003,381,96,196,71,17,18,179,72,185,85,54,40,131,76,2116
15000US060190004004,188,77,86,51,0,12,86,51,102,66,45,44,57,51,2117
15000US060190005011,297,55,135,51,62,36,73,41,162,44,88,35,74,35,2118
15000US060190005012,470,67,248,64,88,50,160,51,222,62,122,49,100,43,2119
15000US060190005021,340,86,20,23,0,12,20,23,320,86,37,31,283,87,2120
15000US060190005022,471,78,219,77,60,46,159,75,252,82,95,60,157,75,2121
15000US060190005023,198,77,94,66,20,33,74,55,104,50,39,35,65,46,2122
15000US060190006001,442,111,84,59,32,37,52,49,358,104,183,85,175,72,2123
15000US060190006002,355,112,113,77,93,79,20,31,242,85,55,42,187,83,2124
15000US060190006003,603,137,322,124,97,65,225,109,281,111,118,74,163,85,2125
15000US060190006004,431,102,236,99,60,56,176,84,195,91,80,56,115,70,2126
15000US060190007001,102,46,19,23,1,6,18,23,83,46,35,23,48,40,2127
15000US060190007002,512,91,100,57,64,44,36,37,412,92,154,69,258,94,2128
15000US060190007003,507,101,215,79,58,36,157,69,292,95,129,60,163,83,2129
15000US060190008001,314,45,122,35,31,19,91,33,192,44,65,30,127,44,2130
15000US060190009011,742,44,374,71,106,52,268,71,368,78,97,43,271,78,2131
15000US060190009021,359,106,134,74,20,32,114,71,225,102,87,55,138,87,2132
15000US060190009022,496,105,319,95,125,55,194,93,177,74,67,35,110,73,2133
15000US060190009023,489,103,274,89,72,52,202,79,215,84,76,45,139,78,2134
15000US060190010001,526,64,229,57,78,36,151,56,297,61,136,42,161,52,2135
15000US060190010002,465,51,149,45,54,29,95,44,316,59,103,31,213,53,2136
15000US060190011001,321,41,145,37,49,31,96,32,176,47,54,29,122,44,2137
15000US060190011002,364,51,121,45,65,34,56,37,243,56,121,40,122,49,2138
15000US060190012011,197,90,98,78,19,30,79,69,99,57,56,50,43,31,2139
15000US060190012012,562,112,284,97,154,79,130,73,278,92,30,26,248,91,2140
15000US060190012013,512,109,254,78,63,58,191,75,258,95,77,50,181,86,2141
15000US060190012014,117,52,16,18,16,18,0,12,101,50,32,28,69,47,2142
15000US060190012021,611,112,267,101,101,72,166,92,344,109,140,73,204,100,2143
15000US060190012022,598,110,189,77,85,58,104,55,409,104,120,82,289,93,2144
15000US060190013011,437,88,247,96,79,61,168,91,190,86,54,43,136,82,2145
15000US060190013012,242,62,68,35,21,22,47,32,174,70,20,22,154,67,2146
15000US060190013013,192,62,123,53,68,48,55,32,69,32,15,21,54,33,2147
15000US060190013014,237,67,90,52,36,28,54,46,147,55,55,32,92,55,2148
15000US060190013015,328,92,133,70,75,47,58,50,195,82,66,52,129,74,2149
15000US060190013031,253,50,102,48,21,17,81,44,151,42,19,15,132,42,2150
15000US060190013032,277,54,172,54,29,22,143,51,105,40,24,17,81,35,2151
15000US060190013041,263,91,196,87,28,35,168,86,67,42,46,41,21,22,2152
15000US060190013042,793,91,241,91,87,62,154,92,552,107,129,63,423,113,2153
15000US060190013043,371,97,144,79,45,37,99,69,227,90,106,61,121,73,2154
15000US060190014071,685,109,370,87,108,70,262,89,315,102,74,56,241,101,2155
15000US060190014072,367,99,230,88,81,56,149,77,137,68,57,56,80,40,2156
15000US060190014073,502,97,206,73,108,54,98,62,296,86,140,59,156,72,2157
15000US060190014081,1003,86,89,63,80,62,9,14,914,93,541,123,373,113,2158
15000US060190014082,207,51,14,18,9,15,5,12,193,49,42,29,151,46,2159
15000US060190014091,646,34,82,32,70,29,12,12,564,45,208,58,356,60,2160
15000US060190014101,1983,148,178,96,95,70,83,91,1805,164,537,148,1268,197,2161
15000US060190014102,719,148,241,123,66,70,175,113,478,173,216,110,262,139,2162
15000US060190014111,332,74,36,35,25,30,11,16,296,70,62,30,234,73,2163
15000US060190014112,267,57,0,12,0,12,0,12,267,57,64,36,203,56,2164
15000US060190014113,671,125,97,66,19,21,78,64,574,122,141,76,433,106,2165
15000US060190014114,668,134,374,96,87,46,287,98,294,129,39,32,255,132,2166
15000US060190014121,724,52,90,54,68,48,22,23,634,71,157,44,477,74,2167
15000US060190014131,1613,57,143,60,42,47,101,50,1470,76,255,72,1215,90,2168
15000US060190014141,484,116,156,102,145,109,11,23,328,116,105,77,223,116,2169
15000US060190014142,402,92,0,12,0,12,0,12,402,92,160,98,242,99,2170
15000US060190014143,1507,147,253,123,146,107,107,79,1254,192,285,122,969,162,2171
15000US060190015001,138,45,26,24,0,12,26,24,112,40,34,21,78,41,2172
15000US060190015002,491,61,122,59,23,32,99,51,369,67,98,34,271,61,2173
15000US060190016001,760,135,109,71,44,36,65,65,651,135,173,83,478,122,2174
15000US060190016002,300,80,71,62,8,11,63,62,229,72,67,40,162,74,2175
15000US060190016003,468,93,123,63,54,50,69,48,345,93,93,57,252,91,2176
15000US060190017001,413,78,112,48,33,21,79,44,301,74,70,41,231,77,2177
15000US060190017002,333,68,59,40,18,17,41,36,274,62,51,23,223,60,2178
15000US060190017003,909,91,193,73,14,17,179,72,716,90,172,62,544,95,2179
15000US060190018001,399,63,107,41,19,17,88,40,292,64,41,24,251,66,2180
15000US060190018002,265,58,38,28,11,12,27,26,227,59,57,23,170,59,2181
15000US060190018003,366,80,65,47,3,5,62,47,301,80,124,51,177,66,2182
15000US060190018004,386,61,73,35,25,19,48,35,313,59,98,43,215,55,2183
15000US060190019001,281,49,29,27,23,25,6,8,252,48,89,36,163,50,2184
15000US060190019002,240,61,74,41,25,26,49,31,166,48,43,21,123,48,2185
15000US060190019003,286,45,43,29,10,9,33,28,243,45,99,36,144,39,2186
15000US060190020001,533,108,273,111,167,97,106,59,260,83,12,14,248,82,2187
15000US060190020002,524,100,159,82,77,54,82,73,365,77,86,37,279,73,2188
15000US060190020003,234,78,84,66,25,32,59,56,150,73,70,56,80,48,2189
15000US060190020004,254,76,101,70,88,68,13,17,153,73,54,47,99,55,2190
15000US060190020005,165,57,72,41,21,27,51,41,93,52,39,39,54,36,2191
15000US060190021001,362,104,34,35,18,28,16,26,328,106,94,58,234,98,2192
15000US060190021002,448,150,76,76,37,60,39,48,372,145,69,85,303,116,2193
15000US060190021003,356,121,179,121,15,26,164,116,177,80,36,39,141,75,2194
15000US060190021004,317,137,189,115,16,30,173,112,128,81,62,55,66,65,2195
15000US060190021005,639,165,58,50,41,45,17,22,581,169,408,176,173,91,2196
15000US060190022001,299,89,59,46,5,8,54,45,240,90,7,12,233,89,2197
15000US060190022002,425,99,123,83,46,48,77,68,302,84,50,25,252,85,2198
15000US060190022003,312,84,81,58,15,24,66,60,231,71,61,44,170,65,2199
15000US060190022004,452,93,53,37,9,14,44,33,399,87,81,65,318,78,2200
15000US060190023001,330,80,67,41,32,32,35,36,263,84,52,47,211,77,2201
15000US060190023002,505,88,80,53,8,15,72,57,425,94,139,78,286,85,2202
15000US060190023003,423,90,116,66,6,10,110,66,307,86,105,49,202,79,2203
15000US060190024001,364,83,177,67,79,52,98,64,187,81,121,64,66,58,2204
15000US060190024002,245,86,155,72,113,66,42,41,90,62,42,54,48,35,2205
15000US060190024003,308,93,197,84,94,54,103,63,111,71,35,31,76,73,2206
15000US060190024004,418,112,146,65,69,49,77,59,272,106,62,49,210,100,2207
15000US060190025011,296,74,197,78,60,51,137,63,99,51,69,46,30,28,2208
15000US060190025012,266,61,100,63,39,33,61,54,166,53,48,32,118,50,2209
15000US060190025013,269,102,81,55,9,14,72,54,188,93,36,43,152,82,2210
15000US060190025014,541,105,304,109,50,49,254,97,237,84,87,56,150,77,2211
15000US060190025021,387,94,148,76,51,47,97,69,239,83,109,67,130,68,2212
15000US060190025022,327,81,249,89,35,43,214,83,78,53,20,32,58,46,2213
15000US060190025023,538,100,277,110,178,100,99,68,261,103,103,65,158,85,2214
15000US060190026011,518,122,190,101,51,43,139,89,328,98,103,87,225,93,2215
15000US060190026012,461,113,173,80,72,50,101,73,288,103,173,84,115,71,2216
15000US060190026013,364,107,126,72,43,45,83,63,238,84,67,38,171,81,2217
15000US060190026021,224,45,83,41,44,37,39,27,141,38,52,33,89,29,2218
15000US060190026022,525,74,215,64,57,41,158,73,310,76,79,44,231,66,2219
15000US060190026023,230,71,50,42,21,21,29,37,180,63,69,37,111,56,2220
15000US060190027011,393,101,68,54,31,29,37,42,325,90,167,84,158,56,2221
15000US060190027012,182,76,79,64,20,32,59,56,103,63,27,31,76,56,2222
15000US060190027013,329,79,79,48,16,19,63,47,250,73,52,32,198,69,2223
15000US060190027014,256,87,92,69,14,17,78,70,164,69,38,29,126,69,2224
15000US060190027021,277,76,89,54,12,17,77,51,188,66,55,40,133,55,2225
15000US060190027022,376,74,118,48,62,54,56,42,258,75,102,58,156,64,2226
15000US060190027023,697,101,366,104,132,75,234,73,331,91,96,60,235,76,2227
15000US060190028001,289,90,104,67,24,28,80,63,185,89,84,53,101,67,2228
15000US060190028002,156,67,98,56,39,43,59,49,58,42,32,30,26,32,2229
15000US060190028003,383,110,186,75,23,29,163,67,197,93,84,65,113,69,2230
15000US060190028004,350,91,187,82,67,45,120,79,163,69,79,63,84,51,2231
15000US060190029031,376,72,173,66,77,54,96,50,203,58,93,46,110,50,2232
15000US060190029032,401,65,138,47,61,39,77,45,263,60,144,61,119,48,2233
15000US060190029033,454,80,148,57,59,39,89,48,306,84,115,53,191,81,2234
15000US060190029041,418,58,111,37,47,31,64,26,307,60,116,49,191,55,2235
15000US060190029042,368,66,67,43,24,24,43,33,301,60,54,29,247,63,2236
15000US060190029051,347,43,90,41,39,23,51,32,257,43,121,42,136,45,2237
15000US060190029052,567,62,200,64,101,45,99,44,367,74,117,51,250,71,2238
15000US060190029061,662,102,313,107,141,80,172,87,349,104,136,82,213,100,2239
15000US060190029062,516,110,121,51,23,23,98,50,395,102,161,66,234,97,2240
15000US060190029063,356,74,150,64,74,45,76,56,206,62,107,60,99,48,2241
15000US060190030011,392,58,146,46,54,33,92,37,246,60,91,37,155,52,2242
15000US060190030012,467,58,160,51,65,32,95,44,307,59,125,41,182,58,2243
15000US060190030031,622,100,352,109,128,63,224,100,270,90,107,60,163,67,2244
15000US060190030032,627,95,234,79,50,40,184,79,393,85,104,56,289,90,2245
15000US060190030041,427,49,133,53,57,34,76,40,294,54,115,49,179,48,2246
15000US060190030042,331,53,73,34,50,31,23,25,258,50,93,30,165,48,2247
15000US060190031021,260,109,74,68,11,21,63,65,186,99,118,90,68,56,2248
15000US060190031022,352,137,46,69,46,69,0,12,306,122,121,86,185,114,2249
15000US060190031023,773,167,243,126,0,12,243,126,530,159,93,73,437,155,2250
15000US060190031024,386,116,41,43,41,43,0,12,345,121,130,89,215,121,2251
15000US060190031025,793,197,122,106,0,12,122,106,671,219,235,128,436,186,2252
15000US060190031031,465,120,91,81,91,81,0,12,374,124,42,29,332,129,2253
15000US060190031032,467,123,128,73,23,26,105,81,339,112,157,88,182,81,2254
15000US060190031033,272,81,28,35,28,35,0,12,244,79,37,36,207,76,2255
15000US060190031034,571,109,152,100,49,71,103,93,419,86,175,85,244,97,2256
15000US060190031035,302,93,30,46,0,12,30,46,272,103,27,33,245,104,2257
15000US060190031041,1089,85,103,55,62,48,41,31,986,105,200,91,786,127,2258
15000US060190031042,319,55,20,20,7,12,13,16,299,58,111,44,188,52,2259
15000US060190031043,294,73,18,21,18,21,0,12,276,72,132,63,144,55,2260
15000US060190032011,586,101,163,78,55,50,108,60,423,86,121,58,302,85,2261
15000US060190032012,893,103,266,99,124,63,142,85,627,112,244,72,383,102,2262
15000US060190032021,384,131,84,60,77,60,7,12,300,119,107,60,193,125,2263
15000US060190032022,464,104,189,80,45,45,144,78,275,100,79,59,196,86,2264
15000US060190032023,816,164,400,152,247,127,153,92,416,110,105,69,311,96,2265
15000US060190033011,671,110,133,68,66,34,67,55,538,110,195,97,343,124,2266
15000US060190033012,329,79,34,26,23,24,11,17,295,75,69,47,226,84,2267
15000US060190033021,572,116,271,91,182,89,89,68,301,99,123,58,178,91,2268
15000US060190033022,259,84,50,42,47,41,3,6,209,80,64,41,145,84,2269
15000US060190033023,345,109,146,84,33,42,113,76,199,87,72,40,127,80,2270
15000US060190033024,339,97,155,91,39,49,116,83,184,79,78,36,106,71,2271
15000US060190034001,311,86,73,44,52,39,21,26,238,82,128,68,110,70,2272
15000US060190034002,692,116,301,82,93,57,208,79,391,99,205,84,186,91,2273
15000US060190034003,214,61,57,45,36,39,21,20,157,55,30,24,127,57,2274
15000US060190034004,392,78,91,55,29,27,62,45,301,72,59,38,242,70,2275
15000US060190035001,253,128,143,115,131,112,12,19,110,88,55,62,55,69,2276
15000US060190035002,431,146,181,100,40,50,141,107,250,110,52,43,198,109,2277
15000US060190035003,545,122,158,106,0,12,158,106,387,122,106,57,281,119,2278
15000US060190035004,431,131,53,53,28,44,25,29,378,137,120,90,258,126,2279
15000US060190035005,317,124,151,91,33,41,118,82,166,91,0,12,166,91,2280
15000US060190036001,361,64,29,24,8,13,21,20,332,71,93,58,239,61,2281
15000US060190036002,261,66,45,29,0,12,45,29,216,65,39,39,177,72,2282
15000US060190036003,414,78,33,38,0,12,33,38,381,80,94,45,287,92,2283
15000US060190036004,267,64,9,15,0,12,9,15,258,62,80,52,178,53,2284
15000US060190036005,369,75,97,63,26,34,71,47,272,75,26,24,246,74,2285
15000US060190037011,617,90,247,97,114,62,133,81,370,109,71,51,299,102,2286
15000US060190037012,464,94,114,60,28,21,86,55,350,92,110,51,240,89,2287
15000US060190037021,612,109,243,89,44,34,199,93,369,95,169,71,200,86,2288
15000US060190037022,407,103,139,81,44,51,95,67,268,91,211,77,57,38,2289
15000US060190037023,218,75,39,50,10,14,29,48,179,62,33,26,146,70,2290
15000US060190037024,272,83,72,46,50,49,22,26,200,80,33,23,167,77,2291
15000US060190038031,391,127,170,133,105,102,65,94,221,75,99,48,122,74,2292
15000US060190038032,1829,164,173,104,55,54,118,93,1656,176,484,160,1172,213,2293
15000US060190038033,296,105,0,12,0,12,0,12,296,105,80,58,216,110,2294
15000US060190038041,480,91,82,58,13,20,69,54,398,85,117,55,281,82,2295
15000US060190038042,449,95,41,34,15,17,26,27,408,102,120,74,288,104,2296
15000US060190038043,693,90,108,68,28,33,80,58,585,103,197,90,388,110,2297
15000US060190038051,867,161,352,151,89,94,263,126,515,140,214,93,301,127,2298
15000US060190038052,326,102,167,97,69,69,98,73,159,73,64,50,95,59,2299
15000US060190038053,924,148,308,119,82,55,226,117,616,135,146,100,470,132,2300
15000US060190038071,432,100,210,97,117,59,93,79,222,63,75,43,147,55,2301
15000US060190038072,438,113,155,98,85,75,70,62,283,103,132,76,151,82,2302
15000US060190038073,161,62,31,22,23,18,8,14,130,62,8,14,122,62,2303
15000US060190038081,506,90,46,30,13,19,33,31,460,92,156,69,304,97,2304
15000US060190038082,929,86,119,54,22,28,97,45,810,86,230,88,580,109,2305
15000US060190038091,978,115,218,102,81,69,137,78,760,140,87,61,673,127,2306
15000US060190038092,586,117,123,67,86,60,37,29,463,118,117,60,346,107,2307
15000US060190038101,759,95,219,84,108,67,111,64,540,96,231,80,309,73,2308
15000US060190038102,808,81,141,73,24,23,117,71,667,97,133,53,534,102,2309
15000US060190039001,321,107,60,43,38,39,22,25,261,105,58,64,203,94,2310
15000US060190039002,227,98,49,45,28,38,21,29,178,96,85,63,93,74,2311
15000US060190039003,412,130,172,113,153,110,19,20,240,102,65,60,175,89,2312
15000US060190039004,258,70,31,28,10,16,21,23,227,72,129,66,98,51,2313
15000US060190039005,364,96,91,62,80,66,11,20,273,85,96,50,177,85,2314
15000US060190040011,846,164,269,120,119,85,150,89,577,141,182,88,395,121,2315
15000US060190040012,1007,174,92,67,92,67,0,12,915,175,169,83,746,174,2316
15000US060190040013,233,107,90,82,26,35,64,67,143,90,0,12,143,90,2317
15000US060190040021,778,132,154,77,37,42,117,67,624,127,207,94,417,111,2318
15000US060190040022,557,107,170,80,21,21,149,81,387,103,88,51,299,101,2319
15000US060190040023,669,113,123,81,31,41,92,69,546,111,102,40,444,104,2320
15000US060190041001,492,49,36,30,23,24,13,20,456,59,87,33,369,61,2321
15000US060190041002,354,62,95,50,8,9,87,50,259,58,98,48,161,60,2322
15000US060190042051,384,85,59,48,0,12,59,48,325,81,119,60,206,92,2323
15000US060190042052,293,94,48,35,19,22,29,27,245,89,62,64,183,79,2324
15000US060190042053,750,136,264,114,99,65,165,97,486,105,71,49,415,101,2325
15000US060190042054,604,114,158,83,101,71,57,44,446,118,122,65,324,110,2326
15000US060190042071,1520,192,148,115,52,71,96,90,1372,192,261,90,1111,192,2327
15000US060190042072,1002,182,557,177,204,153,353,160,445,144,181,93,264,131,2328
15000US060190042081,1762,135,82,83,56,75,26,33,1680,154,432,125,1248,175,2329
15000US060190042082,671,123,0,12,0,12,0,12,671,123,201,87,470,129,2330
15000US060190042101,591,109,170,78,0,12,170,78,421,99,43,40,378,92,2331
15000US060190042102,817,109,35,30,0,12,35,30,782,109,116,57,666,110,2332
15000US060190042111,652,177,168,116,22,35,146,115,484,165,142,101,342,153,2333
15000US060190042112,1671,167,83,94,0,12,83,94,1588,185,167,90,1421,196,2334
15000US060190042121,1616,313,563,261,230,200,333,170,1053,250,168,106,885,241,2335
15000US060190042122,262,119,0,12,0,12,0,12,262,119,65,70,197,101,2336
15000US060190042123,1525,279,210,156,31,51,179,151,1315,253,134,113,1181,248,2337
15000US060190042124,815,233,138,133,47,81,91,113,677,223,162,125,515,198,2338
15000US060190042131,512,107,52,37,0,12,52,37,460,108,121,61,339,115,2339
15000US060190042132,701,100,12,18,12,18,0,12,689,102,156,85,533,129,2340
15000US060190042141,449,70,0,12,0,12,0,12,449,70,79,33,370,76,2341
15000US060190042142,382,65,0,12,0,12,0,12,382,65,92,54,290,66,2342
15000US060190042143,515,97,9,15,9,15,0,12,506,100,247,96,259,79,2343
15000US060190042144,558,99,23,25,12,18,11,17,535,103,201,74,334,94,2344
15000US060190042151,1405,63,92,56,35,32,57,59,1313,97,271,90,1042,102,2345
15000US060190042161,925,66,118,86,78,76,40,34,807,90,213,81,594,94,2346
15000US060190043011,481,82,0,12,0,12,0,12,481,82,203,92,278,69,2347
15000US060190043012,536,100,0,12,0,12,0,12,536,100,96,63,440,84,2348
15000US060190043013,671,87,28,37,28,37,0,12,643,82,216,68,427,82,2349
15000US060190043021,407,79,0,12,0,12,0,12,407,79,116,63,291,94,2350
15000US060190043022,495,117,0,12,0,12,0,12,495,117,80,57,415,120,2351
15000US060190043023,295,95,0,12,0,12,0,12,295,95,118,91,177,68,2352
15000US060190043024,523,127,0,12,0,12,0,12,523,127,65,54,458,138,2353
15000US060190043025,410,98,0,12,0,12,0,12,410,98,154,87,256,84,2354
15000US060190043031,499,72,9,14,9,14,0,12,490,74,64,34,426,74,2355
15000US060190043032,331,57,10,15,10,15,0,12,321,54,108,46,213,62,2356
15000US060190043033,360,66,37,44,25,40,12,18,323,61,60,36,263,60,2357
15000US060190043034,620,83,29,25,29,25,0,12,591,84,154,54,437,94,2358
15000US060190044041,749,100,254,104,101,61,153,86,495,129,47,34,448,127,2359
15000US060190044042,404,88,159,71,65,49,94,53,245,83,118,63,127,76,2360
15000US060190044051,370,77,7,11,0,12,7,11,363,80,132,61,231,64,2361
15000US060190044052,670,66,0,12,0,12,0,12,670,66,96,41,574,72,2362
15000US060190044053,470,81,23,24,23,24,0,12,447,83,32,28,415,82,2363
15000US060190044061,1233,155,95,94,46,73,49,41,1138,164,334,122,804,201,2364
15000US060190044062,314,78,0,12,0,12,0,12,314,78,49,30,265,73,2365
15000US060190044063,765,133,12,19,12,19,0,12,753,133,89,52,664,142,2366
15000US060190044081,710,106,43,33,0,12,43,33,667,106,92,46,575,109,2367
15000US060190044082,873,117,14,21,0,12,14,21,859,119,128,70,731,127,2368
15000US060190044091,482,89,32,28,16,18,16,18,450,91,63,45,387,90,2369
15000US060190044092,352,74,0,12,0,12,0,12,352,74,45,37,307,73,2370
15000US060190044093,507,93,81,65,0,12,81,65,426,88,76,59,350,93,2371
15000US060190045031,1002,105,9,17,9,17,0,12,993,108,249,108,744,148,2372
15000US060190045032,1114,119,90,71,36,41,54,60,1024,133,184,94,840,137,2373
15000US060190045041,745,166,202,140,57,63,145,131,543,185,54,52,489,178,2374
15000US060190045042,452,160,108,102,55,93,53,52,344,143,229,142,115,70,2375
15000US060190045043,407,115,12,29,12,29,0,12,395,120,87,114,308,108,2376
15000US060190045044,495,142,0,12,0,12,0,12,495,142,229,126,266,100,2377
15000US060190045051,769,117,57,49,23,27,34,41,712,113,285,126,427,167,2378
15000US060190045052,1243,158,374,138,58,59,316,133,869,171,214,101,655,169,2379
15000US060190045061,557,88,17,20,11,18,6,9,540,87,145,53,395,92,2380
15000US060190045062,861,99,27,24,0,12,27,24,834,103,275,72,559,103,2381
15000US060190046011,728,79,68,68,21,24,47,64,660,85,159,70,501,99,2382
15000US060190046012,424,79,65,61,65,61,0,12,359,88,57,34,302,86,2383
15000US060190046021,327,78,0,12,0,12,0,12,327,78,12,16,315,80,2384
15000US060190046022,338,77,15,23,0,12,15,23,323,74,57,38,266,67,2385
15000US060190046023,390,89,24,34,7,17,17,25,366,90,65,55,301,85,2386
15000US060190047011,565,132,151,106,63,62,88,81,414,121,170,93,244,108,2387
15000US060190047012,795,160,135,110,13,21,122,108,660,163,185,89,475,167,2388
15000US060190047013,509,131,219,125,101,86,118,100,290,118,242,113,48,41,2389
15000US060190047014,540,151,258,122,38,50,220,119,282,146,35,45,247,139,2390
15000US060190047031,508,94,151,60,65,44,86,54,357,92,49,31,308,93,2391
15000US060190047032,442,83,85,61,35,33,50,49,357,82,60,32,297,83,2392
15000US060190047033,323,62,107,46,10,13,97,43,216,65,44,30,172,64,2393
15000US060190047041,719,122,435,114,242,97,193,75,284,115,87,52,197,105,2394
15000US060190047042,745,105,162,80,109,71,53,41,583,121,213,80,370,105,2395
15000US060190048011,323,104,182,90,89,52,93,77,141,93,113,87,28,23,2396
15000US060190048012,422,106,128,62,48,47,80,53,294,102,139,97,155,57,2397
15000US060190048013,290,89,68,57,7,12,61,57,222,73,109,62,113,64,2398
15000US060190048014,504,117,293,120,52,46,241,109,211,109,13,17,198,105,2399
15000US060190048021,689,108,371,103,133,83,238,90,318,85,163,71,155,66,2400
15000US060190048022,356,92,144,87,54,49,90,78,212,73,84,50,128,55,2401
15000US060190048023,482,87,145,70,80,52,65,52,337,96,147,78,190,82,2402
15000US060190049011,776,105,123,73,42,32,81,63,653,103,246,102,407,103,2403
15000US060190049012,568,101,160,71,31,41,129,63,408,81,96,47,312,83,2404
15000US060190049021,335,52,145,52,37,33,108,54,190,51,59,33,131,47,2405
15000US060190049022,344,51,44,33,24,25,20,28,300,44,62,28,238,49,2406
15000US060190050001,317,88,46,51,39,51,7,14,271,73,92,55,179,64,2407
15000US060190050002,426,99,158,75,61,56,97,63,268,79,105,67,163,78,2408
15000US060190050003,733,96,26,24,6,11,20,20,707,93,211,76,496,90,2409
15000US060190051001,615,205,80,96,13,23,67,92,535,214,84,59,451,215,2410
15000US060190051002,529,150,188,143,12,22,176,138,341,167,128,103,213,148,2411
15000US060190051003,267,107,47,50,24,29,23,40,220,101,127,86,93,74,2412
15000US060190051004,434,137,256,128,69,79,187,128,178,98,116,83,62,60,2413
15000US060190051005,377,151,87,56,47,60,40,40,290,137,71,57,219,137,2414
15000US060190052021,480,90,131,69,52,38,79,60,349,88,150,56,199,76,2415
15000US060190052022,751,95,322,98,138,72,184,80,429,106,99,64,330,109,2416
15000US060190052031,861,110,165,81,35,35,130,78,696,120,215,80,481,121,2417
15000US060190052032,672,113,169,98,46,35,123,85,503,103,221,85,282,101,2418
15000US060190052041,446,91,203,78,74,51,129,72,243,82,174,81,69,37,2419
15000US060190052042,441,100,96,60,55,49,41,36,345,103,63,67,282,82,2420
15000US060190052043,480,97,171,87,40,44,131,72,309,100,123,62,186,84,2421
15000US060190053011,639,130,203,98,60,50,143,102,436,121,134,64,302,111,2422
15000US060190053012,650,131,50,46,26,31,24,33,600,136,202,106,398,113,2423
15000US060190053013,681,107,131,63,59,42,72,54,550,116,204,70,346,119,2424
15000US060190053021,982,131,195,92,131,85,64,56,787,126,167,73,620,121,2425
15000US060190053022,913,106,325,90,148,71,177,68,588,105,161,64,427,96,2426
15000US060190053041,510,146,192,126,15,27,177,122,318,96,133,85,185,103,2427
15000US060190053042,1346,189,314,172,81,92,233,146,1032,204,119,97,913,209,2428
15000US060190053043,310,111,134,97,0,12,134,97,176,83,71,47,105,66,2429
15000US060190053051,568,94,137,83,64,64,73,57,431,96,216,86,215,77,2430
15000US060190053052,593,103,141,75,18,24,123,72,452,99,158,71,294,98,2431
15000US060190054031,652,90,190,82,51,41,139,73,462,82,101,52,361,70,2432
15000US060190054032,289,61,41,36,14,18,27,31,248,66,63,41,185,59,2433
15000US060190054033,443,85,200,76,35,32,165,71,243,82,54,41,189,74,2434
15000US060190054051,522,91,34,25,6,13,28,24,488,93,140,63,348,90,2435
15000US060190054052,375,59,15,17,15,17,0,12,360,59,102,38,258,62,2436
15000US060190054053,474,71,4,7,4,7,0,12,470,71,216,69,254,70,2437
15000US060190054061,446,76,34,29,13,15,21,26,412,77,135,56,277,71,2438
15000US060190054062,332,68,12,19,0,12,12,19,320,70,47,29,273,74,2439
15000US060190054063,628,78,74,41,0,12,74,41,554,80,142,67,412,85,2440
15000US060190054071,468,87,28,30,28,30,0,12,440,91,112,62,328,93,2441
15000US060190054072,819,95,72,65,7,13,65,64,747,104,161,59,586,101,2442
15000US060190054081,414,50,54,21,9,9,45,19,360,55,79,39,281,59,2443
15000US060190054091,854,118,314,96,75,52,239,104,540,124,92,41,448,126,2444
15000US060190054092,543,80,11,19,11,19,0,12,532,79,132,54,400,84,2445
15000US060190054101,251,76,15,20,11,18,4,9,236,76,56,44,180,84,2446
15000US060190054102,921,93,264,116,91,63,173,106,657,117,167,64,490,116,2447
15000US060190055031,1070,146,23,36,0,12,23,36,1047,147,319,98,728,127,2448
15000US060190055032,1030,130,51,43,32,36,19,22,979,135,201,88,778,115,2449
15000US060190055041,1055,21,45,30,13,19,32,24,1010,37,172,66,838,64,2450
15000US060190055051,2126,81,169,126,0,17,169,126,1957,146,385,128,1572,178,2451
15000US060190055071,1164,126,64,73,0,12,64,73,1100,132,194,104,906,153,2452
15000US060190055072,1031,136,19,27,0,12,19,27,1012,141,108,66,904,141,2453
15000US060190055081,828,138,58,56,30,34,28,45,770,140,119,62,651,137,2454
15000US060190055082,958,127,30,27,12,19,18,19,928,133,179,76,749,128,2455
15000US060190055091,760,84,35,31,22,23,13,21,725,87,134,61,591,93,2456
15000US060190055092,916,96,173,76,65,53,108,70,743,88,135,67,608,90,2457
15000US060190055101,950,159,82,76,17,27,65,69,868,167,482,168,386,123,2458
15000US060190055102,671,94,0,12,0,12,0,12,671,94,173,113,498,139,2459
15000US060190055103,655,146,63,80,0,12,63,80,592,140,174,86,418,152,2460
15000US060190055121,703,83,5,9,0,12,5,9,698,83,185,60,513,90,2461
15000US060190055122,909,99,49,33,0,12,49,33,860,93,191,60,669,97,2462
15000US060190055131,523,58,42,36,21,20,21,33,481,62,99,55,382,51,2463
15000US060190055132,440,63,24,25,9,10,15,23,416,56,63,26,353,58,2464
15000US060190055141,507,80,0,12,0,12,0,12,507,80,158,69,349,75,2465
15000US060190055142,459,78,13,14,7,11,6,9,446,80,49,30,397,79,2466
15000US060190055143,441,77,23,22,14,17,9,14,418,72,95,54,323,80,2467
15000US060190055151,604,48,17,28,17,28,0,12,587,55,157,56,430,66,2468
15000US060190055161,964,158,76,77,16,25,60,70,888,156,79,76,809,143,2469
15000US060190055162,761,154,14,23,0,12,14,23,747,153,142,71,605,150,2470
15000US060190055163,780,159,38,39,0,12,38,39,742,158,69,55,673,170,2471
15000US060190055171,1276,134,16,25,16,25,0,12,1260,134,185,120,1075,147,2472
15000US060190055172,780,125,25,37,25,37,0,12,755,128,124,76,631,144,2473
15000US060190055173,649,135,13,23,0,12,13,23,636,135,129,82,507,141,2474
15000US060190055181,1619,76,42,51,29,45,13,21,1577,88,203,87,1374,120,2475
15000US060190055201,542,50,7,10,7,10,0,12,535,51,79,33,456,51,2476
15000US060190055202,25,10,11,9,11,9,0,12,14,8,0,12,14,8,2477
15000US060190055203,239,42,0,12,0,12,0,12,239,42,28,20,211,46,2478
15000US060190055221,110,36,0,12,0,12,0,12,110,36,40,30,70,44,2479
15000US060190055222,190,43,0,12,0,12,0,12,190,43,24,21,166,50,2480
15000US060190055223,950,92,54,52,25,30,29,44,896,102,129,64,767,108,2481
15000US060190055224,76,28,0,12,0,12,0,12,76,28,14,17,62,27,2482
15000US060190055241,1581,62,44,48,44,48,0,12,1537,78,264,83,1273,114,2483
15000US060190055251,106,33,0,12,0,12,0,12,106,33,30,21,76,33,2484
15000US060190055252,321,48,0,12,0,12,0,12,321,48,69,31,252,57,2485
15000US060190056021,534,100,103,78,84,72,19,31,431,99,167,83,264,89,2486
15000US060190056022,491,129,34,39,21,34,13,23,457,132,129,83,328,136,2487
15000US060190056023,690,138,164,117,52,60,112,108,526,133,187,107,339,130,2488
15000US060190056024,479,156,66,100,0,12,66,100,413,146,67,53,346,148,2489
15000US060190056051,522,26,21,21,21,21,0,12,501,34,161,38,340,51,2490
15000US060190056061,578,75,114,72,43,50,71,59,464,82,75,48,389,83,2491
15000US060190056062,773,96,72,34,48,33,24,20,701,87,131,54,570,101,2492
15000US060190056071,523,109,78,54,14,15,64,52,445,119,207,92,238,88,2493
15000US060190056072,470,104,40,30,13,15,27,25,430,105,161,90,269,78,2494
15000US060190056073,511,121,254,109,179,106,75,58,257,84,65,62,192,70,2495
15000US060190056074,341,85,60,40,33,32,27,25,281,81,55,29,226,82,2496
15000US060190056081,495,90,93,56,55,39,38,37,402,95,184,72,218,87,2497
15000US060190056082,369,83,50,48,42,46,8,15,319,90,104,44,215,83,2498
15000US060190056083,297,70,73,53,35,33,38,46,224,66,149,61,75,48,2499
15000US060190056084,271,90,63,53,20,30,43,46,208,81,28,19,180,83,2500
15000US060190057011,439,68,11,15,11,15,0,12,428,68,172,68,256,59,2501
15000US060190057012,269,79,30,36,30,36,0,12,239,82,80,65,159,74,2502
15000US060190057013,256,65,84,44,52,37,32,26,172,68,51,36,121,77,2503
15000US060190057014,383,85,34,40,9,14,25,38,349,78,128,76,221,62,2504
15000US060190057021,357,68,11,13,4,6,7,11,346,69,87,66,259,66,2505
15000US060190057022,606,95,35,28,6,10,29,27,571,96,83,55,488,94,2506
15000US060190057023,363,60,38,30,11,14,27,27,325,70,20,23,305,70,2507
15000US060190057024,516,88,0,12,0,12,0,12,516,88,114,51,402,89,2508
15000US060190057031,241,43,0,12,0,12,0,12,241,43,71,50,170,40,2509
15000US060190057032,521,74,18,19,9,15,9,13,503,75,59,34,444,80,2510
15000US060190057033,562,65,8,12,8,12,0,12,554,65,111,49,443,77,2511
15000US060190057034,408,65,38,35,25,28,13,19,370,69,53,36,317,71,2512
15000US060190057041,581,104,249,88,113,59,136,68,332,95,145,79,187,84,2513
15000US060190057042,403,74,51,43,27,38,24,25,352,67,100,40,252,65,2514
15000US060190057043,432,71,54,44,17,20,37,39,378,74,168,59,210,62,2515
15000US060190057044,353,78,63,41,44,36,19,21,290,91,92,65,198,77,2516
15000US060190058011,976,116,70,60,25,20,45,56,906,120,410,92,496,118,2517
15000US060190058012,461,99,32,29,9,16,23,27,429,100,82,54,347,94,2518
15000US060190058013,382,93,53,42,20,23,33,36,329,93,58,35,271,98,2519
15000US060190058021,665,70,33,31,7,11,26,29,632,75,131,48,501,79,2520
15000US060190058022,763,82,21,18,7,12,14,15,742,78,182,68,560,92,2521
15000US060190058041,367,121,127,106,127,106,0,12,240,104,45,43,195,96,2522
15000US060190058042,510,138,58,47,27,36,31,27,452,143,179,115,273,120,2523
15000US060190058043,471,104,97,94,0,12,97,94,374,111,112,56,262,109,2524
15000US060190058044,287,95,61,54,0,12,61,54,226,91,81,79,145,100,2525
15000US060190058045,358,108,159,81,52,73,107,96,199,90,81,70,118,82,2526
15000US060190058051,1392,80,74,46,27,28,47,36,1318,88,250,78,1068,78,2527
15000US060190059041,1339,92,49,33,0,12,49,33,1290,100,264,73,1026,115,2528
15000US060190059042,217,81,17,28,0,12,17,28,200,81,48,41,152,81,2529
15000US060190059051,221,77,40,46,0,12,40,46,181,74,29,32,152,68,2530
15000US060190059052,1675,167,134,104,121,106,13,21,1541,184,354,98,1187,209,2531
15000US060190059053,521,126,23,34,0,12,23,34,498,128,136,86,362,129,2532
15000US060190059061,549,61,17,16,0,12,17,16,532,60,177,44,355,62,2533
15000US060190059062,208,54,13,14,0,12,13,14,195,56,35,29,160,54,2534
15000US060190059071,17,24,0,12,0,12,0,12,17,24,0,12,17,24,2535
15000US060190059072,921,46,35,31,19,29,16,15,886,50,140,42,746,59,2536
15000US060190059091,1193,124,0,12,0,12,0,12,1193,124,328,110,865,148,2537
15000US060190059092,707,112,28,24,13,14,15,19,679,114,114,49,565,114,2538
15000US060190059111,1219,98,27,26,11,17,16,20,1192,102,195,94,997,126,2539
15000US060190059112,181,101,0,12,0,12,0,12,181,101,0,12,181,101,2540
15000US060190059121,866,79,36,37,36,37,0,12,830,85,177,71,653,104,2541
15000US060190059122,445,80,28,32,0,12,28,32,417,82,93,48,324,82,2542
15000US060190060001,1482,208,33,32,0,12,33,32,1449,209,375,156,1074,216,2543
15000US060190060002,284,110,110,78,0,12,110,78,174,103,52,55,122,87,2544
15000US060190060003,281,113,61,71,24,34,37,60,220,94,65,43,155,93,2545
15000US060190060004,445,134,19,24,0,12,19,24,426,135,149,79,277,121,2546
15000US060190060005,261,88,83,70,0,12,83,70,178,69,30,49,148,60,2547
15000US060190061001,300,90,20,32,20,32,0,12,280,89,71,75,209,85,2548
15000US060190061002,431,127,183,98,30,34,153,97,248,115,72,55,176,110,2549
15000US060190061003,378,93,69,68,69,68,0,12,309,105,35,36,274,105,2550
15000US060190061004,305,95,77,65,14,23,63,62,228,84,22,35,206,82,2551
15000US060190061005,699,139,120,95,37,51,83,88,579,126,96,77,483,141,2552
15000US060190062011,326,61,159,63,37,29,122,57,167,57,53,39,114,47,2553
15000US060190062012,302,54,88,53,26,28,62,44,214,57,41,26,173,58,2554
15000US060190062021,383,114,90,68,34,41,56,51,293,101,96,57,197,92,2555
15000US060190062022,313,80,43,51,43,51,0,12,270,74,81,58,189,67,2556
15000US060190062023,400,108,226,90,65,56,161,78,174,83,120,69,54,51,2557
15000US060190062024,521,106,149,63,30,24,119,60,372,93,197,82,175,83,2558
15000US060190063001,649,129,46,75,46,75,0,12,603,116,167,108,436,127,2559
15000US060190063002,313,117,17,27,0,12,17,27,296,125,71,53,225,135,2560
15000US060190063003,605,105,0,12,0,12,0,12,605,105,165,100,440,121,2561
15000US060190063004,241,121,28,33,16,25,12,20,213,127,82,81,131,105,2562
15000US060190063005,581,131,48,44,14,24,34,36,533,121,48,51,485,123,2563
15000US060190064021,77,26,0,12,0,12,0,12,77,26,21,17,56,19,2564
15000US060190064022,458,66,25,14,10,10,15,9,433,66,122,38,311,58,2565
15000US060190064023,462,79,40,22,23,19,17,11,422,75,140,46,282,66,2566
15000US060190064024,42,21,0,12,0,12,0,12,42,21,4,6,38,20,2567
15000US060190064025,22,15,0,12,0,12,0,12,22,15,2,3,20,14,2568
15000US060190064026,146,45,8,11,2,4,6,10,138,43,31,20,107,35,2569
15000US060190064031,737,165,20,24,20,24,0,12,717,166,266,128,451,131,2570
15000US060190064032,150,85,43,69,43,69,0,12,107,64,28,31,79,56,2571
15000US060190064033,487,158,24,41,24,41,0,12,463,160,62,46,401,161,2572
15000US060190064034,659,124,108,90,43,59,65,76,551,141,188,109,363,145,2573
15000US060190064041,641,123,0,12,0,12,0,12,641,123,181,78,460,111,2574
15000US060190064042,278,78,28,33,0,12,28,33,250,77,129,65,121,49,2575
15000US060190064043,978,121,87,62,52,42,35,46,891,134,278,100,613,131,2576
15000US060190064051,685,82,40,49,4,7,36,49,645,98,141,68,504,97,2577
15000US060190064052,646,122,86,59,47,37,39,51,560,116,114,69,446,117,2578
15000US060190064053,510,98,57,38,26,24,31,27,453,105,103,56,350,99,2579
15000US060190065011,999,117,451,113,229,91,222,90,548,94,187,88,361,91,2580
15000US060190065012,273,61,128,60,0,12,128,60,145,54,54,43,91,43,2581
15000US060190065013,291,81,104,66,33,29,71,66,187,66,69,49,118,66,2582
15000US060190065021,403,109,160,74,108,66,52,40,243,107,34,25,209,107,2583
15000US060190065022,702,122,323,125,129,81,194,94,379,118,125,61,254,106,2584
15000US060190066021,293,70,92,50,35,36,57,36,201,70,116,60,85,42,2585
15000US060190066022,548,93,74,51,18,21,56,46,474,95,117,50,357,96,2586
15000US060190066023,477,102,111,60,17,19,94,59,366,102,126,70,240,90,2587
15000US060190066024,304,84,163,73,33,26,130,73,141,67,63,46,78,46,2588
15000US060190066031,302,62,45,27,27,21,18,16,257,62,72,35,185,71,2589
15000US060190066032,391,72,30,21,5,7,25,21,361,72,86,48,275,66,2590
15000US060190066041,633,125,238,105,74,53,164,99,395,116,149,73,246,101,2591
15000US060190066042,659,107,310,109,44,48,266,106,349,90,132,70,217,84,2592
15000US060190066043,127,74,76,68,0,12,76,68,51,37,0,12,51,37,2593
15000US060190066044,253,60,29,27,18,24,11,16,224,60,72,42,152,51,2594
15000US060190066045,313,101,96,65,17,28,79,60,217,91,102,73,115,72,2595
15000US060190067001,487,120,0,12,0,12,0,12,487,120,165,86,322,123,2596
15000US060190067002,290,119,55,62,0,12,55,62,235,112,43,46,192,111,2597
15000US060190067003,689,142,117,91,43,51,74,76,572,147,159,87,413,143,2598
15000US060190067004,408,100,19,32,0,12,19,32,389,98,103,55,286,104,2599
15000US060190067005,372,106,75,66,31,46,44,42,297,111,60,53,237,128,2600
15000US060190068021,268,101,143,98,66,61,77,80,125,82,0,12,125,82,2601
15000US060190068022,182,75,12,18,12,18,0,12,170,73,63,57,107,55,2602
15000US060190068023,435,104,91,79,91,79,0,12,344,128,42,33,302,125,2603
15000US060190068024,201,101,83,78,15,25,68,73,118,77,35,33,83,71,2604
15000US060190069001,403,79,140,67,52,37,88,55,263,77,116,49,147,65,2605
15000US060190069002,225,54,47,38,19,25,28,24,178,54,79,41,99,45,2606
15000US060190069003,256,68,19,15,3,5,16,15,237,68,64,31,173,65,2607
15000US060190070021,376,95,108,53,17,18,91,50,268,98,61,31,207,98,2608
15000US060190070022,489,109,139,87,8,13,131,88,350,86,100,52,250,81,2609
15000US060190070023,468,114,135,91,4,10,131,90,333,102,112,62,221,105,2610
15000US060190070031,525,151,35,38,21,26,14,23,490,154,64,40,426,148,2611
15000US060190070032,908,149,259,120,111,97,148,84,649,159,180,92,469,161,2612
15000US060190070033,368,112,13,22,0,12,13,22,355,113,36,31,319,116,2613
15000US060190070034,379,118,23,28,0,12,23,28,356,121,63,49,293,120,2614
15000US060190070041,320,60,14,23,14,23,0,12,306,58,93,41,213,50,2615
15000US060190070042,1016,113,91,52,39,37,52,44,925,112,248,77,677,110,2616
15000US060190070043,418,83,76,56,27,30,49,44,342,77,147,73,195,64,2617
15000US060190071001,379,96,111,61,44,46,67,54,268,84,104,41,164,86,2618
15000US060190071002,160,68,12,20,0,12,12,20,148,67,36,28,112,65,2619
15000US060190071003,168,51,27,33,27,33,0,12,141,49,40,24,101,46,2620
15000US060190071004,437,90,163,81,55,49,108,69,274,81,66,43,208,80,2621
15000US060190071005,797,103,237,85,34,25,203,88,560,102,129,63,431,97,2622
15000US060190072011,504,128,6,10,0,12,6,10,498,126,101,59,397,126,2623
15000US060190072012,556,109,0,12,0,12,0,12,556,109,105,68,451,96,2624
15000US060190072013,485,124,15,25,0,12,15,25,470,124,153,83,317,120,2625
15000US060190072014,403,115,100,93,83,88,17,27,303,114,11,18,292,114,2626
15000US060190072015,720,136,100,79,73,78,27,30,620,129,224,84,396,122,2627
15000US060190072021,441,106,125,50,37,29,88,39,316,95,90,47,226,99,2628
15000US060190072022,1132,129,176,77,19,17,157,78,956,117,263,85,693,114,2629
15000US060190073001,209,51,34,21,17,16,17,13,175,50,51,30,124,46,2630
15000US060190073002,274,79,20,30,0,12,20,30,254,78,66,33,188,79,2631
15000US060190073003,265,86,25,23,25,23,0,12,240,81,69,30,171,81,2632
15000US060190073004,205,81,48,42,8,12,40,41,157,74,56,46,101,57,2633
15000US060190073005,304,77,61,47,31,37,30,31,243,68,63,57,180,60,2634
15000US060190074001,241,61,26,21,6,10,20,18,215,58,87,41,128,48,2635
15000US060190074002,273,80,52,42,28,33,24,25,221,69,90,54,131,50,2636
15000US060190074003,524,74,92,56,11,16,81,51,432,80,94,48,338,84,2637
15000US060190075001,277,78,45,48,27,43,18,21,232,75,53,38,179,71,2638
15000US060190075002,181,50,33,17,10,10,23,15,148,48,54,28,94,41,2639
15000US060190075003,264,86,112,81,9,11,103,80,152,57,62,55,90,50,2640
15000US060190075004,294,85,37,42,0,12,37,42,257,80,98,70,159,82,2641
15000US060190075005,433,97,95,49,49,38,46,26,338,96,100,64,238,90,2642
15000US060190076001,270,69,64,47,30,40,34,27,206,62,39,23,167,63,2643
15000US060190076002,215,62,45,28,7,10,38,26,170,60,35,20,135,58,2644
15000US060190076003,328,77,131,59,23,19,108,57,197,65,62,25,135,58,2645
15000US060190076004,454,75,96,56,37,25,59,50,358,76,44,22,314,77,2646
15000US060190077001,597,128,104,72,44,39,60,62,493,118,41,31,452,118,2647
15000US060190077002,322,100,0,12,0,12,0,12,322,100,53,42,269,94,2648
15000US060190077003,475,107,135,72,76,62,59,41,340,106,168,77,172,72,2649
15000US060190077004,136,66,79,58,4,7,75,58,57,40,7,11,50,38,2650
15000US060190078011,621,58,135,72,56,50,79,55,486,76,173,66,313,78,2651
15000US060190078021,218,51,63,37,0,12,63,37,155,38,53,26,102,33,2652
15000US060190078022,219,67,84,48,17,27,67,48,135,64,19,30,116,57,2653
15000US060190078023,525,114,266,80,17,27,249,75,259,94,61,48,198,83,2654
15000US060190078024,401,100,94,60,0,12,94,60,307,96,40,45,267,95,2655
15000US060190079011,0,12,0,12,0,12,0,12,0,12,0,12,0,12,2656
15000US060190079021,429,69,43,34,15,21,28,28,386,67,40,22,346,65,2657
15000US060190079022,433,69,83,33,25,20,58,29,350,68,55,31,295,63,2658
15000US060190080001,93,46,0,12,0,12,0,12,93,46,27,31,66,52,2659
15000US060190080002,527,119,66,64,60,62,6,11,461,132,190,99,271,110,2660
15000US060190080003,276,84,36,42,36,42,0,12,240,87,45,37,195,83,2661
15000US060190080004,483,112,135,73,51,59,84,53,348,106,130,69,218,86,2662
15000US060190080005,366,89,23,23,0,12,23,23,343,92,137,61,206,80,2663
15000US060190081001,490,98,78,59,0,12,78,59,412,94,101,43,311,91,2664
15000US060190081002,756,121,245,90,47,47,198,74,511,139,89,52,422,132,2665
15000US060190081003,217,59,105,62,37,38,68,60,112,53,42,24,70,47,2666
15000US060190081004,456,99,117,64,24,36,93,65,339,86,101,61,238,82,2667
15000US060190082001,141,60,25,32,9,14,16,27,116,66,26,30,90,66,2668
15000US060190082002,195,69,49,44,16,26,33,36,146,70,50,46,96,55,2669
15000US060190082003,136,46,16,21,0,12,16,21,120,49,23,27,97,48,2670
15000US060190082004,816,90,271,65,75,41,196,66,545,90,73,45,472,86,2671
15000US060190082005,183,53,148,46,5,7,143,48,35,29,13,22,22,20,2672
15000US060190082006,248,73,65,41,23,27,42,33,183,64,10,13,173,63,2673
15000US060190083011,297,87,48,44,7,12,41,41,249,84,32,42,217,85,2674
15000US060190083012,524,98,228,82,41,35,187,86,296,98,123,59,173,83,2675
15000US060190083013,668,112,250,92,25,42,225,84,418,130,104,66,314,122,2676
15000US060190083021,718,91,306,87,6,11,300,88,412,108,123,63,289,95,2677
15000US060190083022,151,52,27,30,0,12,27,30,124,51,0,12,124,51,2678
15000US060190083023,128,68,53,49,8,12,45,48,75,45,31,40,44,29,2679
15000US060190083024,231,65,68,37,20,24,48,29,163,70,7,11,156,71,2680
15000US060190083025,424,75,112,59,16,24,96,56,312,75,89,48,223,73,2681
15000US060190084011,742,163,420,158,19,30,401,159,322,134,50,65,272,125,2682
15000US060190084012,280,99,30,53,30,53,0,12,250,105,68,70,182,101,2683
15000US060190084013,264,102,74,57,20,32,54,55,190,85,0,12,190,85,2684
15000US060190084014,414,133,139,75,15,27,124,80,275,118,71,52,204,123,2685
15000US060190084015,330,114,22,36,22,36,0,12,308,126,85,76,223,117,2686
15000US060190084016,336,112,65,63,0,12,65,63,271,112,94,66,177,105,2687
15000US060190084021,189,42,11,11,2,4,9,10,178,43,43,28,135,46,2688
15000US060190084022,152,41,39,23,3,5,36,22,113,42,33,27,80,41,2689
15000US060190085011,437,79,157,61,39,38,118,52,280,78,39,35,241,80,2690
15000US060190085012,411,97,173,77,69,53,104,64,238,78,94,52,144,66,2691
15000US060190085013,262,61,91,59,29,33,62,49,171,55,67,39,104,47,2692
15000US060190085021,594,114,152,65,36,43,116,52,442,107,111,60,331,103,2693
15000US060190085022,693,97,189,73,38,36,151,72,504,103,118,53,386,98,2694
15000US060190085023,778,115,501,108,75,54,426,99,277,97,84,53,193,89,2695
15000US060210101001,823,141,92,68,23,28,69,58,731,140,265,104,466,141,2696
15000US060210101002,881,174,125,96,0,12,125,96,756,161,319,126,437,146,2697
15000US060210101003,740,155,53,53,0,12,53,53,687,148,289,108,398,142,2698
15000US060210101004,369,100,60,49,24,29,36,42,309,98,74,51,235,91,2699
15000US060210102001,383,80,15,16,15,16,0,12,368,81,117,57,251,72,2700
15000US060210102002,663,98,55,41,40,40,15,18,608,104,245,101,363,95,2701
15000US060210102003,192,43,19,15,19,15,0,12,173,44,65,30,108,43,2702
15000US060210102004,520,111,109,109,109,109,0,12,411,89,200,84,211,84,2703
15000US060210103001,202,37,0,12,0,12,0,12,202,37,106,36,96,35,2704
15000US060210103002,317,69,15,15,9,13,6,8,302,66,137,54,165,52,2705
15000US060210103003,283,56,45,27,16,13,29,23,238,50,111,35,127,45,2706
15000US060210104001,494,134,49,42,38,37,11,19,445,136,266,87,179,117,2707
15000US060210104002,587,147,0,12,0,12,0,12,587,147,149,61,438,146,2708
15000US060210104003,393,126,127,89,99,80,28,41,266,98,85,45,181,97,2709
15000US060210104004,338,120,131,94,26,35,105,89,207,88,111,81,96,66,2710
15000US060210104005,349,104,30,35,0,12,30,35,319,104,133,72,186,95,2711
15000US060210104006,241,99,8,19,8,19,0,12,233,100,125,79,108,60,2712
15000US060210104007,249,87,17,30,17,30,0,12,232,94,35,37,197,100,2713
15000US060210105011,599,89,98,56,36,35,62,45,501,101,157,54,344,87,2714
15000US060210105012,251,45,25,20,8,9,17,18,226,45,79,27,147,36,2715
15000US060210105013,307,69,51,40,26,27,25,30,256,70,60,41,196,64,2716
15000US060210105021,317,50,0,12,0,12,0,12,317,50,88,34,229,55,2717
15000US060210105022,303,46,33,26,13,14,20,23,270,45,66,26,204,47,2718
15000US060230001001,527,122,137,79,64,50,73,61,390,108,129,68,261,97,2719
15000US060230001002,696,122,88,59,8,13,80,58,608,118,173,73,435,128,2720
15000US060230001003,290,106,25,30,0,12,25,30,265,104,59,62,206,93,2721
15000US060230001004,382,105,67,47,39,34,28,33,315,104,121,84,194,75,2722
15000US060230002001,378,108,21,34,0,12,21,34,357,105,129,63,228,99,2723
15000US060230002002,335,111,56,57,0,12,56,57,279,102,117,67,162,84,2724
15000US060230002003,279,105,53,52,9,17,44,50,226,100,110,74,116,97,2725
15000US060230002004,414,137,50,43,16,27,34,31,364,134,206,137,158,98,2726
15000US060230002005,376,131,36,41,0,12,36,41,340,132,100,69,240,123,2727
15000US060230002006,477,127,15,19,0,12,15,19,462,126,165,111,297,123,2728
15000US060230003001,254,83,88,69,29,36,59,58,166,76,86,57,80,63,2729
15000US060230003002,252,79,0,12,0,12,0,12,252,79,36,42,216,86,2730
15000US060230003003,397,105,92,67,0,12,92,67,305,102,135,73,170,85,2731
15000US060230003004,841,128,157,99,41,50,116,92,684,133,178,96,506,133,2732
15000US060230003005,553,93,116,73,79,67,37,35,437,92,108,63,329,97,2733
15000US060230004001,402,83,13,17,13,17,0,12,389,84,80,39,309,79,2734
15000US060230004002,351,91,21,24,21,24,0,12,330,91,75,43,255,84,2735
15000US060230004003,820,121,97,66,56,43,41,47,723,129,327,127,396,97,2736
15000US060230005001,363,101,51,35,25,24,26,22,312,95,79,52,233,89,2737
15000US060230005002,546,86,37,23,22,16,15,18,509,90,232,81,277,83,2738
15000US060230005003,288,84,72,71,0,12,72,71,216,64,84,33,132,62,2739
15000US060230005004,555,116,70,52,9,19,61,48,485,124,207,96,278,80,2740
15000US060230006001,278,89,0,12,0,12,0,12,278,89,86,61,192,80,2741
15000US060230006002,394,80,14,22,0,12,14,22,380,83,142,71,238,89,2742
15000US060230006003,379,80,36,33,22,27,14,27,343,84,47,38,296,82,2743
15000US060230006004,548,108,89,69,49,45,40,49,459,118,107,78,352,92,2744
15000US060230006005,406,95,21,33,0,12,21,33,385,88,160,77,225,97,2745
15000US060230007001,538,96,47,44,29,35,18,29,491,109,146,88,345,104,2746
15000US060230007002,793,138,143,75,46,42,97,63,650,144,214,99,436,124,2747
15000US060230007003,618,112,42,38,31,34,11,18,576,118,190,71,386,121,2748
15000US060230007004,297,64,0,12,0,12,0,12,297,64,95,45,202,68,2749
15000US060230008001,610,130,55,54,0,12,55,54,555,117,158,84,397,121,2750
15000US060230008002,728,127,51,46,51,46,0,12,677,135,235,79,442,122,2751
15000US060230008003,753,120,94,63,66,50,28,31,659,113,173,87,486,104,2752
15000US060230009001,726,95,61,39,11,12,50,38,665,95,80,47,585,99,2753
15000US060230009002,553,67,0,12,0,12,0,12,553,67,123,54,430,69,2754
15000US060230009003,1016,96,93,51,30,29,63,41,923,103,189,62,734,95,2755
15000US060230010001,628,143,92,66,17,28,75,66,536,143,60,60,476,154,2756
15000US060230010002,74,28,0,12,0,12,0,12,74,28,21,33,53,42,2757
15000US060230010003,364,117,33,36,33,36,0,12,331,120,17,28,314,125,2758
15000US060230010004,735,156,181,86,77,56,104,69,554,155,114,71,440,155,2759
15000US060230010005,671,157,170,121,81,69,89,101,501,134,70,53,431,135,2760
15000US060230011011,656,133,77,67,35,44,42,49,579,140,164,51,415,126,2761
15000US060230011012,625,146,209,108,91,73,118,86,416,145,152,94,264,110,2762
15000US060230011013,652,129,93,66,36,45,57,50,559,136,111,70,448,145,2763
15000US060230011014,632,139,164,115,0,12,164,115,468,121,155,87,313,118,2764
15000US060230012001,932,136,126,80,39,50,87,70,806,126,156,65,650,115,2765
15000US060230012002,434,81,0,12,0,12,0,12,434,81,104,44,330,86,2766
15000US060230012003,595,120,138,61,83,47,55,37,457,115,144,75,313,104,2767
15000US060230013001,533,66,76,29,40,19,36,22,457,68,119,52,338,58,2768
15000US060230101021,575,137,95,78,0,12,95,78,480,127,167,92,313,118,2769
15000US060230101022,107,30,15,11,2,4,13,11,92,28,34,15,58,27,2770
15000US060230101023,268,93,54,38,22,26,32,36,214,87,46,42,168,79,2771
15000US060230101024,173,92,25,39,25,39,0,12,148,84,60,58,88,65,2772
15000US060230102001,535,64,74,33,43,18,31,27,461,62,158,42,303,60,2773
15000US060230102002,243,47,13,14,2,5,11,12,230,43,53,24,177,35,2774
15000US060230102003,360,58,0,12,0,12,0,12,360,58,105,44,255,49,2775
15000US060230103001,292,34,23,17,9,10,14,13,269,29,63,18,206,30,2776
15000US060230103002,307,53,16,13,16,13,0,12,291,54,52,26,239,50,2777
15000US060230103003,239,59,28,26,16,19,12,19,211,55,63,35,148,47,2778
15000US060230103004,356,72,4,5,4,5,0,12,352,73,84,35,268,69,2779
15000US060230103005,241,76,17,25,1,2,16,25,224,74,24,12,200,75,2780
15000US060230104001,807,109,109,68,23,33,86,58,698,103,156,67,542,106,2781
15000US060230104002,624,77,13,15,13,15,0,12,611,77,100,54,511,74,2782
15000US060230105011,809,159,109,82,39,46,70,68,700,147,170,74,530,150,2783
15000US060230105012,798,182,111,87,20,35,91,75,687,166,224,86,463,170,2784
15000US060230105013,663,121,11,19,0,12,11,19,652,127,261,121,391,116,2785
15000US060230105014,591,142,78,87,25,43,53,73,513,127,177,91,336,114,2786
15000US060230105021,880,136,124,93,110,92,14,23,756,141,248,85,508,126,2787
15000US060230105022,607,122,12,18,0,12,12,18,595,127,136,67,459,129,2788
15000US060230105023,674,136,16,26,16,26,0,12,658,137,160,105,498,127,2789
15000US060230106001,496,41,14,10,7,8,7,8,482,41,110,31,372,49,2790
15000US060230106002,299,41,5,6,0,12,5,6,294,42,58,29,236,48,2791
15000US060230107001,287,94,21,26,21,26,0,12,266,103,57,38,209,107,2792
15000US060230107002,854,169,58,52,47,52,11,20,796,166,364,153,432,96,2793
15000US060230107003,892,128,55,49,55,49,0,12,837,138,276,106,561,166,2794
15000US060230107004,213,120,38,43,21,33,17,25,175,116,53,85,122,86,2795
15000US060230107005,465,131,78,106,0,12,78,106,387,141,80,57,307,145,2796
15000US060230108001,477,90,106,50,54,39,52,32,371,77,169,49,202,60,2797
15000US060230108002,507,104,46,52,8,13,38,50,461,98,133,73,328,101,2798
15000US060230108003,305,84,31,38,7,11,24,35,274,77,62,48,212,74,2799
15000US060230108004,372,76,49,48,41,46,8,12,323,84,99,56,224,72,2800
15000US060230109011,332,68,47,34,10,16,37,31,285,74,98,44,187,66,2801
15000US060230109012,487,97,109,60,103,60,6,11,378,97,171,79,207,74,2802
15000US060230109013,842,133,79,64,40,42,39,52,763,134,342,110,421,90,2803
15000US060230109021,237,48,19,16,3,5,16,15,218,47,72,27,146,43,2804
15000US060230109022,377,57,24,15,17,15,7,7,353,59,157,40,196,48,2805
15000US060230109023,397,67,0,12,0,12,0,12,397,67,68,33,329,69,2806
15000US060230109024,540,77,26,22,15,16,11,15,514,76,137,45,377,79,2807
15000US060230110001,824,102,84,54,27,26,57,49,740,104,206,72,534,106,2808
15000US060230110002,651,93,66,44,31,31,35,30,585,95,227,63,358,92,2809
15000US060230110003,318,64,0,12,0,12,0,12,318,64,83,37,235,61,2810
15000US060230111001,554,124,53,37,27,24,26,30,501,124,193,92,308,105,2811
15000US060230111002,451,85,54,34,32,36,22,24,397,87,220,88,177,63,2812
15000US060230111003,490,100,0,12,0,12,0,12,490,100,104,51,386,95,2813
15000US060230111004,381,71,83,42,38,30,45,33,298,69,84,34,214,58,2814
15000US060230112001,464,70,100,41,33,23,67,36,364,67,165,60,199,58,2815
15000US060230112002,368,58,26,24,18,21,8,12,342,60,140,48,202,53,2816
15000US060230112003,564,82,46,27,8,11,38,25,518,85,174,63,344,73,2817
15000US060230115001,416,163,42,65,0,12,42,65,374,152,72,78,302,135,2818
15000US060230115002,583,206,84,93,81,93,3,5,499,168,81,56,418,155,2819
15000US060230115003,448,154,18,30,18,30,0,12,430,151,15,23,415,153,2820
15000US060230116001,467,121,29,25,29,25,0,12,438,125,128,67,310,116,2821
15000US060230116002,608,136,65,50,36,41,29,35,543,136,110,64,433,122,2822
15000US060230116003,579,124,0,12,0,12,0,12,579,124,139,74,440,117,2823
15000US060239400001,578,78,193,52,101,35,92,43,385,60,157,45,228,57,2824
15000US060239400002,473,62,134,46,72,38,62,30,339,62,121,43,218,57,2825
15000US060239901000,0,12,0,12,0,12,0,12,0,12,0,12,0,12,2826
15000US060250101011,60,37,0,12,0,12,0,12,60,37,13,16,47,34,2827
15000US060250101021,461,104,47,46,16,28,31,35,414,111,151,69,263,104,2828
15000US060250101022,288,69,127,45,42,35,85,38,161,57,89,45,72,39,2829
15000US060250101023,363,76,54,38,18,21,36,32,309,79,63,40,246,72,2830
15000US060250101024,267,65,61,42,0,12,61,42,206,62,41,26,165,58,2831
15000US060250102001,295,47,38,26,3,6,35,25,257,45,120,38,137,39,2832
15000US060250102002,393,58,118,40,62,30,56,28,275,53,107,37,168,43,2833
15000US060250103001,316,34,50,21,31,18,19,13,266,36,90,31,176,35,2834
15000US060250104001,255,90,97,67,80,66,17,29,158,72,52,37,106,69,2835
15000US060250104002,378,120,219,120,55,56,164,102,159,99,85,83,74,65,2836
15000US060250104003,253,134,71,75,11,20,60,73,182,117,43,56,139,109,2837
15000US060250104004,477,139,217,111,96,76,121,91,260,127,197,119,63,73,2838
15000US060250104005,621,151,409,147,134,110,275,120,212,91,135,74,77,73,2839
15000US060250105001,923,185,129,77,64,45,65,64,794,187,421,161,373,139,2840
15000US060250105002,344,115,185,117,37,44,148,109,159,75,34,38,125,72,2841
15000US060250105003,281,104,14,22,14,22,0,12,267,104,77,75,190,101,2842
15000US060250105004,406,121,14,21,0,12,14,21,392,119,202,83,190,120,2843
15000US060250106001,451,131,74,75,44,67,30,32,377,124,168,107,209,84,2844
15000US060250106002,343,144,112,100,49,77,63,59,231,131,98,95,133,99,2845
15000US060250106003,251,71,0,12,0,12,0,12,251,71,71,45,180,68,2846
15000US060250106004,947,157,51,45,11,19,40,39,896,160,193,82,703,154,2847
15000US060250107001,281,84,51,50,9,16,42,46,230,75,80,43,150,70,2848
15000US060250107002,374,75,132,70,25,30,107,65,242,67,159,63,83,45,2849
15000US060250107003,501,101,247,102,17,29,230,95,254,80,83,50,171,75,2850
15000US060250108001,198,55,37,19,29,16,8,9,161,53,66,41,95,39,2851
15000US060250108002,271,51,7,10,7,10,0,12,264,49,92,33,172,46,2852
15000US060250109001,605,154,209,109,46,51,163,109,396,141,180,89,216,109,2853
15000US060250109002,424,134,227,126,0,12,227,126,197,97,41,40,156,91,2854
15000US060250109003,444,138,53,66,37,61,16,27,391,138,166,101,225,109,2855
15000US060250109004,223,81,15,26,15,26,0,12,208,82,55,40,153,82,2856
15000US060250109005,187,106,67,82,0,12,67,82,120,88,40,37,80,84,2857
15000US060250109006,86,46,11,20,11,20,0,12,75,43,64,38,11,18,2858
15000US060250110001,280,113,13,24,0,12,13,24,267,119,24,32,243,123,2859
15000US060250110002,176,140,0,12,0,12,0,12,176,140,0,12,176,140,2860
15000US060250110003,168,90,14,22,14,22,0,12,154,87,55,46,99,86,2861
15000US060250110004,245,84,57,57,0,12,57,57,188,81,110,78,78,54,2862
15000US060250110005,1350,197,34,42,13,22,21,36,1316,199,309,112,1007,208,2863
15000US060250110006,1350,218,75,61,27,36,48,51,1275,216,273,115,1002,212,2864
15000US060250111001,150,42,5,8,0,12,5,8,145,43,38,26,107,37,2865
15000US060250111002,262,63,18,15,8,12,10,9,244,64,106,50,138,55,2866
15000US060250111003,409,88,99,56,33,36,66,45,310,85,117,60,193,66,2867
15000US060250112011,1193,128,85,53,47,37,38,34,1108,132,208,92,900,127,2868
15000US060250112012,506,101,122,74,28,32,94,71,384,87,113,57,271,82,2869
15000US060250112021,780,134,337,102,65,43,272,94,443,112,79,59,364,111,2870
15000US060250112022,564,108,190,83,96,65,94,60,374,104,116,79,258,88,2871
15000US060250112023,301,92,85,63,14,16,71,61,216,80,136,71,80,51,2872
15000US060250113001,999,142,109,57,23,27,86,49,890,149,108,63,782,145,2873
15000US060250113002,448,72,79,35,43,27,36,23,369,66,123,40,246,48,2874
15000US060250113003,456,115,117,72,32,34,85,64,339,111,70,47,269,105,2875
15000US060250113004,524,137,147,90,33,36,114,82,377,131,93,56,284,134,2876
15000US060250114001,375,89,163,68,38,39,125,65,212,73,82,40,130,72,2877
15000US060250114002,248,81,118,63,63,46,55,50,130,63,35,35,95,59,2878
15000US060250114003,555,93,170,64,97,60,73,41,385,92,155,66,230,77,2879
15000US060250115001,425,93,108,57,28,25,80,53,317,90,183,70,134,65,2880
15000US060250115002,340,74,101,58,59,47,42,32,239,62,92,45,147,59,2881
15000US060250115003,572,96,289,90,133,59,156,69,283,95,131,63,152,70,2882
15000US060250115004,320,74,56,43,7,11,49,40,264,67,110,56,154,53,2883
15000US060250116001,468,122,135,82,72,63,63,61,333,102,164,84,169,93,2884
15000US060250116002,749,152,196,107,71,74,125,89,553,145,257,102,296,123,2885
15000US060250116003,155,90,19,24,10,19,9,15,136,86,68,68,68,66,2886
15000US060250116004,485,149,142,101,111,98,31,37,343,129,104,74,239,120,2887
15000US060250117001,636,107,63,47,49,46,14,16,573,109,151,67,422,111,2888
15000US060250117002,349,73,41,31,41,31,0,12,308,81,121,67,187,78,2889
15000US060250117003,413,77,92,58,35,23,57,56,321,71,76,54,245,68,2890
15000US060250118011,520,92,71,48,33,36,38,31,449,84,142,59,307,82,2891
15000US060250118012,613,97,40,38,30,34,10,16,573,104,141,71,432,104,2892
15000US060250118021,619,94,150,69,101,63,49,52,469,91,167,72,302,77,2893
15000US060250118022,296,74,58,48,58,48,0,12,238,75,92,52,146,64,2894
15000US060250118023,493,79,73,55,38,31,35,47,420,69,93,43,327,69,2895
15000US060250118024,268,74,0,12,0,12,0,12,268,74,69,46,199,67,2896
15000US060250118031,1719,147,89,59,44,35,45,46,1630,152,338,105,1292,177,2897
15000US060250119001,121,77,88,81,88,81,0,12,33,39,33,39,0,12,2898
15000US060250119002,1989,191,266,115,106,66,160,95,1723,230,654,212,1069,216,2899
15000US060250119003,562,153,68,73,29,43,39,60,494,152,240,122,254,107,2900
15000US060250120011,732,117,287,113,53,38,234,105,445,124,278,106,167,88,2901
15000US060250120012,229,70,75,55,41,36,34,41,154,56,79,47,75,42,2902
15000US060250120021,1264,167,144,87,93,79,51,44,1120,170,367,115,753,169,2903
15000US060250120022,971,171,154,80,26,30,128,80,817,154,219,100,598,146,2904
15000US060250121001,352,130,175,103,40,49,135,101,177,111,11,21,166,114,2905
15000US060250121002,279,119,57,66,0,12,57,66,222,115,117,80,105,88,2906
15000US060250121003,478,147,51,67,0,12,51,67,427,139,307,119,120,106,2907
15000US060250121004,791,166,289,129,103,87,186,116,502,156,225,135,277,116,2908
15000US060250122001,697,114,133,61,68,52,65,40,564,104,215,74,349,95,2909
15000US060250122002,269,73,68,42,55,39,13,15,201,76,25,24,176,76,2910
15000US060250122003,329,76,95,71,0,12,95,71,234,70,127,70,107,67,2911
15000US060250122004,482,86,155,71,56,46,99,57,327,107,199,90,128,56,2912
15000US060250123011,320,83,50,36,22,23,28,28,270,70,98,46,172,56,2913
15000US060250123012,41,32,4,7,0,12,4,7,37,31,21,27,16,15,2914
15000US060250123021,392,113,40,48,40,48,0,12,352,113,46,50,306,104,2915
15000US060250123022,1021,146,213,76,87,47,126,71,808,144,347,107,461,130,2916
15000US060250123023,501,141,103,60,69,43,34,43,398,130,128,78,270,114,2917
15000US060250124001,369,98,13,13,13,13,0,12,356,98,136,61,220,80,2918
15000US060250124002,121,66,0,12,0,12,0,12,121,66,43,35,78,57,2919
15000US060259400001,293,61,74,22,37,15,37,18,219,55,92,38,127,46,2920
15000US060259400002,220,48,28,17,4,6,24,16,192,50,66,28,126,43,2921
15000US060259400003,231,77,35,31,33,31,2,4,196,74,134,68,62,24,2922
15000US060270001001,783,103,20,22,0,12,20,22,763,107,223,95,540,97,2923
15000US060270001002,472,72,18,20,0,12,18,20,454,77,125,52,329,75,2924
15000US060270002001,400,46,13,14,13,14,0,12,387,44,66,26,321,46,2925
15000US060270002002,272,50,0,12,0,12,0,12,272,50,35,19,237,51,2926
15000US060270003001,469,65,0,12,0,12,0,12,469,65,82,38,387,66,2927
15000US060270003002,579,73,0,12,0,12,0,12,579,73,89,48,490,75,2928
15000US060270004001,635,79,140,38,20,14,120,37,495,74,146,36,349,70,2929
15000US060270004002,778,166,112,90,78,84,34,41,666,156,195,109,471,146,2930
15000US060270004003,734,169,87,77,20,33,67,71,647,158,267,114,380,129,2931
15000US060270004004,439,120,13,19,13,19,0,12,426,123,0,12,426,123,2932
15000US060270005001,391,64,10,10,4,4,6,9,381,63,77,32,304,62,2933
15000US060270005002,689,68,97,35,42,28,55,20,592,64,198,49,394,66,2934
15000US060270008001,311,53,12,10,2,4,10,10,299,53,53,23,246,52,2935
15000US060270008002,223,65,11,17,0,12,11,17,212,62,77,42,135,51,2936
15000US060270008003,407,98,88,53,28,23,60,49,319,90,50,42,269,90,2937
15000US060270008004,391,73,86,47,12,8,74,46,305,67,92,47,213,61,2938
15000US060290001011,482,234,132,122,23,38,109,114,350,229,115,90,235,221,2939
15000US060290001012,403,220,175,156,20,37,155,152,228,170,105,118,123,139,2940
15000US060290001013,489,169,92,79,68,71,24,38,397,164,105,90,292,150,2941
15000US060290001014,474,219,22,35,22,35,0,12,452,216,192,132,260,190,2942
15000US060290001015,2778,384,344,235,108,150,236,189,2434,362,661,201,1773,377,2943
15000US060290001021,761,102,128,71,35,34,93,61,633,102,135,47,498,106,2944
15000US060290001022,464,93,51,55,5,9,46,55,413,96,139,62,274,90,2945
15000US060290002001,328,109,182,104,73,87,109,107,146,84,47,47,99,69,2946
15000US060290002002,375,150,183,111,78,61,105,101,192,111,132,101,60,47,2947
15000US060290002003,281,124,73,60,33,37,40,49,208,126,54,75,154,104,2948
15000US060290002004,463,149,178,106,95,89,83,77,285,129,61,60,224,130,2949
15000US060290002005,361,152,49,49,36,43,13,23,312,155,149,92,163,136,2950
15000US060290002006,501,166,130,118,71,106,59,48,371,159,104,89,267,150,2951
15000US060290002007,472,144,104,88,47,74,57,61,368,126,156,93,212,88,2952
15000US060290003001,548,117,147,92,42,32,105,90,401,101,159,66,242,95,2953
15000US060290003002,534,125,179,92,69,65,110,73,355,130,140,97,215,99,2954
15000US060290003003,384,118,252,124,156,104,96,80,132,53,81,47,51,36,2955
15000US060290003004,206,89,38,44,22,35,16,25,168,78,35,30,133,77,2956
15000US060290004001,524,107,112,63,67,50,45,31,412,105,182,70,230,97,2957
15000US060290004002,558,95,223,84,91,53,132,70,335,82,147,63,188,67,2958
15000US060290004003,614,115,170,76,91,60,79,51,444,95,167,79,277,87,2959
15000US060290005031,960,138,33,40,20,33,13,23,927,148,170,96,757,148,2960
15000US060290005032,685,114,83,90,33,39,50,81,602,126,285,122,317,90,2961
15000US060290005033,659,104,0,12,0,12,0,12,659,104,177,92,482,120,2962
15000US060290005041,686,83,39,39,14,25,25,28,647,87,175,59,472,102,2963
15000US060290005042,1019,116,270,99,91,80,179,92,749,103,360,100,389,117,2964
15000US060290005051,638,82,8,12,8,12,0,12,630,81,148,58,482,95,2965
15000US060290005052,770,73,46,34,22,25,24,24,724,76,130,63,594,90,2966
15000US060290005061,1116,107,51,25,15,17,36,22,1065,110,193,64,872,118,2967
15000US060290005071,1314,61,57,64,49,58,8,15,1257,66,370,104,887,114,2968
15000US060290006001,1063,139,134,93,16,27,118,91,929,136,284,114,645,161,2969
15000US060290006002,253,114,142,93,53,61,89,77,111,77,67,63,44,56,2970
15000US060290006003,492,163,184,110,83,68,101,90,308,145,169,105,139,105,2971
15000US060290006004,685,171,359,131,161,110,198,121,326,137,100,84,226,128,2972
15000US060290007001,415,76,64,45,39,38,25,27,351,74,74,37,277,76,2973
15000US060290007002,268,90,49,53,11,17,38,49,219,79,52,46,167,76,2974
15000US060290007003,288,78,0,12,0,12,0,12,288,78,50,30,238,78,2975
15000US060290007004,523,113,41,37,32,35,9,13,482,112,64,51,418,102,2976
15000US060290007005,273,80,22,19,7,13,15,16,251,79,19,16,232,79,2977
15000US060290008001,390,93,44,54,31,49,13,19,346,89,106,58,240,87,2978
15000US060290008002,357,87,139,78,75,58,64,56,218,76,59,52,159,64,2979
15000US060290008003,209,66,60,49,14,18,46,46,149,50,42,29,107,46,2980
15000US060290008004,309,81,64,48,28,27,36,40,245,83,20,23,225,83,2981
15000US060290008005,294,84,78,58,54,43,24,38,216,83,73,45,143,65,2982
15000US060290009021,773,102,159,80,16,19,143,79,614,110,181,67,433,98,2983
15000US060290009022,486,89,36,38,29,36,7,11,450,84,183,62,267,80,2984
15000US060290009031,1010,127,208,103,19,19,189,101,802,142,262,82,540,134,2985
15000US060290009032,379,94,8,12,8,12,0,12,371,96,81,40,290,98,2986
15000US060290009041,540,99,82,44,7,11,75,42,458,91,151,53,307,85,2987
15000US060290009042,570,97,92,68,11,20,81,66,478,110,165,75,313,98,2988
15000US060290009043,413,100,76,59,39,37,37,40,337,98,76,44,261,92,2989
15000US060290009051,332,53,0,12,0,12,0,12,332,53,135,57,197,55,2990
15000US060290009052,455,63,99,57,0,12,99,57,356,71,91,46,265,82,2991
15000US060290009061,752,100,219,91,72,66,147,76,533,93,192,71,341,82,2992
15000US060290009062,474,93,73,60,0,12,73,60,401,93,179,84,222,83,2993
15000US060290009071,714,40,110,50,32,25,78,43,604,52,158,56,446,70,2994
15000US060290009081,556,102,37,45,37,45,0,12,519,99,184,70,335,94,2995
15000US060290009082,598,99,140,102,8,15,132,104,458,115,179,91,279,113,2996
15000US060290009083,704,116,61,74,0,12,61,74,643,128,121,56,522,117,2997
15000US060290009091,444,61,36,29,26,27,10,11,408,61,105,41,303,61,2998
15000US060290009092,449,56,9,10,4,7,5,7,440,57,91,43,349,65,2999
15000US060290009101,772,149,76,55,33,40,43,39,696,142,202,99,494,137,3000
15000US060290009102,748,167,0,12,0,12,0,12,748,167,156,88,592,170,3001
15000US060290009103,1430,173,20,34,0,12,20,34,1410,177,237,89,1173,185,3002
15000US060290009104,889,221,189,123,38,41,151,110,700,191,300,175,400,146,3003
15000US060290010001,1142,182,319,171,96,95,223,130,823,208,110,64,713,206,3004
15000US060290010002,769,181,92,82,35,41,57,73,677,173,208,121,469,162,3005
15000US060290010003,259,124,17,27,17,27,0,12,242,125,98,89,144,96,3006
15000US060290010004,581,163,108,122,0,12,108,122,473,168,126,124,347,129,3007
15000US060290011011,796,90,288,109,155,90,133,70,508,120,219,90,289,120,3008
15000US060290011012,503,76,118,57,41,35,77,55,385,82,152,68,233,81,3009
15000US060290011021,730,134,235,107,89,68,146,85,495,123,255,86,240,101,3010
15000US060290011022,345,93,96,58,8,13,88,57,249,94,94,63,155,89,3011
15000US060290011023,381,90,171,76,77,60,94,52,210,87,58,43,152,78,3012
15000US060290011024,307,89,29,22,18,21,11,16,278,90,33,30,245,98,3013
15000US060290011031,385,70,143,64,43,33,100,64,242,76,26,27,216,77,3014
15000US060290011032,396,75,233,78,124,57,109,61,163,60,46,32,117,57,3015
15000US060290011033,429,93,238,88,49,47,189,78,191,85,22,27,169,83,3016
15000US060290012011,403,68,80,45,33,30,47,36,323,70,97,46,226,59,3017
15000US060290012012,274,79,135,55,62,44,73,43,139,68,37,29,102,55,3018
15000US060290012021,473,109,210,84,85,52,125,72,263,92,79,64,184,78,3019
15000US060290012022,451,88,206,75,46,42,160,73,245,79,86,50,159,70,3020
15000US060290012023,335,78,108,60,33,27,75,56,227,68,49,38,178,79,3021
15000US060290012024,275,93,107,64,17,27,90,57,168,81,38,28,130,78,3022
15000US060290013001,556,111,217,89,79,66,138,70,339,101,58,42,281,96,3023
15000US060290013002,198,77,107,69,43,40,64,54,91,56,49,39,42,39,3024
15000US060290013003,511,105,259,103,58,54,201,94,252,98,89,56,163,83,3025
15000US060290013004,361,85,101,50,46,47,55,44,260,95,101,76,159,74,3026
15000US060290013005,187,78,109,73,79,66,30,35,78,47,30,24,48,45,3027
15000US060290013006,235,80,81,50,36,34,45,42,154,71,65,45,89,56,3028
15000US060290014001,518,131,123,92,70,68,53,62,395,160,106,87,289,147,3029
15000US060290014002,346,142,194,128,121,111,73,65,152,88,41,40,111,84,3030
15000US060290014003,472,125,208,95,38,46,170,87,264,130,34,42,230,129,3031
15000US060290014004,1033,174,335,145,123,104,212,106,698,165,273,127,425,169,3032
15000US060290015001,172,46,28,26,7,13,21,22,144,42,55,25,89,42,3033
15000US060290015002,222,52,131,44,65,39,66,29,91,39,51,31,40,24,3034
15000US060290015003,273,54,92,38,34,32,58,30,181,53,54,36,127,47,3035
15000US060290016001,461,78,105,53,14,15,91,49,356,73,210,64,146,59,3036
15000US060290016002,219,64,47,33,0,12,47,33,172,54,18,13,154,52,3037
15000US060290017001,354,85,8,13,0,12,8,13,346,85,64,46,282,80,3038
15000US060290017002,462,106,29,40,5,10,24,38,433,104,16,17,417,103,3039
15000US060290017003,725,122,106,76,59,54,47,63,619,137,146,65,473,134,3040
15000US060290017004,293,75,8,15,8,15,0,12,285,76,7,11,278,78,3041
15000US060290018011,448,156,254,151,30,47,224,145,194,89,27,31,167,88,3042
15000US060290018012,635,148,159,92,59,56,100,67,476,124,106,61,370,130,3043
15000US060290018013,925,171,65,78,0,12,65,78,860,172,201,89,659,170,3044
15000US060290018021,502,163,40,46,0,12,40,46,462,163,72,73,390,154,3045
15000US060290018022,1076,186,58,76,0,12,58,76,1018,179,102,60,916,187,3046
15000US060290018023,572,121,103,85,5,11,98,84,469,119,111,57,358,138,3047
15000US060290019011,459,99,147,75,43,50,104,56,312,84,86,42,226,84,3048
15000US060290019012,326,73,56,58,25,37,31,43,270,63,73,39,197,68,3049
15000US060290019013,329,68,108,56,15,18,93,56,221,74,73,47,148,68,3050
15000US060290019014,277,88,17,22,0,12,17,22,260,84,0,12,260,84,3051
15000US060290019021,587,104,185,79,44,36,141,71,402,102,87,47,315,94,3052
15000US060290019022,388,90,117,80,39,55,78,60,271,87,51,45,220,82,3053
15000US060290019023,215,82,40,41,24,30,16,26,175,72,121,62,54,33,3054
15000US060290019024,547,97,161,82,62,52,99,69,386,83,87,41,299,80,3055
15000US060290020001,216,125,65,66,65,66,0,12,151,108,100,93,51,50,3056
15000US060290020002,550,152,268,127,106,91,162,115,282,110,143,79,139,89,3057
15000US060290020003,633,163,179,94,143,89,36,43,454,180,125,112,329,159,3058
15000US060290020004,925,168,327,130,111,100,216,125,598,157,181,100,417,166,3059
15000US060290021001,142,52,76,43,0,12,76,43,66,38,22,22,44,31,3060
15000US060290021002,206,69,55,42,12,19,43,39,151,60,23,17,128,57,3061
15000US060290021003,308,71,100,55,58,42,42,32,208,61,101,47,107,52,3062
15000US060290021004,235,74,95,54,31,36,64,46,140,54,32,31,108,51,3063
15000US060290022001,316,87,162,70,34,35,128,64,154,65,51,28,103,62,3064
15000US060290022002,240,82,45,40,17,28,28,30,195,76,16,18,179,75,3065
15000US060290022003,293,86,152,65,61,45,91,58,141,66,66,46,75,53,3066
15000US060290022004,353,88,208,93,153,85,55,45,145,69,25,19,120,65,3067
15000US060290022005,260,71,87,56,40,40,47,42,173,74,64,42,109,66,3068
15000US060290023011,886,250,283,209,92,98,191,184,603,159,202,100,401,141,3069
15000US060290023012,811,221,486,216,144,108,342,199,325,154,145,107,180,128,3070
15000US060290023013,408,156,180,118,80,94,100,88,228,146,143,107,85,93,3071
15000US060290023014,604,162,76,99,0,12,76,99,528,150,209,94,319,123,3072
15000US060290023021,434,70,173,62,22,18,151,61,261,60,95,37,166,59,3073
15000US060290023022,407,65,69,40,19,17,50,37,338,68,130,63,208,76,3074
15000US060290024001,2056,105,555,136,127,59,428,140,1501,128,193,76,1308,151,3075
15000US060290025001,218,107,60,69,15,24,45,64,158,107,45,49,113,101,3076
15000US060290025002,430,147,136,103,61,76,75,82,294,129,123,97,171,94,3077
15000US060290025003,647,177,280,149,87,69,193,132,367,153,48,51,319,145,3078
15000US060290025004,488,153,199,122,18,32,181,115,289,146,182,128,107,76,3079
15000US060290025005,524,185,180,119,73,67,107,94,344,156,86,85,258,156,3080
15000US060290026001,251,61,57,35,22,20,35,30,194,56,70,34,124,49,3081
15000US060290026002,378,68,93,47,52,31,41,37,285,57,52,25,233,61,3082
15000US060290026003,337,61,130,50,46,39,84,36,207,53,73,36,134,51,3083
15000US060290027001,308,71,90,54,62,44,28,34,218,65,73,50,145,58,3084
15000US060290027002,249,93,138,81,43,46,95,74,111,68,21,26,90,70,3085
15000US060290027003,553,114,105,59,13,16,92,58,448,107,158,64,290,103,3086
15000US060290027004,340,88,75,62,12,17,63,59,265,77,66,42,199,76,3087
15000US060290027005,371,88,78,57,40,37,38,45,293,87,91,45,202,84,3088
15000US060290028041,819,91,8,14,8,14,0,12,811,87,344,69,467,96,3089
15000US060290028042,675,90,20,20,0,12,20,20,655,93,201,62,454,101,3090
15000US060290028061,1018,96,0,12,0,12,0,12,1018,96,147,67,871,114,3091
15000US060290028071,606,104,0,12,0,12,0,12,606,104,132,55,474,107,3092
15000US060290028072,254,62,0,12,0,12,0,12,254,62,112,57,142,66,3093
15000US060290028073,190,47,6,11,6,11,0,12,184,47,26,26,158,48,3094
15000US060290028074,341,74,0,12,0,12,0,12,341,74,101,65,240,69,3095
15000US060290028081,467,105,0,12,0,12,0,12,467,105,35,35,432,107,3096
15000US060290028082,395,78,0,12,0,12,0,12,395,78,57,45,338,85,3097
15000US060290028083,932,206,37,42,19,31,18,29,895,201,178,120,717,180,3098
15000US060290028084,384,83,0,12,0,12,0,12,384,83,44,34,340,86,3099
15000US060290028085,458,105,32,51,0,12,32,51,426,112,20,25,406,114,3100
15000US060290028111,1403,88,0,12,0,12,0,12,1403,88,295,69,1108,99,3101
15000US060290028121,541,118,250,97,101,74,149,72,291,84,88,56,203,81,3102
15000US060290028122,381,84,51,36,23,26,28,24,330,82,71,52,259,77,3103
15000US060290028123,665,104,200,84,102,52,98,68,465,109,89,55,376,100,3104
15000US060290028124,469,101,119,66,72,55,47,41,350,103,73,49,277,102,3105
15000US060290028131,417,79,9,12,7,11,2,7,408,78,114,56,294,80,3106
15000US060290028132,435,100,79,48,14,15,65,45,356,104,73,56,283,101,3107
15000US060290028133,765,109,145,69,64,41,81,56,620,102,90,54,530,99,3108
15000US060290028141,439,96,102,58,38,32,64,51,337,93,83,54,254,99,3109
15000US060290028142,434,93,69,39,6,9,63,37,365,98,141,71,224,78,3110
15000US060290028143,663,98,32,29,0,12,32,29,631,97,165,77,466,104,3111
15000US060290028151,807,108,156,70,35,28,121,66,651,110,222,79,429,116,3112
15000US060290028152,551,107,60,47,10,12,50,44,491,115,103,58,388,102,3113
15000US060290028161,799,100,128,72,60,38,68,67,671,116,224,86,447,128,3114
15000US060290028162,311,92,5,8,0,12,5,8,306,92,85,49,221,91,3115
15000US060290028163,693,110,172,84,13,19,159,83,521,98,149,61,372,100,3116
15000US060290028171,345,88,39,41,0,12,39,41,306,91,62,38,244,84,3117
15000US060290028172,805,87,167,72,37,41,130,66,638,109,172,64,466,120,3118
15000US060290028173,572,93,144,75,66,56,78,57,428,97,70,39,358,101,3119
15000US060290028181,755,72,104,66,20,28,84,64,651,78,96,49,555,81,3120
15000US060290028182,635,72,36,28,0,12,36,28,599,70,153,56,446,81,3121
15000US060290028191,561,84,41,40,0,12,41,40,520,79,90,49,430,77,3122
15000US060290028192,1138,103,113,60,21,30,92,58,1025,113,215,84,810,103,3123
15000US060290028201,450,94,30,35,8,13,22,34,420,93,81,40,339,91,3124
15000US060290028202,385,114,0,12,0,12,0,12,385,114,55,50,330,112,3125
15000US060290028203,794,103,56,55,34,53,22,23,738,120,142,74,596,127,3126
15000US060290028204,399,99,7,12,0,12,7,12,392,99,108,60,284,94,3127
15000US060290028211,679,91,22,34,0,12,22,34,657,90,60,43,597,95,3128
15000US060290028212,385,90,39,43,7,11,32,42,346,90,98,58,248,86,3129
15000US060290028213,532,110,27,31,0,12,27,31,505,109,130,69,375,106,3130
15000US060290029001,515,132,101,91,16,25,85,88,414,152,125,82,289,145,3131
15000US060290029002,979,171,254,133,93,87,161,104,725,182,56,46,669,183,3132
15000US060290029003,554,131,58,42,29,33,29,32,496,125,211,93,285,105,3133
15000US060290029004,362,112,43,41,16,26,27,32,319,119,73,47,246,123,3134
15000US060290030001,120,59,73,61,21,23,52,55,47,34,12,18,35,28,3135
15000US060290030002,332,107,54,45,17,20,37,42,278,103,35,28,243,108,3136
15000US060290030003,235,98,90,74,41,46,49,55,145,79,70,69,75,55,3137
15000US060290030004,528,100,229,92,43,32,186,89,299,97,70,35,229,90,3138
15000US060290030005,420,103,174,92,51,42,123,83,246,92,58,61,188,77,3139
15000US060290030006,394,117,247,114,32,28,215,113,147,72,49,42,98,74,3140
15000US060290031031,361,73,88,46,18,15,70,44,273,70,97,39,176,60,3141
15000US060290031032,393,84,70,48,47,37,23,29,323,79,112,53,211,71,3142
15000US060290031033,289,67,72,43,24,18,48,38,217,64,74,34,143,60,3143
15000US060290031121,790,114,20,22,11,15,9,16,770,110,90,59,680,119,3144
15000US060290031122,613,117,64,41,24,27,40,31,549,115,53,39,496,112,3145
15000US060290031123,465,92,50,44,29,36,21,24,415,99,149,62,266,89,3146
15000US060290031131,779,92,106,53,27,29,79,47,673,92,290,88,383,94,3147
15000US060290031132,571,112,219,89,16,20,203,96,352,107,57,33,295,103,3148
15000US060290031141,507,194,152,148,12,20,140,148,355,141,142,76,213,130,3149
15000US060290031142,579,167,0,12,0,12,0,12,579,167,43,46,536,182,3150
15000US060290031143,510,155,115,86,29,33,86,81,395,116,94,76,301,122,3151
15000US060290031144,675,201,113,94,27,44,86,90,562,196,133,77,429,190,3152
15000US060290031151,461,120,108,80,0,12,108,80,353,103,61,39,292,95,3153
15000US060290031152,390,124,219,104,83,63,136,88,171,78,43,42,128,74,3154
15000US060290031153,630,126,136,88,51,65,85,54,494,110,120,68,374,98,3155
15000US060290031211,325,107,72,69,17,30,55,59,253,106,157,107,96,69,3156
15000US060290031212,431,144,106,95,7,12,99,96,325,121,91,87,234,109,3157
15000US060290031213,505,161,171,131,93,99,78,80,334,145,161,87,173,110,3158
15000US060290031214,653,196,122,73,18,26,104,73,531,196,203,140,328,146,3159
15000US060290031215,486,161,293,145,111,111,182,106,193,80,114,46,79,70,3160
15000US060290031221,588,159,33,43,11,18,22,38,555,163,169,94,386,141,3161
15000US060290031222,523,131,53,67,19,32,34,56,470,135,39,35,431,136,3162
15000US060290031223,461,154,58,65,25,40,33,54,403,167,106,107,297,126,3163
15000US060290031224,544,130,63,47,10,16,53,44,481,129,145,82,336,117,3164
15000US060290031231,1948,331,100,96,25,44,75,87,1848,316,467,218,1381,330,3165
15000US060290031232,808,234,0,12,0,12,0,12,808,234,186,157,622,213,3166
15000US060290031233,327,127,31,52,31,52,0,12,296,119,64,60,232,112,3167
15000US060290031234,716,205,208,121,103,104,105,121,508,177,113,87,395,170,3168
15000US060290031235,444,209,64,92,0,12,64,92,380,185,28,52,352,198,3169
15000US060290031236,596,248,19,35,0,12,19,35,577,258,162,127,415,246,3170
15000US060290031241,383,83,45,50,45,50,0,12,338,85,56,36,282,85,3171
15000US060290031242,525,94,47,45,17,29,30,35,478,92,96,58,382,98,3172
15000US060290031243,352,102,20,23,8,12,12,19,332,103,64,69,268,98,3173
15000US060290031244,347,83,46,45,46,45,0,12,301,74,117,57,184,76,3174
15000US060290032021,988,192,188,122,29,35,159,117,800,198,94,68,706,199,3175
15000US060290032022,1694,254,472,189,48,56,424,187,1222,238,257,120,965,255,3176
15000US060290032023,598,184,98,87,0,12,98,87,500,154,89,83,411,147,3177
15000US060290032024,450,139,57,71,0,12,57,71,393,145,28,35,365,148,3178
15000US060290032025,499,153,81,82,0,12,81,82,418,147,149,95,269,118,3179
15000US060290032031,745,43,14,15,0,12,14,15,731,43,153,50,578,74,3180
15000US060290032041,2936,113,117,73,50,44,67,60,2819,131,443,122,2376,161,3181
15000US060290032051,913,154,179,97,75,65,104,82,734,173,180,95,554,164,3182
15000US060290032052,701,133,11,18,11,18,0,12,690,137,155,93,535,144,3183
15000US060290032053,875,149,87,108,0,12,87,108,788,132,135,69,653,129,3184
15000US060290032061,1013,177,14,27,14,27,0,12,999,178,264,101,735,180,3185
15000US060290032062,1006,212,116,96,20,33,96,90,890,195,134,93,756,208,3186
15000US060290032063,1963,245,204,126,59,72,145,106,1759,235,327,133,1432,230,3187
15000US060290033031,476,45,77,26,43,20,34,21,399,46,140,39,259,43,3188
15000US060290033041,358,49,34,18,26,14,8,10,324,48,86,33,238,44,3189
15000US060290033042,296,48,49,22,2,3,47,21,247,39,89,31,158,32,3190
15000US060290033043,97,36,3,5,0,12,3,5,94,36,14,12,80,36,3191
15000US060290033051,418,88,16,24,16,24,0,12,402,93,149,86,253,81,3192
15000US060290033052,223,75,7,11,7,11,0,12,216,75,62,59,154,76,3193
15000US060290033053,611,114,152,101,93,74,59,68,459,128,72,64,387,116,3194
15000US060290033061,812,195,106,82,49,53,57,66,706,181,193,93,513,169,3195
15000US060290033062,945,199,32,30,32,30,0,12,913,195,292,125,621,189,3196
15000US060290034001,693,120,193,77,61,34,132,78,500,103,115,47,385,98,3197
15000US060290034002,662,96,125,79,19,20,106,76,537,107,105,54,432,111,3198
15000US060290035001,946,197,217,127,89,81,128,105,729,206,331,152,398,149,3199
15000US060290035002,814,204,75,79,47,71,28,34,739,215,166,114,573,193,3200
15000US060290035003,519,143,65,75,0,12,65,75,454,123,46,43,408,127,3201
15000US060290036001,169,67,46,37,20,31,26,22,123,68,50,52,73,64,3202
15000US060290036002,247,84,88,59,61,52,27,30,159,71,91,53,68,48,3203
15000US060290036003,1082,112,222,132,67,73,155,116,860,140,117,52,743,150,3204
15000US060290037001,370,55,97,41,7,7,90,41,273,55,40,23,233,53,3205
15000US060290037002,682,71,143,75,48,46,95,61,539,77,96,47,443,75,3206
15000US060290038031,1983,99,54,47,8,12,46,45,1929,114,267,107,1662,139,3207
15000US060290038041,1559,276,127,151,93,137,34,54,1432,270,233,149,1199,240,3208
15000US060290038042,1438,257,36,61,36,61,0,12,1402,249,239,166,1163,235,3209
15000US060290038043,1633,285,23,36,0,17,23,36,1610,284,246,146,1364,258,3210
15000US060290038051,867,144,0,12,0,12,0,12,867,144,282,131,585,116,3211
15000US060290038052,889,148,0,12,0,12,0,12,889,148,97,61,792,155,3212
15000US060290038053,389,82,49,47,49,47,0,12,340,79,50,50,290,80,3213
15000US060290038054,583,132,30,35,12,20,18,30,553,132,68,57,485,133,3214
15000US060290038061,1680,75,32,34,5,9,27,35,1648,74,381,81,1267,90,3215
15000US060290038071,825,105,22,25,9,15,13,19,803,109,179,73,624,119,3216
15000US060290038072,398,100,67,52,12,17,55,49,331,91,183,96,148,56,3217
15000US060290038081,584,87,30,36,6,10,24,34,554,87,103,37,451,83,3218
15000US060290038082,969,106,110,58,40,44,70,48,859,109,159,81,700,99,3219
15000US060290038091,588,137,12,20,12,20,0,12,576,138,146,97,430,137,3220
15000US060290038092,1884,209,0,17,0,17,0,17,1884,209,209,120,1675,210,3221
15000US060290038093,1580,207,169,133,25,29,144,132,1411,209,255,118,1156,232,3222
15000US060290038101,408,42,5,9,0,12,5,9,403,44,73,29,330,50,3223
15000US060290038102,466,46,22,26,4,6,18,25,444,49,51,23,393,51,3224
15000US060290038111,621,65,27,25,14,15,13,20,594,62,117,36,477,61,3225
15000US060290038112,351,62,50,35,16,16,34,32,301,60,93,38,208,58,3226
15000US060290038121,613,101,36,46,0,12,36,46,577,106,158,64,419,95,3227
15000US060290038122,658,103,12,20,12,20,0,12,646,102,29,27,617,99,3228
15000US060290038123,359,72,45,47,0,12,45,47,314,76,94,49,220,69,3229
15000US060290038131,2521,127,44,45,0,17,44,45,2477,135,471,184,2006,208,3230
15000US060290039001,311,118,28,22,4,6,24,22,283,119,27,15,256,120,3231
15000US060290039002,0,12,0,12,0,12,0,12,0,12,0,12,0,12,3232
15000US060290040001,302,86,67,48,30,28,37,39,235,86,64,41,171,79,3233
15000US060290040002,403,98,97,68,23,27,74,60,306,94,34,23,272,97,3234
15000US060290040003,373,116,81,58,26,28,55,55,292,97,75,45,217,87,3235
15000US060290040004,736,126,117,62,25,26,92,57,619,139,84,48,535,139,3236
15000US060290041011,727,99,33,27,14,16,19,23,694,99,188,63,506,108,3237
15000US060290041012,364,83,103,73,20,21,83,70,261,92,48,42,213,93,3238
15000US060290041013,365,92,89,72,0,12,89,72,276,86,50,31,226,83,3239
15000US060290041021,653,97,189,79,24,22,165,80,464,106,107,55,357,96,3240
15000US060290041022,753,96,171,63,33,26,138,65,582,111,79,40,503,113,3241
15000US060290042001,344,36,98,30,12,9,86,32,246,36,50,17,196,39,3242
15000US060290043011,265,78,27,28,0,12,27,28,238,75,14,17,224,77,3243
15000US060290043012,441,90,117,69,21,26,96,67,324,89,81,36,243,87,3244
15000US060290043013,1227,109,313,119,55,39,258,112,914,124,136,48,778,121,3245
15000US060290043021,0,17,0,17,0,17,0,17,0,17,0,17,0,17,3246
15000US060290044011,671,145,100,63,22,32,78,55,571,151,148,90,423,137,3247
15000US060290044012,732,160,218,121,15,22,203,121,514,165,72,68,442,169,3248
15000US060290044013,759,181,96,74,0,12,96,74,663,170,89,57,574,163,3249
15000US060290044021,563,79,226,68,24,21,202,69,337,78,47,29,290,83,3250
15000US060290044022,686,91,296,85,59,42,237,85,390,85,71,39,319,84,3251
15000US060290045001,354,42,88,33,0,12,88,33,266,46,15,17,251,45,3252
15000US060290045002,453,45,70,22,8,9,62,22,383,44,41,20,342,45,3253
15000US060290046011,0,12,0,12,0,12,0,12,0,12,0,12,0,12,3254
15000US060290046031,0,12,0,12,0,12,0,12,0,12,0,12,0,12,3255
15000US060290046041,259,136,12,14,0,12,12,14,247,135,62,59,185,137,3256
15000US060290046042,1851,217,326,177,35,42,291,171,1525,245,195,95,1330,265,3257
15000US060290046043,0,12,0,12,0,12,0,12,0,12,0,12,0,12,3258
15000US060290046044,588,160,57,46,0,12,57,46,531,161,96,95,435,150,3259
15000US060290047011,1045,144,213,93,49,39,164,86,832,136,111,57,721,131,3260
15000US060290047012,785,97,318,104,45,39,273,101,467,74,73,37,394,76,3261
15000US060290047013,213,72,59,47,0,12,59,47,154,65,31,36,123,67,3262
15000US060290047021,345,51,67,29,19,16,48,24,278,56,35,22,243,55,3263
15000US060290047022,288,55,89,39,6,8,83,38,199,46,46,22,153,44,3264
15000US060290047023,300,52,88,42,12,12,76,40,212,53,44,25,168,54,3265
15000US060290048001,556,143,162,102,12,20,150,101,394,143,66,46,328,142,3266
15000US060290048002,535,130,103,93,31,48,72,80,432,122,145,69,287,120,3267
15000US060290048003,528,128,90,67,13,21,77,63,438,130,52,42,386,126,3268
15000US060290048004,1126,178,477,143,0,12,477,143,649,184,42,38,607,188,3269
15000US060290049011,303,78,32,31,8,12,24,28,271,78,28,26,243,76,3270
15000US060290049012,414,92,174,68,20,18,154,66,240,90,42,35,198,97,3271
15000US060290049013,183,62,30,32,0,12,30,32,153,56,45,35,108,55,3272
15000US060290049014,479,109,61,55,19,22,42,50,418,111,51,35,367,113,3273
15000US060290049021,353,88,28,26,0,12,28,26,325,93,85,35,240,93,3274
15000US060290049022,438,84,28,22,9,15,19,16,410,80,82,44,328,85,3275
15000US060290049023,466,84,45,43,8,14,37,40,421,85,78,34,343,88,3276
15000US060290049024,316,81,16,18,9,15,7,11,300,82,53,30,247,85,3277
15000US060290049025,451,107,66,58,23,35,43,44,385,102,89,48,296,100,3278
15000US060290050031,365,71,53,42,15,20,38,35,312,69,34,24,278,65,3279
15000US060290050032,581,90,154,66,10,14,144,65,427,105,47,29,380,100,3280
15000US060290050041,966,171,147,80,31,49,116,63,819,169,140,72,679,177,3281
15000US060290050042,604,170,218,136,18,21,200,134,386,131,53,46,333,131,3282
15000US060290050043,449,125,15,17,0,12,15,17,434,123,87,38,347,123,3283
15000US060290051031,1058,74,82,50,15,22,67,48,976,81,401,101,575,110,3284
15000US060290051041,1022,104,11,18,11,18,0,12,1011,105,232,58,779,104,3285
15000US060290051042,531,99,26,37,0,12,26,37,505,103,76,46,429,93,3286
15000US060290052011,274,60,27,21,12,12,15,17,247,61,66,36,181,50,3287
15000US060290052012,382,145,63,79,63,79,0,12,319,144,130,92,189,123,3288
15000US060290052013,276,125,0,12,0,12,0,12,276,125,120,94,156,85,3289
15000US060290052014,698,180,56,70,14,22,42,66,642,174,207,101,435,146,3290
15000US060290052015,55,73,0,12,0,12,0,12,55,73,0,12,55,73,3291
15000US060290052016,404,125,17,26,17,26,0,12,387,122,39,44,348,113,3292
15000US060290052017,524,186,21,35,21,35,0,12,503,182,178,109,325,151,3293
15000US060290052031,629,184,148,113,133,111,15,23,481,176,184,123,297,145,3294
15000US060290052032,388,127,16,27,16,27,0,12,372,127,171,114,201,96,3295
15000US060290052033,621,184,104,118,104,118,0,12,517,144,252,124,265,118,3296
15000US060290052034,436,96,0,12,0,12,0,12,436,96,178,84,258,101,3297
15000US060290052041,362,141,34,30,22,28,12,12,328,138,106,46,222,135,3298
15000US060290052042,336,152,102,95,50,44,52,84,234,137,80,66,154,121,3299
15000US060290052043,846,199,275,172,194,147,81,102,571,173,342,155,229,111,3300
15000US060290052044,663,173,156,120,126,112,30,33,507,161,135,92,372,148,3301
15000US060290052045,437,136,20,30,0,12,20,30,417,132,244,108,173,114,3302
15000US060290053001,121,38,7,10,7,10,0,12,114,37,4,7,110,37,3303
15000US060290053002,469,66,198,60,65,43,133,49,271,57,93,36,178,51,3304
15000US060290054011,479,165,162,129,146,127,16,26,317,142,63,43,254,138,3305
15000US060290054012,710,142,108,89,73,82,35,41,602,125,143,80,459,125,3306
15000US060290054013,422,150,0,12,0,12,0,12,422,150,88,47,334,148,3307
15000US060290054014,553,118,0,12,0,12,0,12,553,118,139,113,414,114,3308
15000US060290054015,482,109,37,40,37,40,0,12,445,119,82,56,363,123,3309
15000US060290054021,600,83,85,50,9,13,76,48,515,94,123,61,392,89,3310
15000US060290054022,652,90,46,38,27,32,19,21,606,90,167,67,439,92,3311
15000US060290054023,661,92,0,12,0,12,0,12,661,92,147,62,514,99,3312
15000US060290054031,744,172,66,56,66,56,0,12,678,184,301,130,377,161,3313
15000US060290054032,1224,193,168,135,117,123,51,46,1056,198,208,132,848,177,3314
15000US060290054033,385,112,32,43,32,43,0,12,353,109,68,60,285,103,3315
15000US060290054034,618,137,40,45,22,34,18,29,578,136,104,71,474,135,3316
15000US060290054035,478,211,289,191,98,111,191,152,189,123,76,62,113,105,3317
15000US060290054041,467,115,19,31,0,12,19,31,448,111,106,55,342,117,3318
15000US060290054042,1200,150,187,138,154,132,33,38,1013,159,204,90,809,156,3319
15000US060290054043,767,119,16,27,0,12,16,27,751,117,235,112,516,115,3320
15000US060290054044,329,88,35,41,20,31,15,24,294,96,143,90,151,53,3321
15000US060290055011,419,161,77,90,64,85,13,22,342,159,108,93,234,149,3322
15000US060290055012,473,195,98,91,0,12,98,91,375,167,109,120,266,133,3323
15000US060290055013,847,174,25,40,0,12,25,40,822,179,137,67,685,189,3324
15000US060290055014,26,28,12,20,12,20,0,12,14,21,0,12,14,21,3325
15000US060290055015,460,174,152,121,41,67,111,112,308,117,37,43,271,121,3326
15000US060290055016,362,146,0,12,0,12,0,12,362,146,112,87,250,126,3327
15000US060290055061,916,204,59,61,45,56,14,23,857,205,237,123,620,213,3328
15000US060290055062,290,96,16,29,0,12,16,29,274,101,34,40,240,101,3329
15000US060290055063,386,119,15,24,15,24,0,12,371,120,85,72,286,108,3330
15000US060290055064,347,136,16,26,16,26,0,12,331,146,79,70,252,136,3331
15000US060290055071,707,148,174,111,57,92,117,76,533,144,210,93,323,141,3332
15000US060290055072,1232,230,241,154,82,95,159,129,991,235,242,123,749,234,3333
15000US060290055073,715,180,158,88,90,59,68,59,557,177,189,131,368,144,3334
15000US060290055081,391,84,116,73,57,45,59,57,275,74,53,35,222,72,3335
15000US060290055082,534,120,45,40,24,26,21,29,489,127,189,82,300,111,3336
15000US060290055083,704,147,286,107,128,79,158,80,418,147,119,51,299,135,3337
15000US060290056001,526,86,106,49,52,43,54,32,420,100,163,57,257,88,3338
15000US060290056002,371,69,86,51,41,32,45,40,285,64,107,44,178,58,3339
15000US060290057001,709,77,12,20,0,12,12,20,697,76,63,42,634,69,3340
15000US060290058011,815,133,51,45,36,42,15,17,764,129,179,78,585,135,3341
15000US060290058012,350,74,8,12,0,12,8,12,342,74,85,39,257,75,3342
15000US060290058013,949,123,71,63,44,48,27,41,878,119,151,70,727,124,3343
15000US060290058021,387,114,44,41,14,23,30,34,343,115,119,77,224,113,3344
15000US060290058022,631,176,127,113,60,76,67,88,504,152,148,82,356,141,3345
15000US060290058023,570,165,109,74,109,74,0,12,461,149,89,57,372,147,3346
15000US060290058024,1066,220,129,96,37,41,92,92,937,220,251,110,686,202,3347
15000US060290059001,280,94,91,64,0,12,91,64,189,101,46,38,143,92,3348
15000US060290059002,409,98,115,72,47,43,68,60,294,104,84,64,210,85,3349
15000US060290059003,711,137,127,60,75,41,52,48,584,135,169,74,415,123,3350
15000US060290060021,0,12,0,12,0,12,0,12,0,12,0,12,0,12,3351
15000US060290060031,488,144,0,12,0,12,0,12,488,144,101,80,387,143,3352
15000US060290060032,474,154,106,83,64,65,42,46,368,152,111,80,257,139,3353
15000US060290060033,454,127,99,92,0,12,99,92,355,105,104,64,251,103,3354
15000US060290060034,665,171,182,127,104,102,78,82,483,145,56,47,427,143,3355
15000US060290060041,387,65,18,11,10,10,8,8,369,63,124,47,245,57,3356
15000US060290060042,254,51,16,25,0,12,16,25,238,49,79,33,159,49,3357
15000US060290060061,621,107,17,21,17,21,0,12,604,110,117,46,487,111,3358
15000US060290060062,331,74,25,28,0,12,25,28,306,76,12,14,294,78,3359
15000US060290060063,433,88,10,16,10,16,0,12,423,89,52,26,371,86,3360
15000US060290060071,401,125,0,12,0,12,0,12,401,125,49,48,352,119,3361
15000US060290060072,1233,197,63,64,63,64,0,12,1170,218,304,151,866,217,3362
15000US060290060073,442,149,2,4,0,12,2,4,440,148,139,82,301,154,3363
15000US060290060081,278,89,30,29,30,29,0,12,248,83,13,20,235,80,3364
15000US060290060082,579,181,36,40,17,27,19,33,543,183,169,123,374,148,3365
15000US060290060083,868,151,36,46,36,46,0,12,832,153,233,103,599,170,3366
15000US060290060084,769,179,14,23,0,12,14,23,755,181,51,40,704,177,3367
15000US060290061001,652,158,102,97,51,51,51,82,550,146,120,69,430,136,3368
15000US060290061002,874,190,146,117,49,47,97,109,728,175,140,78,588,167,3369
15000US060290061003,867,175,29,32,16,24,13,21,838,174,233,119,605,150,3370
15000US060290061004,688,180,165,104,43,34,122,96,523,155,187,111,336,138,3371
15000US060290062011,735,52,128,49,15,17,113,46,607,68,100,35,507,77,3372
15000US060290062021,1549,91,275,85,132,56,143,59,1274,118,194,71,1080,128,3373
15000US060290063011,492,69,40,33,9,15,31,29,452,73,113,49,339,72,3374
15000US060290063012,494,87,101,52,25,25,76,48,393,79,100,40,293,81,3375
15000US060290063031,749,106,233,82,18,28,215,78,516,113,126,67,390,113,3376
15000US060290063032,761,116,183,85,35,40,148,77,578,95,110,51,468,96,3377
15000US060290063041,396,66,152,53,46,30,106,44,244,63,75,36,169,58,3378
15000US060290063042,411,66,86,43,53,34,33,30,325,69,72,38,253,68,3379
15000US060290063043,204,74,83,65,27,25,56,62,121,63,12,11,109,63,3380
15000US060290064011,237,63,83,44,17,19,66,45,154,56,51,38,103,38,3381
15000US060290064012,438,109,50,48,20,31,30,37,388,104,109,58,279,103,3382
15000US060290064013,428,94,151,79,28,36,123,71,277,85,104,57,173,71,3383
15000US060290064014,535,121,94,60,37,38,57,48,441,109,34,42,407,115,3384
15000US060290064015,364,92,114,66,57,52,57,46,250,86,96,66,154,77,3385
15000US060290064031,367,97,158,85,10,19,148,81,209,80,53,44,156,75,3386
15000US060290064032,460,122,94,61,27,33,67,49,366,122,27,26,339,125,3387
15000US060290064033,408,112,49,43,23,29,26,31,359,112,33,37,326,118,3388
15000US060290064034,223,83,22,31,0,12,22,31,201,77,37,37,164,85,3389
15000US060290064041,475,72,108,47,40,28,68,43,367,79,78,37,289,81,3390
15000US060290064042,348,67,108,54,27,32,81,45,240,64,63,28,177,61,3391
15000US060290065001,341,85,115,70,79,69,36,31,226,68,90,37,136,59,3392
15000US060290065002,270,92,27,44,0,12,27,44,243,94,87,70,156,84,3393
15000US060290065003,282,66,88,53,15,21,73,56,194,57,66,42,128,54,3394
15000US060310001001,271,57,18,18,12,17,6,6,253,52,80,36,173,53,3395
15000US060310001002,355,95,0,12,0,12,0,12,355,95,21,32,334,93,3396
15000US060310001003,375,75,58,40,20,33,38,36,317,64,85,35,232,62,3397
15000US060310002001,490,63,60,42,6,6,54,41,430,62,134,40,296,61,3398
15000US060310002002,266,49,44,27,23,31,21,21,222,47,46,23,176,47,3399
15000US060310003001,797,149,0,12,0,12,0,12,797,149,47,39,750,146,3400
15000US060310003002,821,129,43,43,7,13,36,42,778,135,107,76,671,143,3401
15000US060310004021,411,85,126,63,45,41,81,50,285,70,83,37,202,70,3402
15000US060310004022,755,150,119,60,53,42,66,54,636,153,190,86,446,148,3403
15000US060310004023,686,87,80,65,16,20,64,67,606,83,154,58,452,88,3404
15000US060310004031,529,93,77,46,8,13,69,45,452,97,115,62,337,114,3405
15000US060310004032,872,102,163,81,85,61,78,58,709,113,193,60,516,119,3406
15000US060310004033,402,108,15,18,7,13,8,12,387,109,36,36,351,108,3407
15000US060310004041,749,166,74,80,29,35,45,73,675,179,62,63,613,177,3408
15000US060310004042,223,92,0,12,0,12,0,12,223,92,35,41,188,87,3409
15000US060310004043,669,187,143,124,0,12,143,124,526,166,72,57,454,171,3410
15000US060310004044,968,206,15,23,0,12,15,23,953,206,200,131,753,196,3411
15000US060310004045,786,166,118,90,20,32,98,82,668,162,198,118,470,155,3412
15000US060310004051,766,165,92,82,0,12,92,82,674,166,95,63,579,165,3413
15000US060310004052,463,132,16,26,0,12,16,26,447,137,110,63,337,134,3414
15000US060310004053,439,114,73,69,6,13,67,67,366,135,119,96,247,117,3415
15000US060310004054,523,127,144,95,32,45,112,87,379,147,86,77,293,156,3416
15000US060310005001,251,77,35,41,0,12,35,41,216,68,29,33,187,64,3417
15000US060310005002,251,87,16,17,8,12,8,13,235,87,68,54,167,77,3418
15000US060310005003,561,105,132,77,0,12,132,77,429,87,212,82,217,69,3419
15000US060310005004,435,87,137,70,51,42,86,60,298,77,188,58,110,62,3420
15000US060310006011,2166,198,63,66,10,17,53,64,2103,195,415,123,1688,203,3421
15000US060310006012,698,172,191,117,50,64,141,105,507,160,118,66,389,163,3422
15000US060310006021,571,118,20,31,5,18,15,25,551,119,107,82,444,118,3423
15000US060310006022,949,192,0,12,0,12,0,12,949,192,118,88,831,193,3424
15000US060310006023,396,124,0,12,0,12,0,12,396,124,70,55,326,131,3425
15000US060310006024,244,84,0,12,0,12,0,12,244,84,37,44,207,87,3426
15000US060310007011,640,115,32,23,26,23,6,10,608,116,103,58,505,120,3427
15000US060310007012,643,88,99,65,55,51,44,40,544,100,189,70,355,99,3428
15000US060310007013,458,93,0,12,0,12,0,12,458,93,92,68,366,78,3429
15000US060310007014,476,94,21,20,14,24,7,11,455,93,62,47,393,94,3430
15000US060310007021,616,94,24,30,0,12,24,30,592,94,213,67,379,90,3431
15000US060310007022,980,113,175,73,78,58,97,68,805,114,262,95,543,126,3432
15000US060310008001,245,74,78,58,0,12,78,58,167,50,77,33,90,47,3433
15000US060310008002,821,111,222,82,98,55,124,64,599,107,247,77,352,103,3434
15000US060310008003,304,78,37,23,29,22,8,9,267,81,63,33,204,78,3435
15000US060310008004,163,57,23,26,23,26,0,12,140,56,28,21,112,52,3436
15000US060310009001,253,99,29,43,29,43,0,12,224,92,79,59,145,74,3437
15000US060310009002,393,140,30,27,18,29,12,19,363,139,148,101,215,126,3438
15000US060310009003,376,117,106,105,19,29,87,100,270,88,117,67,153,71,3439
15000US060310009004,560,201,257,150,92,93,165,134,303,141,87,68,216,131,3440
15000US060310009005,720,206,237,151,137,114,100,107,483,175,245,135,238,134,3441
15000US060310009006,170,79,41,50,0,12,41,50,129,71,49,36,80,63,3442
15000US060310009007,302,138,72,55,13,23,59,56,230,136,76,96,154,103,3443
15000US060310010011,320,85,8,13,0,12,8,13,312,87,51,33,261,89,3444
15000US060310010012,1211,92,48,32,24,24,24,23,1163,96,465,111,698,124,3445
15000US060310010021,512,97,150,81,50,52,100,64,362,110,152,75,210,94,3446
15000US060310010022,421,81,124,70,25,29,99,64,297,85,65,52,232,74,3447
15000US060310010023,431,104,180,90,105,69,75,53,251,76,88,56,163,76,3448
15000US060310010031,1004,133,145,81,47,43,98,65,859,146,256,110,603,145,3449
15000US060310010032,605,120,78,49,25,27,53,43,527,126,271,125,256,89,3450
15000US060310011001,353,66,111,44,65,30,46,31,242,60,81,34,161,55,3451
15000US060310011002,664,124,315,98,80,52,235,85,349,122,139,77,210,101,3452
15000US060310011003,488,102,220,106,80,41,140,97,268,86,114,68,154,76,3453
15000US060310011004,312,71,85,39,58,32,27,20,227,71,51,34,176,67,3454
15000US060310012001,379,66,41,28,15,14,26,27,338,68,100,34,238,65,3455
15000US060310012002,409,51,19,15,10,10,9,11,390,51,88,27,302,52,3456
15000US060310013001,617,113,310,113,93,66,217,100,307,97,51,40,256,94,3457
15000US060310013002,644,111,293,112,142,84,151,83,351,109,100,63,251,98,3458
15000US060310014011,836,74,267,85,116,53,151,74,569,102,170,60,399,96,3459
15000US060310014021,217,54,68,41,10,11,58,41,149,51,19,20,130,53,3460
15000US060310014022,518,79,138,59,20,23,118,50,380,81,197,64,183,59,3461
15000US060310015001,492,107,37,38,37,38,0,12,455,109,142,70,313,105,3462
15000US060310015002,415,95,102,62,36,35,66,51,313,88,68,52,245,90,3463
15000US060310015003,223,86,87,84,80,83,7,11,136,49,6,12,130,49,3464
15000US060310015004,304,95,34,41,34,41,0,12,270,99,68,57,202,91,3465
15000US060310016011,377,106,87,64,0,12,87,64,290,100,84,54,206,91,3466
15000US060310016012,395,99,46,45,23,33,23,32,349,99,60,25,289,96,3467
15000US060310016013,290,97,97,66,35,34,62,54,193,75,93,64,100,53,3468
15000US060310016021,0,17,0,17,0,17,0,17,0,17,0,17,0,17,3469
15000US060310017011,877,138,116,76,31,35,85,65,761,153,201,96,560,160,3470
15000US060310017012,318,105,111,63,9,14,102,65,207,97,48,57,159,94,3471
15000US060310017013,350,124,72,51,37,37,35,35,278,119,85,70,193,112,3472
15000US060310017014,575,108,181,81,43,46,138,72,394,106,56,43,338,106,3473
15000US060310017015,30,49,0,12,0,12,0,12,30,49,0,12,30,49,3474
15000US060319818001,0,12,0,12,0,12,0,12,0,12,0,12,0,12,3475
15000US060330001001,578,128,46,36,44,36,2,4,532,119,176,78,356,109,3476
15000US060330001002,757,121,74,61,24,27,50,55,683,125,317,108,366,96,3477
15000US060330003001,430,80,0,12,0,12,0,12,430,80,117,49,313,82,3478
15000US060330003002,1104,111,57,57,19,21,38,47,1047,117,388,102,659,145,3479
15000US060330004001,477,96,22,37,22,37,0,12,455,100,164,106,291,94,3480
15000US060330004002,664,165,102,96,49,55,53,76,562,154,122,86,440,162,3481
15000US060330004003,607,158,75,81,12,19,63,79,532,168,195,107,337,150,3482
15000US060330004004,300,88,0,12,0,12,0,12,300,88,139,77,161,65,3483
15000US060330004005,320,117,46,32,7,16,39,34,274,114,119,77,155,105,3484
15000US060330005011,487,116,56,63,0,12,56,63,431,108,220,99,211,88,3485
15000US060330005012,741,132,164,115,47,52,117,98,577,118,252,92,325,105,3486
15000US060330005013,141,72,43,49,15,23,28,39,98,53,77,56,21,24,3487
15000US060330005021,652,132,52,57,30,48,22,28,600,132,260,94,340,120,3488
15000US060330005022,454,109,35,44,24,39,11,18,419,104,128,72,291,95,3489
15000US060330006001,326,119,95,73,21,33,74,68,231,92,125,72,106,60,3490
15000US060330006002,445,132,79,50,71,49,8,14,366,123,189,88,177,89,3491
15000US060330006003,386,109,82,68,37,44,45,51,304,95,164,74,140,79,3492
15000US060330006004,180,86,14,16,11,16,3,6,166,84,45,44,121,71,3493
15000US060330006005,431,82,56,48,56,48,0,12,375,83,179,72,196,70,3494
15000US060330007011,846,151,175,78,73,47,102,68,671,148,186,87,485,142,3495
15000US060330007012,1089,165,171,88,62,53,109,72,918,150,373,113,545,121,3496
15000US060330007021,805,151,110,70,90,65,20,24,695,151,352,111,343,135,3497
15000US060330007022,743,122,189,85,96,49,93,69,554,123,253,94,301,116,3498
15000US060330007023,10,14,0,12,0,12,0,12,10,14,0,12,10,14,3499
15000US060330008011,607,120,156,80,56,56,100,64,451,116,209,87,242,99,3500
15000US060330008012,631,123,175,77,92,62,83,39,456,114,115,57,341,118,3501
15000US060330008021,674,135,213,85,45,35,168,87,461,138,225,96,236,112,3502
15000US060330008022,585,138,151,76,79,46,72,61,434,124,180,83,254,93,3503
15000US060330008023,419,100,88,61,57,51,31,36,331,102,112,60,219,91,3504
15000US060330009001,954,157,77,77,65,75,12,20,877,163,304,123,573,169,3505
15000US060330009002,370,144,0,12,0,12,0,12,370,144,98,61,272,139,3506
15000US060330009003,1269,192,117,103,72,77,45,73,1152,204,438,155,714,168,3507
15000US060330010001,334,134,12,22,0,12,12,22,322,133,103,96,219,99,3508
15000US060330010002,336,115,3,8,1,3,2,6,333,115,139,93,194,104,3509
15000US060330010003,343,134,0,12,0,12,0,12,343,134,103,91,240,115,3510
15000US060330010004,268,71,0,12,0,12,0,12,268,71,89,75,179,75,3511
15000US060330010005,638,142,30,36,30,36,0,12,608,147,286,136,322,97,3512
15000US060330010006,386,129,65,55,0,12,65,55,321,130,97,83,224,114,3513
15000US060330011001,580,144,39,50,29,47,10,17,541,145,173,85,368,131,3514
15000US060330011002,774,139,71,40,42,33,29,28,703,135,180,71,523,129,3515
15000US060330012001,542,114,0,12,0,12,0,12,542,114,141,85,401,114,3516
15000US060330012002,511,109,22,31,11,27,11,17,489,106,234,90,255,83,3517
15000US060330012003,340,87,24,24,24,24,0,12,316,86,138,72,178,73,3518
15000US060330013001,131,49,12,20,0,12,12,20,119,48,54,35,65,44,3519
15000US060330013002,575,115,109,72,69,55,40,42,466,118,226,113,240,90,3520
15000US060330013003,361,132,56,64,16,25,40,61,305,126,33,31,272,128,3521
15000US060330013004,1310,216,21,26,0,12,21,26,1289,214,323,123,966,191,3522
15000US060330013005,283,113,39,63,0,12,39,63,244,107,115,79,129,101,3523
15000US060350401001,119,44,6,6,3,4,3,4,113,44,45,26,68,37,3524
15000US060350401002,365,81,7,7,3,4,4,6,358,81,100,42,258,82,3525
15000US060350401003,132,46,29,29,18,28,11,10,103,44,35,21,68,40,3526
15000US060350402001,374,92,10,16,0,12,10,16,364,92,187,67,177,70,3527
15000US060350402002,622,118,72,56,24,37,48,45,550,116,194,71,356,108,3528
15000US060350402003,235,91,50,43,26,33,24,29,185,84,64,49,121,72,3529
15000US060350403021,449,80,43,31,19,16,24,29,406,73,88,35,318,67,3530
15000US060350403022,586,83,4,6,0,12,4,6,582,83,117,41,465,83,3531
15000US060350403023,670,114,38,20,36,19,2,6,632,118,166,72,466,111,3532
15000US060350403031,566,111,61,41,12,13,49,41,505,116,242,78,263,98,3533
15000US060350403032,317,67,24,21,6,10,18,20,293,65,158,64,135,52,3534
15000US060350403033,335,70,111,63,94,63,17,25,224,53,89,45,135,47,3535
15000US060350403041,305,64,56,32,40,29,16,16,249,57,72,33,177,57,3536
15000US060350403042,373,76,98,48,43,29,55,41,275,69,104,45,171,65,3537
15000US060350403051,539,79,30,26,6,10,24,26,509,80,107,42,402,80,3538
15000US060350403052,267,76,56,42,0,12,56,42,211,77,33,25,178,74,3539
15000US060350403053,501,95,62,47,49,45,13,17,439,91,103,48,336,87,3540
15000US060350404001,476,73,24,19,14,13,10,14,452,71,151,53,301,66,3541
15000US060350404002,0,17,0,17,0,17,0,17,0,17,0,17,0,17,3542
15000US060350405001,601,108,20,19,7,12,13,15,581,112,178,78,403,107,3543
15000US060350405002,242,71,30,45,30,45,0,12,212,66,55,51,157,62,3544
15000US060350405003,517,108,39,42,14,17,25,38,478,112,198,86,280,96,3545
15000US060350406001,442,107,20,22,10,16,10,16,422,105,177,81,245,86,3546
15000US060350406002,84,29,8,10,1,6,7,8,76,26,30,18,46,18,3547
15000US060350406003,384,94,44,39,38,36,6,10,340,94,123,64,217,76,3548
15000US060371011101,623,113,83,55,14,16,69,54,540,101,114,59,426,108,3549
15000US060371011102,614,89,60,52,25,31,35,36,554,98,140,67,414,93,3550
15000US060371011103,397,85,29,25,8,13,21,21,368,86,86,49,282,85,3551
15000US060371011221,796,91,11,18,11,18,0,12,785,90,118,47,667,87,3552
15000US060371011222,446,86,25,24,20,23,5,11,421,84,80,47,341,87,3553
15000US060371012101,900,130,55,49,16,24,39,44,845,143,264,133,581,165,3554
15000US060371012102,1404,141,54,51,0,12,54,51,1350,144,370,129,980,170,3555
15000US060371012201,380,60,0,12,0,12,0,12,380,60,71,37,309,62,3556
15000US060371012202,840,79,51,32,20,23,31,24,789,82,221,59,568,88,3557
15000US060371013001,441,77,14,19,14,19,0,12,427,77,90,37,337,78,3558
15000US060371013002,443,82,9,14,0,12,9,14,434,84,110,54,324,89,3559
15000US060371013003,320,84,0,12,0,12,0,12,320,84,161,81,159,79,3560
15000US060371013004,257,71,23,36,23,36,0,12,234,68,67,50,167,63,3561
15000US060371014001,359,87,54,44,54,44,0,12,305,87,47,40,258,91,3562
15000US060371014002,675,93,4,8,0,12,4,8,671,93,103,48,568,102,3563
15000US060371014003,519,92,24,26,0,12,24,26,495,91,203,85,292,81,3564
15000US060371021031,683,36,15,14,0,12,15,14,668,38,147,46,521,55,3565
15000US060371021041,856,100,23,34,0,12,23,34,833,106,146,63,687,114,3566
15000US060371021042,415,97,20,25,20,25,0,12,395,98,49,30,346,108,3567
15000US060371021051,238,45,11,12,0,12,11,12,227,43,34,28,193,46,3568
15000US060371021052,324,51,60,37,32,36,28,29,264,57,49,32,215,64,3569
15000US060371021071,866,91,40,42,13,16,27,39,826,92,190,91,636,115,3570
15000US060371021072,376,64,44,39,0,12,44,39,332,69,156,78,176,66,3571
15000US060371031011,564,49,10,11,10,11,0,12,554,49,175,50,379,56,3572
15000US060371031012,358,47,36,34,6,9,30,33,322,45,124,47,198,47,3573
15000US060371031021,257,63,8,14,0,12,8,14,249,64,92,61,157,64,3574
15000US060371031022,282,67,32,30,12,18,20,24,250,69,14,15,236,70,3575
15000US060371031023,372,91,38,34,27,34,11,19,334,96,74,38,260,94,3576
15000US060371031024,301,91,0,12,0,12,0,12,301,91,146,83,155,56,3577
15000US060371031025,433,85,23,26,0,12,23,26,410,83,85,42,325,87,3578
15000US060371032001,709,134,0,12,0,12,0,12,709,134,284,125,425,136,3579
15000US060371032002,603,128,30,33,16,26,14,22,573,127,123,60,450,122,3580
15000US060371032003,890,140,48,65,9,17,39,61,842,145,315,136,527,133,3581
15000US060371033001,622,80,7,11,0,12,7,11,615,81,149,76,466,88,3582
15000US060371033002,563,85,0,12,0,12,0,12,563,85,92,41,471,74,3583
15000US060371034001,498,124,68,64,9,17,59,65,430,123,190,111,240,96,3584
15000US060371034002,305,117,0,12,0,12,0,12,305,117,97,88,208,80,3585
15000US060371034003,210,66,0,12,0,12,0,12,210,66,54,38,156,63,3586
15000US060371034004,412,122,55,60,15,25,40,58,357,115,0,12,357,115,3587
15000US060371034005,1035,151,62,77,44,71,18,31,973,160,242,107,731,161,3588
15000US060371041031,398,61,47,33,9,14,38,32,351,64,107,40,244,62,3589
15000US060371041032,418,68,48,30,32,28,16,16,370,70,99,42,271,67,3590
15000US060371041051,411,83,45,41,45,41,0,12,366,84,87,44,279,80,3591
15000US060371041052,1138,95,365,96,127,67,238,93,773,138,244,98,529,118,3592
15000US060371041081,413,84,42,30,15,22,27,21,371,84,82,38,289,82,3593
15000US060371041082,680,97,90,66,45,54,45,35,590,118,198,70,392,111,3594
15000US060371041083,311,85,44,35,23,19,21,27,267,94,97,62,170,80,3595
15000US060371041241,575,111,3,6,3,6,0,12,572,112,226,93,346,97,3596
15000US060371041242,403,95,46,35,37,31,9,16,357,98,107,60,250,94,3597
15000US060371041243,299,78,9,15,9,15,0,12,290,80,37,23,253,83,3598
15000US060371042011,299,68,44,35,8,10,36,34,255,75,30,24,225,71,3599
15000US060371042012,343,64,84,46,44,37,40,32,259,63,93,43,166,63,3600
15000US060371042013,265,70,40,37,32,34,8,11,225,62,87,46,138,58,3601
15000US060371042031,566,74,136,68,21,24,115,64,430,68,97,47,333,74,3602
15000US060371042032,461,77,65,34,15,17,50,32,396,80,110,50,286,81,3603
15000US060371042041,306,54,52,35,23,26,29,26,254,53,75,35,179,50,3604
15000US060371042042,429,50,39,27,20,20,19,19,390,48,135,43,255,52,3605
15000US060371043101,219,48,41,31,30,25,11,17,178,48,116,44,62,33,3606
15000US060371043102,356,61,81,46,29,26,52,37,275,63,61,37,214,61,3607
15000US060371043103,276,52,48,37,6,8,42,36,228,45,98,34,130,52,3608
15000US060371043201,616,114,32,28,10,17,22,22,584,120,282,105,302,101,3609
15000US060371043202,282,108,103,83,86,81,17,28,179,83,42,42,137,75,3610
15000US060371043203,195,60,39,35,8,13,31,33,156,60,70,43,86,60,3611
15000US060371043204,156,69,42,43,19,26,23,31,114,57,35,38,79,45,3612
15000US060371044011,303,50,39,30,29,26,10,15,264,49,86,33,178,50,3613
15000US060371044012,416,51,106,41,35,24,71,33,310,53,102,41,208,49,3614
15000US060371044031,394,57,105,50,45,32,60,42,289,69,91,33,198,65,3615
15000US060371044032,240,55,16,12,10,8,6,9,224,54,69,35,155,52,3616
15000US060371044041,245,48,45,30,17,21,28,23,200,46,99,35,101,37,3617
15000US060371044042,373,53,56,32,22,21,34,24,317,59,79,30,238,54,3618
15000US060371045001,171,45,45,27,29,22,16,14,126,43,48,24,78,36,3619
15000US060371045002,425,65,94,45,62,42,32,27,331,66,120,53,211,65,3620
15000US060371046101,438,53,86,40,60,36,26,23,352,51,92,39,260,53,3621
15000US060371046102,274,49,35,22,16,16,19,19,239,51,80,42,159,51,3622
15000US060371046201,244,61,43,34,6,9,37,33,201,53,65,35,136,54,3623
15000US060371046202,468,54,94,37,32,27,62,28,374,57,117,42,257,60,3624
15000US060371047011,351,52,95,41,66,36,29,21,256,53,105,45,151,47,3625
15000US060371047012,389,52,209,51,74,37,135,47,180,55,116,47,64,36,3626
15000US060371047013,172,48,40,29,0,12,40,29,132,43,18,21,114,41,3627
15000US060371047031,305,52,87,47,34,27,53,37,218,64,74,45,144,51,3628
15000US060371047032,261,43,39,26,34,25,5,8,222,49,59,37,163,49,3629
15000US060371047041,1107,74,167,82,41,44,126,70,940,99,253,90,687,112,3630
15000US060371048101,174,61,5,9,5,9,0,12,169,61,58,43,111,46,3631
15000US060371048102,212,70,9,19,0,12,9,19,203,69,85,60,118,62,3632
15000US060371048103,637,94,136,81,136,81,0,12,501,114,139,59,362,121,3633
15000US060371048211,522,51,67,43,37,37,30,25,455,62,157,56,298,64,3634
15000US060371048212,229,44,22,26,0,12,22,26,207,45,54,33,153,40,3635
15000US060371048221,615,39,126,49,43,40,83,41,489,61,155,45,334,64,3636
15000US060371060101,939,49,65,51,0,12,65,51,874,65,273,69,601,94,3637
15000US060371060201,521,92,33,30,6,11,27,27,488,97,249,83,239,77,3638
15000US060371060202,911,111,59,36,12,16,47,35,852,108,290,98,562,98,3639
15000US060371061111,518,93,32,41,0,12,32,41,486,93,140,65,346,85,3640
15000US060371061112,823,89,24,38,0,12,24,38,799,99,225,89,574,95,3641
15000US060371061121,526,97,41,34,6,9,35,33,485,94,160,80,325,83,3642
15000US060371061122,969,107,8,12,0,12,8,12,961,108,173,61,788,111,3643
15000US060371061131,546,82,26,23,0,12,26,23,520,84,100,45,420,86,3644
15000US060371061132,365,63,22,18,0,12,22,18,343,64,109,69,234,66,3645
15000US060371061141,1265,89,207,96,134,76,73,56,1058,125,316,104,742,123,3646
15000US060371061142,303,73,65,47,41,43,24,36,238,64,122,58,116,54,3647
15000US060371064031,283,59,54,41,54,41,0,12,229,59,64,36,165,55,3648
15000US060371064032,263,48,8,8,8,8,0,12,255,48,68,43,187,54,3649
15000US060371064033,210,50,18,17,6,9,12,14,192,49,40,31,152,42,3650
15000US060371064051,435,93,46,40,11,18,35,37,389,94,59,43,330,97,3651
15000US060371064052,365,84,0,12,0,12,0,12,365,84,114,72,251,71,3652
15000US060371064053,363,96,48,44,18,30,30,35,315,94,57,53,258,85,3653
15000US060371064061,936,109,31,38,0,12,31,38,905,109,301,93,604,109,3654
15000US060371064062,237,98,10,16,0,12,10,16,227,98,72,61,155,88,3655
15000US060371064063,395,85,41,47,15,22,26,41,354,87,79,62,275,78,3656
15000US060371064071,545,81,106,50,23,25,83,43,439,83,142,51,297,71,3657
15000US060371064072,297,67,52,32,26,25,26,17,245,62,76,32,169,60,3658
15000US060371064081,743,69,127,38,80,31,47,26,616,77,242,69,374,68,3659
15000US060371064082,202,49,81,36,34,27,47,32,121,48,47,35,74,34,3660
15000US060371065101,472,98,0,12,0,12,0,12,472,98,178,86,294,94,3661
15000US060371065102,419,94,40,33,0,12,40,33,379,93,54,42,325,89,3662
15000US060371065103,619,98,6,11,6,11,0,12,613,97,81,54,532,105,3663
15000US060371065201,566,76,17,19,9,14,8,12,549,79,169,68,380,96,3664
15000US060371065202,481,85,95,62,43,40,52,49,386,82,183,62,203,73,3665
15000US060371065203,292,81,2,6,2,6,0,12,290,80,98,59,192,76,3666
15000US060371066031,485,58,0,12,0,12,0,12,485,58,127,58,358,50,3667
15000US060371066032,489,59,3,5,0,12,3,5,486,59,108,48,378,57,3668
15000US060371066041,60,40,20,23,20,23,0,12,40,37,23,36,17,20,3669
15000US060371066042,558,113,46,44,10,15,36,43,512,111,119,58,393,110,3670
15000US060371066043,242,84,27,42,0,12,27,42,215,83,40,41,175,82,3671
15000US060371066044,321,75,48,43,38,46,10,16,273,72,91,46,182,70,3672
15000US060371066411,749,50,0,12,0,12,0,12,749,50,126,41,623,56,3673
15000US060371066421,371,73,16,19,0,12,16,19,355,76,128,57,227,69,3674
15000US060371066422,351,59,0,12,0,12,0,12,351,59,108,43,243,69,3675
15000US060371066423,317,72,0,12,0,12,0,12,317,72,98,46,219,78,3676
15000US060371066431,853,81,6,11,0,12,6,11,847,82,224,94,623,108,3677
15000US060371066432,276,67,19,27,0,12,19,27,257,60,50,37,207,65,3678
15000US060371066433,210,61,27,33,20,31,7,11,183,59,27,25,156,57,3679
15000US060371066451,439,77,11,16,11,16,0,12,428,83,122,59,306,81,3680
15000US060371066452,707,71,13,19,0,12,13,19,694,72,120,47,574,90,3681
15000US060371066461,577,47,22,20,14,15,8,12,555,49,189,52,366,54,3682
15000US060371066462,402,52,22,20,7,9,15,18,380,47,96,34,284,55,3683
15000US060371066481,696,64,66,39,22,26,44,29,630,68,258,54,372,78,3684
15000US060371066482,304,59,92,52,28,32,64,46,212,52,64,35,148,50,3685
15000US060371066491,279,54,38,31,19,23,19,23,241,49,60,31,181,48,3686
15000US060371066492,428,61,14,14,9,13,5,9,414,58,109,41,305,65,3687
15000US060371070101,728,36,79,43,24,25,55,39,649,53,243,57,406,65,3688
15000US060371070201,1034,95,191,79,84,61,107,72,843,103,254,114,589,115,3689
15000US060371070202,221,87,11,17,11,17,0,12,210,85,88,59,122,60,3690
15000US060371081011,772,37,0,12,0,12,0,12,772,37,116,42,656,47,3691
15000US060371081021,1236,57,16,18,9,14,7,11,1220,60,222,70,998,76,3692
15000US060371081031,555,77,5,8,0,12,5,8,550,78,98,61,452,73,3693
15000US060371081032,431,74,0,12,0,12,0,12,431,74,91,44,340,71,3694
15000US060371081041,583,21,0,12,0,12,0,12,583,21,118,39,465,39,3695
15000US060371082011,902,113,11,18,0,12,11,18,891,113,121,63,770,110,3696
15000US060371082012,1030,100,5,11,5,11,0,12,1025,99,139,50,886,114,3697
15000US060371082021,2320,103,40,45,0,17,40,45,2280,115,603,165,1677,189,3698
15000US060371091001,372,59,5,7,5,7,0,12,367,60,131,46,236,58,3699
15000US060371091002,344,43,10,11,10,11,0,12,334,42,134,50,200,49,3700
15000US060371092001,204,62,0,12,0,12,0,12,204,62,31,23,173,61,3701
15000US060371092002,321,89,0,12,0,12,0,12,321,89,73,40,248,87,3702
15000US060371092003,424,76,0,12,0,12,0,12,424,76,94,67,330,85,3703
15000US060371093001,262,59,0,12,0,12,0,12,262,59,111,37,151,53,3704
15000US060371093002,420,67,5,8,5,8,0,12,415,67,143,57,272,73,3705
15000US060371093003,238,54,4,6,4,6,0,12,234,53,74,37,160,47,3706
15000US060371094001,307,73,26,28,26,28,0,12,281,72,100,49,181,61,3707
15000US060371094002,282,67,7,12,7,12,0,12,275,68,79,56,196,61,3708
15000US060371094003,458,84,9,14,0,12,9,14,449,85,258,85,191,86,3709
15000US060371095001,237,63,17,27,0,12,17,27,220,58,47,30,173,60,3710
15000US060371095002,448,85,58,50,9,16,49,48,390,92,112,59,278,87,3711
15000US060371095003,332,80,16,20,11,17,5,10,316,84,233,80,83,59,3712
15000US060371096011,263,78,16,16,11,14,5,11,247,75,117,62,130,53,3713
15000US060371096012,281,86,0,12,0,12,0,12,281,86,120,70,161,70,3714
15000US060371096013,374,96,9,14,0,12,9,14,365,96,51,34,314,96,3715
15000US060371096014,345,85,23,28,18,27,5,9,322,81,156,64,166,67,3716
15000US060371096031,338,77,31,29,8,13,23,25,307,78,139,54,168,62,3717
15000US060371096032,569,108,21,29,0,12,21,29,548,112,139,82,409,106,3718
15000US060371096033,346,90,34,33,25,27,9,16,312,88,113,50,199,84,3719
15000US060371096041,289,71,20,21,7,11,13,17,269,69,98,60,171,59,3720
15000US060371096042,305,59,24,23,21,23,3,6,281,59,61,30,220,59,3721
15000US060371096043,298,59,0,12,0,12,0,12,298,59,88,41,210,57,3722
15000US060371097001,395,114,1,8,1,8,0,12,394,112,70,45,324,111,3723
15000US060371097002,626,100,9,13,0,12,9,13,617,101,177,71,440,107,3724
15000US060371097003,299,82,0,12,0,12,0,12,299,82,52,31,247,84,3725
15000US060371098001,387,67,9,14,0,12,9,14,378,66,152,62,226,75,3726
15000US060371098002,267,70,10,20,6,10,4,17,257,70,65,40,192,67,3727
15000US060371098003,423,74,9,15,9,15,0,12,414,74,136,60,278,73,3728
15000US060371098004,375,75,30,35,19,31,11,17,345,69,72,60,273,71,3729
15000US060371111001,502,50,32,26,32,26,0,12,470,55,114,41,356,70,3730
15000US060371111002,455,52,9,10,5,8,4,8,446,52,131,46,315,52,3731
15000US060371112011,285,53,50,32,17,19,33,31,235,55,69,38,166,51,3732
15000US060371112012,533,79,12,19,0,12,12,19,521,77,139,60,382,80,3733
15000US060371112013,244,60,16,22,16,22,0,12,228,55,79,43,149,60,3734
15000US060371112021,477,89,0,12,0,12,0,12,477,89,161,81,316,78,3735
15000US060371112022,567,110,7,12,7,12,0,12,560,112,98,67,462,125,3736
15000US060371112023,721,126,43,37,43,37,0,12,678,123,87,41,591,127,3737
15000US060371112041,765,90,8,12,0,12,8,12,757,90,156,59,601,84,3738
15000US060371112042,645,66,0,12,0,12,0,12,645,66,218,76,427,74,3739
15000US060371112043,499,83,11,17,11,17,0,12,488,84,142,44,346,92,3740
15000US060371112051,512,88,44,50,5,15,39,47,468,89,120,70,348,87,3741
15000US060371112052,263,87,11,17,0,12,11,17,252,89,28,23,224,91,3742
15000US060371112053,537,96,0,12,0,12,0,12,537,96,81,46,456,100,3743
15000US060371112061,358,89,7,11,7,11,0,12,351,90,69,48,282,89,3744
15000US060371112062,250,68,0,12,0,12,0,12,250,68,35,36,215,67,3745
15000US060371112063,230,60,16,27,16,27,0,12,214,54,97,38,117,44,3746
15000US060371112064,294,71,10,16,0,12,10,16,284,75,76,41,208,78,3747
15000US060371112065,373,85,0,12,0,12,0,12,373,85,135,78,238,71,3748
15000US060371113011,386,99,13,22,13,22,0,12,373,102,61,44,312,96,3749
15000US060371113012,745,140,76,78,14,21,62,75,669,148,0,12,669,148,3750
15000US060371113013,909,166,0,12,0,12,0,12,909,166,217,99,692,185,3751
15000US060371113014,652,162,50,47,38,46,12,19,602,166,46,45,556,166,3752
15000US060371113021,565,91,0,12,0,12,0,12,565,91,211,75,354,86,3753
15000US060371113022,1292,99,68,46,19,31,49,37,1224,110,245,82,979,121,3754
15000US060371114001,867,156,0,12,0,12,0,12,867,156,179,86,688,151,3755
15000US060371114002,725,141,111,92,25,39,86,79,614,136,203,112,411,143,3756
15000US060371114003,1287,188,40,41,23,33,17,27,1247,202,592,215,655,190,3757
15000US060371131011,515,73,0,12,0,12,0,12,515,73,122,48,393,77,3758
15000US060371131012,614,75,0,12,0,12,0,12,614,75,130,55,484,80,3759
15000US060371131021,507,57,0,12,0,12,0,12,507,57,152,42,355,56,3760
15000US060371131022,478,55,0,12,0,12,0,12,478,55,126,40,352,58,3761
15000US060371132111,746,79,0,12,0,12,0,12,746,79,123,53,623,87,3762
15000US060371132112,852,92,0,12,0,12,0,12,852,92,149,54,703,100,3763
15000US060371132121,429,77,0,12,0,12,0,12,429,77,84,47,345,80,3764
15000US060371132122,680,78,58,55,10,15,48,53,622,82,150,58,472,94,3765
15000US060371132131,931,115,28,28,13,20,15,17,903,119,137,75,766,127,3766
15000US060371132132,717,114,23,24,0,12,23,24,694,112,114,64,580,110,3767
15000US060371132311,609,48,0,12,0,12,0,12,609,48,107,43,502,56,3768
15000US060371132312,231,45,0,12,0,12,0,12,231,45,77,40,154,39,3769
15000US060371132321,792,81,13,20,13,20,0,12,779,77,180,58,599,90,3770
15000US060371132322,583,75,0,12,0,12,0,12,583,75,95,48,488,73,3771
15000US060371132331,460,139,200,117,200,117,0,12,260,143,32,42,228,145,3772
15000US060371132332,780,185,190,134,8,14,182,132,590,195,79,68,511,174,3773
15000US060371132333,1211,186,109,91,42,52,67,78,1102,195,155,78,947,203,3774
15000US060371132341,581,91,26,23,9,14,17,18,555,89,147,61,408,88,3775
15000US060371132342,927,104,177,76,61,51,116,62,750,118,131,54,619,120,3776
15000US060371132351,696,54,61,37,39,29,22,21,635,57,185,55,450,69,3777
15000US060371132371,918,90,56,49,0,12,56,49,862,91,203,80,659,93,3778
15000US060371132372,525,81,9,14,9,14,0,12,516,82,149,53,367,86,3779
15000US060371133011,254,46,13,16,5,8,8,14,241,46,74,37,167,45,3780
15000US060371133012,644,69,19,23,0,12,19,23,625,71,212,55,413,65,3781
15000US060371133031,759,80,13,20,13,20,0,12,746,84,193,63,553,88,3782
15000US060371133032,631,82,25,21,25,21,0,12,606,78,313,93,293,77,3783
15000US060371133211,1650,165,171,92,29,33,142,83,1479,177,161,95,1318,183,3784
15000US060371133212,724,146,34,41,20,33,14,23,690,142,166,92,524,137,3785
15000US060371133221,643,73,9,14,9,14,0,12,634,75,115,70,519,80,3786
15000US060371133222,771,75,11,17,0,12,11,17,760,77,199,87,561,87,3787
15000US060371134011,617,78,8,13,8,13,0,12,609,81,251,90,358,84,3788
15000US060371134012,457,76,26,22,17,21,9,12,431,80,158,54,273,78,3789
15000US060371134013,709,77,27,29,8,13,19,26,682,78,155,61,527,93,3790
15000US060371134211,560,109,101,58,27,28,74,47,459,101,85,63,374,102,3791
15000US060371134212,642,78,79,38,49,30,30,26,563,79,148,57,415,92,3792
15000US060371134213,763,88,99,56,24,22,75,53,664,99,88,63,576,104,3793
15000US060371134221,584,155,15,25,15,25,0,12,569,155,191,120,378,132,3794
15000US060371134222,814,144,151,119,16,27,135,117,663,163,133,84,530,166,3795
15000US060371134223,389,95,20,25,5,14,15,24,369,95,91,45,278,101,3796
15000US060371134224,329,118,0,12,0,12,0,12,329,118,57,47,272,117,3797
15000US060371151011,580,85,0,12,0,12,0,12,580,85,197,79,383,92,3798
15000US060371151012,684,77,8,12,8,12,0,12,676,75,268,65,408,79,3799
15000US060371151013,392,86,11,15,0,12,11,15,381,87,104,58,277,76,3800
15000US060371151031,52,21,12,17,12,17,0,12,40,18,10,7,30,17,3801
15000US060371151041,335,80,0,12,0,12,0,12,335,80,148,68,187,68,3802
15000US060371151042,1547,122,44,37,0,12,44,37,1503,128,73,40,1430,130,3803
15000US060371152011,1121,168,0,12,0,12,0,12,1121,168,162,95,959,175,3804
15000US060371152012,699,150,0,12,0,12,0,12,699,150,109,63,590,149,3805
15000US060371152013,980,169,19,29,0,12,19,29,961,172,122,80,839,184,3806
15000US060371152021,749,104,9,16,0,12,9,16,740,106,106,43,634,114,3807
15000US060371152022,583,97,47,57,0,12,47,57,536,100,100,35,436,109,3808
15000US060371152023,584,118,0,12,0,12,0,12,584,118,95,42,489,122,3809
15000US060371153011,417,66,5,9,5,9,0,12,412,64,60,38,352,71,3810
15000US060371153012,1233,110,58,53,38,49,20,22,1175,119,258,104,917,143,3811
15000US060371153021,1029,29,213,52,42,27,171,47,816,60,187,45,629,62,3812
15000US060371154011,903,129,27,32,7,11,20,30,876,129,169,72,707,129,3813
15000US060371154012,1016,118,170,81,21,24,149,78,846,120,208,81,638,102,3814
15000US060371154031,1012,54,110,63,27,27,83,56,902,72,254,82,648,95,3815
15000US060371154041,368,74,48,31,12,19,36,27,320,82,56,31,264,82,3816
15000US060371154042,449,72,103,54,37,30,66,44,346,78,69,33,277,77,3817
15000US060371171011,515,92,9,14,9,14,0,12,506,91,88,46,418,105,3818
15000US060371171012,859,92,143,72,32,38,111,75,716,85,160,59,556,90,3819
15000US060371171021,311,51,38,27,34,27,4,6,273,53,103,38,170,51,3820
15000US060371171022,488,65,18,21,0,12,18,21,470,65,115,43,355,65,3821
15000US060371172011,858,97,129,76,8,13,121,75,729,107,160,67,569,105,3822
15000US060371172012,284,67,0,12,0,12,0,12,284,67,101,53,183,62,3823
15000US060371172021,461,44,0,12,0,12,0,12,461,44,108,39,353,52,3824
15000US060371172022,279,41,22,25,16,24,6,8,257,47,9,10,248,48,3825
15000US060371173011,542,60,26,30,9,13,17,27,516,59,120,57,396,71,3826
15000US060371173012,391,56,0,12,0,12,0,12,391,56,62,36,329,60,3827
15000US060371173013,298,57,59,48,38,32,21,32,239,47,59,32,180,53,3828
15000US060371173021,316,55,0,12,0,12,0,12,316,55,101,39,215,62,3829
15000US060371173022,397,77,20,30,0,12,20,30,377,78,97,51,280,77,3830
15000US060371173023,364,64,0,12,0,12,0,12,364,64,70,52,294,64,3831
15000US060371173024,619,90,121,67,30,33,91,59,498,88,125,50,373,85,3832
15000US060371173031,625,84,8,13,0,12,8,13,617,86,154,56,463,83,3833
15000US060371173032,406,82,0,12,0,12,0,12,406,82,134,81,272,97,3834
15000US060371174041,390,70,22,33,22,33,0,12,368,70,115,63,253,72,3835
15000US060371174042,287,66,0,12,0,12,0,12,287,66,67,34,220,70,3836
15000US060371174043,648,82,42,49,33,46,9,15,606,85,215,75,391,91,3837
15000US060371174051,862,26,264,61,56,33,208,64,598,61,67,40,531,70,3838
15000US060371174071,918,44,206,56,52,31,154,52,712,66,193,60,519,74,3839
15000US060371174081,861,32,225,58,73,40,152,50,636,58,186,57,450,67,3840
15000US060371175101,952,74,280,86,57,48,223,79,672,108,160,71,512,110,3841
15000US060371175201,988,45,295,66,43,30,252,61,693,74,179,51,514,79,3842
15000US060371175301,600,94,170,72,51,36,119,70,430,86,156,58,274,77,3843
15000US060371175302,949,96,196,71,26,29,170,67,753,105,183,74,570,101,3844
15000US060371190011,471,55,56,41,27,30,29,28,415,58,134,50,281,48,3845
15000US060371190012,183,41,26,24,26,24,0,12,157,43,71,37,86,33,3846
15000US060371190013,300,53,16,14,0,12,16,14,284,55,111,51,173,51,3847
15000US060371190021,230,69,4,8,0,12,4,8,226,70,86,47,140,71,3848
15000US060371190022,291,83,0,12,0,12,0,12,291,83,117,62,174,71,3849
15000US060371190023,258,53,27,32,21,30,6,9,231,52,126,60,105,48,3850
15000US060371190024,456,89,3,8,3,8,0,12,453,88,216,64,237,79,3851
15000US060371190025,375,85,32,31,4,12,28,32,343,84,36,30,307,89,3852
15000US060371192011,175,43,38,29,18,17,20,24,137,36,85,34,52,24,3853
15000US060371192012,316,62,39,29,25,22,14,17,277,61,54,34,223,65,3854
15000US060371192013,378,55,65,34,37,29,28,24,313,48,81,40,232,51,3855
15000US060371192021,256,77,21,24,0,12,21,24,235,80,31,28,204,80,3856
15000US060371192022,248,68,5,11,0,12,5,11,243,67,68,50,175,73,3857
15000US060371192023,209,70,19,26,19,26,0,12,190,68,20,22,170,69,3858
15000US060371192024,333,72,0,12,0,12,0,12,333,72,158,63,175,88,3859
15000US060371193101,789,89,81,51,34,26,47,42,708,94,227,84,481,101,3860
15000US060371193102,355,80,96,64,56,49,40,39,259,73,55,43,204,75,3861
15000US060371193201,1172,40,238,75,103,54,135,64,934,88,241,79,693,111,3862
15000US060371193401,972,34,306,81,103,52,203,71,666,76,163,52,503,73,3863
15000US060371193411,779,39,98,36,20,15,78,35,681,51,326,62,355,58,3864
15000US060371193421,748,32,146,56,74,41,72,42,602,61,222,59,380,71,3865
15000US060371194001,172,52,22,26,0,12,22,26,150,56,30,27,120,49,3866
15000US060371194002,312,71,30,43,30,43,0,12,282,74,126,57,156,69,3867
15000US060371194003,318,75,22,26,14,20,8,15,296,74,61,47,235,75,3868
15000US060371194004,283,70,46,43,28,32,18,27,237,66,96,49,141,61,3869
15000US060371197001,414,81,0,12,0,12,0,12,414,81,66,37,348,89,3870
15000US060371197002,416,64,8,13,8,13,0,12,408,65,104,46,304,78,3871
15000US060371197003,433,75,14,17,9,14,5,12,419,76,94,42,325,79,3872
15000US060371198001,232,66,0,12,0,12,0,12,232,66,76,45,156,55,3873
15000US060371198002,350,87,63,50,36,41,27,28,287,84,89,51,198,75,3874
15000US060371198003,258,83,15,15,0,12,15,15,243,83,89,62,154,69,3875
15000US060371198004,381,88,37,44,6,10,31,48,344,82,122,51,222,77,3876
15000US060371198005,185,54,0,12,0,12,0,12,185,54,44,33,141,50,3877
15000US060371199001,393,74,17,19,7,12,10,15,376,77,79,61,297,81,3878
15000US060371199002,491,83,26,41,26,41,0,12,465,79,105,56,360,85,3879
15000US060371199003,124,54,13,19,0,12,13,19,111,55,71,45,40,37,3880
15000US060371199004,204,73,8,12,8,12,0,12,196,74,59,39,137,68,3881
15000US060371200101,398,52,104,46,32,25,72,43,294,58,98,36,196,62,3882
15000US060371200102,296,51,24,20,10,10,14,17,272,52,51,32,221,51,3883
15000US060371200201,663,99,90,67,33,40,57,56,573,100,124,56,449,98,3884
15000US060371200202,447,91,98,67,21,23,77,58,349,99,80,51,269,108,3885
15000US060371200301,695,41,161,53,71,36,90,36,534,57,224,60,310,67,3886
15000US060371201031,835,41,234,65,87,42,147,56,601,80,145,59,456,80,3887
15000US060371201041,754,30,124,48,58,31,66,36,630,52,184,49,446,58,3888
15000US060371201051,548,49,86,41,9,10,77,40,462,55,140,50,322,62,3889
15000US060371201052,334,51,9,12,9,12,0,12,325,52,186,47,139,41,3890
15000US060371201061,1191,46,232,79,51,45,181,72,959,85,199,84,760,106,3891
15000US060371201071,1025,37,277,65,38,29,239,57,748,69,150,49,598,70,3892
15000US060371201081,604,90,124,67,27,36,97,57,480,83,152,61,328,79,3893
15000US060371201082,722,92,168,74,73,43,95,62,554,99,134,60,420,97,3894
15000US060371203001,223,66,25,38,0,12,25,38,198,65,92,49,106,47,3895
15000US060371203002,373,98,65,57,40,37,25,40,308,91,131,76,177,67,3896
15000US060371203003,297,67,14,22,0,12,14,22,283,73,155,69,128,52,3897
15000US060371203004,513,101,127,77,51,55,76,52,386,97,92,64,294,87,3898
15000US060371204001,1198,119,102,45,26,31,76,47,1096,127,418,130,678,136,3899
15000US060371204002,169,59,49,50,45,49,4,8,120,53,42,32,78,46,3900
15000US060371204003,347,73,19,22,10,18,9,16,328,75,34,32,294,74,3901
15000US060371204004,371,91,14,18,0,12,14,18,357,88,140,69,217,74,3902
15000US060371210101,235,77,8,13,0,12,8,13,227,79,90,49,137,77,3903
15000US060371210102,424,86,6,9,6,9,0,12,418,86,86,59,332,85,3904
15000US060371210103,320,96,104,84,55,57,49,55,216,93,77,55,139,83,3905
15000US060371210104,281,77,12,18,12,18,0,12,269,78,96,66,173,74,3906
15000US060371210201,221,57,64,55,30,26,34,51,157,50,18,18,139,50,3907
15000US060371210202,523,78,116,51,19,21,97,52,407,74,62,34,345,70,3908
15000US060371210203,306,54,9,13,9,13,0,12,297,53,79,42,218,58,3909
15000US060371211011,331,46,28,21,11,13,17,17,303,45,85,31,218,47,3910
15000US060371211012,606,56,121,51,11,17,110,48,485,73,127,45,358,73,3911
15000US060371211021,225,53,32,29,20,22,12,18,193,47,67,38,126,43,3912
15000US060371211022,261,54,25,36,25,36,0,12,236,50,54,28,182,47,3913
15000US060371211023,309,60,37,23,14,15,23,19,272,60,78,28,194,64,3914
15000US060371212101,554,48,58,37,24,22,34,27,496,56,208,52,288,67,3915
15000US060371212102,226,51,51,32,22,24,29,23,175,50,48,30,127,44,3916
15000US060371212211,147,38,12,15,0,12,12,15,135,36,31,23,104,30,3917
15000US060371212212,345,45,42,29,8,10,34,29,303,53,98,40,205,53,3918
15000US060371212221,876,89,280,94,123,69,157,71,596,101,139,74,457,102,3919
15000US060371212222,121,50,0,12,0,12,0,12,121,50,66,43,55,32,3920
15000US060371212223,199,60,19,19,19,19,0,12,180,60,55,35,125,52,3921
15000US060371216001,581,53,7,12,0,12,7,12,574,53,197,58,377,72,3922
15000US060371216002,237,43,3,6,0,12,3,6,234,44,83,36,151,42,3923
15000US060371218011,815,92,130,64,53,49,77,55,685,102,152,67,533,96,3924
15000US060371218012,317,70,37,36,0,12,37,36,280,69,88,38,192,63,3925
15000US060371218021,243,46,0,12,0,12,0,12,243,46,71,30,172,49,3926
15000US060371218022,336,50,9,13,0,12,9,13,327,51,84,31,243,60,3927
15000US060371218023,136,41,22,17,12,18,10,15,114,40,25,23,89,36,3928
15000US060371219001,505,89,83,58,22,24,61,53,422,92,43,38,379,95,3929
15000US060371219002,325,68,50,37,7,12,43,37,275,71,124,65,151,66,3930
15000US060371219003,216,69,27,28,20,31,7,12,189,65,67,34,122,67,3931
15000US060371220001,576,110,44,33,16,19,28,28,532,112,186,91,346,109,3932
15000US060371220002,643,120,58,56,47,56,11,17,585,114,164,89,421,93,3933
15000US060371220003,346,94,47,50,17,20,30,47,299,90,97,52,202,87,3934
15000US060371221201,556,95,131,58,70,51,61,49,425,96,163,74,262,88,3935
15000US060371221202,526,88,86,55,55,47,31,32,440,94,164,70,276,84,3936
15000US060371221211,481,48,94,39,32,23,62,33,387,54,111,39,276,50,3937
15000US060371221212,249,37,41,28,16,18,25,21,208,40,64,31,144,37,3938
15000US060371221221,113,31,19,22,6,10,13,20,94,34,21,18,73,31,3939
15000US060371221222,264,50,90,38,34,25,56,32,174,48,93,41,81,36,3940
15000US060371221223,185,54,30,33,30,33,0,12,155,52,55,25,100,45,3941
15000US060371222001,299,58,42,26,5,7,37,26,257,57,87,45,170,55,3942
15000US060371222002,476,65,67,42,36,32,31,35,409,68,118,51,291,59,3943
15000US060371222003,138,52,13,19,13,19,0,12,125,52,23,25,102,47,3944
15000US060371224101,726,74,156,74,17,20,139,69,570,84,66,48,504,89,3945
15000US060371224102,329,66,113,57,12,18,101,59,216,73,64,51,152,57,3946
15000US060371224201,301,62,33,27,0,12,33,27,268,62,93,37,175,64,3947
15000US060371224202,1057,71,187,71,34,41,153,69,870,107,184,77,686,123,3948
15000US060371230101,606,67,141,49,74,38,67,34,465,82,172,55,293,69,3949
15000US060371230102,429,62,60,36,27,26,33,26,369,68,89,36,280,64,3950
15000US060371230201,505,52,114,50,30,28,84,44,391,66,103,44,288,65,3951
15000US060371230202,324,49,41,36,8,12,33,34,283,52,100,47,183,58,3952
15000US060371231031,721,93,59,50,9,14,50,47,662,88,150,60,512,103,3953
15000US060371231032,806,104,157,92,27,32,130,91,649,116,120,73,529,109,3954
15000US060371231041,436,102,29,33,0,12,29,33,407,97,62,53,345,98,3955
15000US060371231042,675,106,99,75,32,48,67,55,576,111,74,38,502,113,3956
15000US060371231043,446,96,43,38,34,34,9,15,403,94,71,39,332,98,3957
15000US060371232031,487,79,66,48,0,12,66,48,421,85,84,52,337,84,3958
15000US060371232032,335,74,66,50,19,30,47,39,269,75,67,48,202,80,3959
15000US060371232033,296,55,95,52,21,28,74,53,201,61,44,26,157,54,3960
15000US060371232041,831,58,114,48,27,23,87,43,717,66,118,42,599,68,3961
15000US060371232042,212,41,74,34,13,11,61,31,138,37,31,21,107,33,3962
15000US060371232051,443,51,110,44,37,28,73,41,333,60,80,37,253,65,3963
15000US060371232052,281,47,41,36,0,12,41,36,240,46,67,35,173,46,3964
15000US060371232061,870,37,172,54,27,21,145,53,698,62,173,52,525,70,3965
15000US060371233011,442,77,72,57,10,16,62,52,370,69,103,56,267,69,3966
15000US060371233012,829,86,33,35,0,12,33,35,796,93,147,66,649,96,3967
15000US060371233013,216,62,15,24,15,24,0,12,201,59,0,12,201,59,3968
15000US060371233031,220,46,24,22,6,9,18,21,196,46,31,25,165,44,3969
15000US060371233032,722,56,80,34,35,26,45,23,642,65,207,59,435,74,3970
15000US060371233041,755,108,44,46,37,46,7,11,711,119,209,107,502,118,3971
15000US060371233042,192,62,25,31,17,28,8,13,167,60,37,30,130,62,3972
15000US060371233043,749,111,49,49,21,21,28,45,700,111,283,82,417,112,3973
15000US060371234101,901,88,173,71,50,44,123,57,728,109,204,70,524,127,3974
15000US060371234102,377,78,57,46,0,12,57,46,320,66,104,44,216,65,3975
15000US060371234201,745,89,174,68,26,23,148,63,571,88,161,65,410,84,3976
15000US060371234202,306,71,15,24,0,12,15,24,291,68,32,23,259,65,3977
15000US060371234203,294,82,35,37,5,7,30,36,259,82,49,35,210,80,3978
15000US060371235101,895,119,155,79,15,20,140,81,740,111,227,74,513,118,3979
15000US060371235102,670,114,58,51,8,13,50,48,612,125,201,67,411,104,3980
15000US060371235201,827,39,66,45,41,30,25,29,761,57,293,56,468,67,3981
15000US060371236011,359,74,25,28,8,11,17,27,334,75,66,38,268,74,3982
15000US060371236012,738,80,36,28,18,20,18,20,702,83,147,65,555,91,3983
15000US060371236013,806,93,80,53,25,38,55,55,726,105,236,83,490,104,3984
15000US060371236021,702,85,61,61,0,12,61,61,641,97,157,97,484,100,3985
15000US060371236022,263,50,10,17,0,12,10,17,253,51,32,25,221,56,3986
15000US060371236023,375,72,26,30,20,33,6,10,349,70,78,55,271,59,3987
15000US060371237001,187,58,0,12,0,12,0,12,187,58,25,20,162,59,3988
15000US060371237002,369,106,9,15,9,15,0,12,360,105,32,25,328,105,3989
15000US060371237003,530,99,31,38,0,12,31,38,499,103,113,52,386,111,3990
15000US060371237004,381,93,34,32,14,22,20,23,347,90,114,65,233,80,3991
15000US060371238001,526,135,0,12,0,12,0,12,526,135,167,102,359,145,3992
15000US060371238002,1006,142,44,55,0,12,44,55,962,144,129,91,833,157,3993
15000US060371238003,851,119,53,48,17,28,36,39,798,123,166,91,632,133,3994
15000US060371239011,963,100,109,73,33,38,76,63,854,122,172,78,682,115,3995
15000US060371239012,191,63,10,17,10,17,0,12,181,63,54,32,127,65,3996
15000US060371239013,294,64,19,23,0,12,19,23,275,63,100,57,175,68,3997
15000US060371239021,233,53,0,12,0,12,0,12,233,53,23,20,210,59,3998
15000US060371239022,861,62,35,27,24,23,11,16,826,64,140,53,686,78,3999
15000US060371240001,498,96,0,12,0,12,0,12,498,96,81,56,417,114,4000
15000US060371240002,619,117,69,68,19,32,50,61,550,122,50,36,500,125,4001
15000US060371240003,556,102,16,26,16,26,0,12,540,101,144,83,396,96,4002
15000US060371240004,473,96,0,12,0,12,0,12,473,96,125,83,348,101,4003
15000US060371241021,522,115,92,69,41,50,51,49,430,126,78,53,352,116,4004
15000US060371241022,481,114,46,35,26,28,20,23,435,109,54,35,381,105,4005
15000US060371241023,423,86,15,22,0,12,15,22,408,87,70,43,338,87,4006
15000US060371241031,240,47,45,43,21,28,24,34,195,50,68,31,127,49,4007
15000US060371241032,352,52,75,39,19,16,56,36,277,51,95,37,182,47,4008
15000US060371241041,821,50,79,46,3,6,76,47,742,64,162,45,580,66,4009
15000US060371241042,210,43,13,15,13,15,0,12,197,42,40,29,157,42,4010
15000US060371241051,489,64,21,20,3,6,18,19,468,64,75,36,393,67,4011
15000US060371241052,402,82,13,17,0,12,13,17,389,83,77,46,312,78,4012
15000US060371242011,426,116,59,63,15,26,44,61,367,116,55,52,312,113,4013
15000US060371242012,478,116,45,47,37,41,8,25,433,102,60,36,373,99,4014
15000US060371242013,243,103,26,34,3,11,23,32,217,99,64,61,153,94,4015
15000US060371242031,232,54,21,25,0,12,21,25,211,47,75,35,136,47,4016
15000US060371242032,590,62,127,51,25,25,102,46,463,71,66,27,397,67,4017
15000US060371242041,509,92,89,51,0,12,89,51,420,90,62,30,358,87,4018
15000US060371242042,511,95,106,62,6,12,100,64,405,100,24,24,381,101,4019
15000US060371243001,389,89,40,40,0,12,40,40,349,85,49,35,300,85,4020
15000US060371243002,481,92,104,64,36,33,68,56,377,88,141,68,236,77,4021
15000US060371243003,413,90,18,26,0,12,18,26,395,93,122,53,273,91,4022
15000US060371244001,430,79,25,40,0,12,25,40,405,70,119,57,286,76,4023
15000US060371244002,444,71,15,17,7,11,8,13,429,71,130,52,299,77,4024
15000US060371244003,761,83,9,13,9,13,0,12,752,84,93,56,659,89,4025
15000US060371245001,516,92,6,10,0,12,6,10,510,91,69,50,441,92,4026
15000US060371245002,630,95,48,29,0,12,48,29,582,95,118,54,464,105,4027
15000US060371246001,285,58,0,12,0,12,0,12,285,58,47,27,238,57,4028
15000US060371246002,540,77,8,12,0,12,8,12,532,77,67,48,465,90,4029
15000US060371246003,583,67,10,16,10,16,0,12,573,67,108,57,465,82,4030
15000US060371247001,293,68,15,24,0,12,15,24,278,70,12,29,266,72,4031
15000US060371247002,544,126,0,12,0,12,0,12,544,126,40,42,504,132,4032
15000US060371247003,836,169,39,37,28,33,11,17,797,172,14,22,783,175,4033
15000US060371247004,584,112,0,12,0,12,0,12,584,112,87,50,497,115,4034
15000US060371249021,1526,60,114,71,51,53,63,47,1412,84,337,74,1075,98,4035
15000US060371249031,1144,109,109,66,51,44,58,52,1035,115,175,94,860,133,4036
15000US060371249032,446,92,0,12,0,12,0,12,446,92,95,65,351,83,4037
15000US060371251001,608,126,20,29,0,12,20,29,588,127,64,65,524,128,4038
15000US060371251002,1591,193,139,84,28,33,111,75,1452,205,238,134,1214,182,4039
15000US060371251003,331,78,12,20,0,12,12,20,319,84,42,41,277,85,4040
15000US060371251004,321,76,0,12,0,12,0,12,321,76,67,53,254,82,4041
15000US060371252001,676,106,74,51,0,12,74,51,602,115,34,32,568,114,4042
15000US060371252002,489,87,5,8,5,8,0,12,484,87,69,32,415,91,4043
15000US060371252003,454,101,13,16,5,8,8,15,441,100,34,29,407,101,4044
15000US060371253101,406,103,28,34,18,30,10,16,378,106,87,68,291,116,4045
15000US060371253102,466,117,57,53,37,43,20,32,409,112,126,58,283,108,4046
15000US060371253103,1096,143,125,86,52,52,73,67,971,152,115,89,856,151,4047
15000US060371253201,1427,175,16,26,16,26,0,12,1411,176,374,147,1037,170,4048
15000US060371253202,1364,173,56,60,30,39,26,37,1308,175,98,59,1210,180,4049
15000US060371254011,1059,162,32,51,0,12,32,51,1027,166,294,112,733,175,4050
15000US060371254012,1331,185,35,42,20,34,15,26,1296,183,102,85,1194,194,4051
15000US060371254021,843,126,35,39,0,12,35,39,808,127,43,32,765,122,4052
15000US060371254022,287,54,0,12,0,12,0,12,287,54,36,24,251,56,4053
15000US060371254023,874,122,31,38,0,12,31,38,843,119,86,53,757,113,4054
15000US060371255011,882,107,18,18,9,13,9,13,864,109,98,74,766,118,4055
15000US060371255012,752,102,78,47,20,22,58,48,674,110,35,26,639,111,4056
15000US060371255021,1349,105,27,27,11,18,16,20,1322,110,291,98,1031,119,4057
15000US060371255022,367,85,0,12,0,12,0,12,367,85,44,34,323,86,4058
15000US060371256001,350,81,7,12,7,12,0,12,343,81,77,55,266,67,4059
15000US060371256002,454,86,10,14,0,12,10,14,444,91,81,59,363,84,4060
15000US060371256003,444,82,25,39,0,12,25,39,419,82,94,41,325,77,4061
15000US060371271021,471,85,115,88,74,76,41,44,356,92,68,47,288,83,4062
15000US060371271022,1049,98,157,70,22,21,135,67,892,121,146,66,746,128,4063
15000US060371271031,1088,58,296,95,77,58,219,93,792,96,207,78,585,97,4064
15000US060371271041,623,93,49,46,30,38,19,28,574,92,163,68,411,98,4065
15000US060371271042,585,83,111,67,27,34,84,71,474,89,48,35,426,91,4066
15000US060371272101,278,62,50,44,11,19,39,40,228,55,62,44,166,51,4067
15000US060371272102,659,108,103,74,0,12,103,74,556,105,172,76,384,96,4068
15000US060371272103,959,114,83,49,20,24,63,45,876,115,193,80,683,127,4069
15000US060371272201,410,91,51,43,10,16,41,39,359,87,83,47,276,91,4070
15000US060371272202,1298,95,192,81,24,21,168,84,1106,111,363,122,743,120,4071
15000US060371273001,710,122,123,48,16,20,107,46,587,118,183,90,404,99,4072
15000US060371273002,1004,126,51,36,17,18,34,31,953,127,140,60,813,115,4073
15000US060371274001,275,82,45,44,17,18,28,40,230,81,62,41,168,78,4074
15000US060371274002,523,103,67,64,0,12,67,64,456,98,61,35,395,105,4075
15000US060371274003,554,97,119,72,50,49,69,55,435,89,65,46,370,89,4076
15000US060371274004,526,104,99,63,77,53,22,35,427,91,32,38,395,91,4077
15000US060371275201,817,100,253,100,89,62,164,82,564,100,48,45,516,98,4078
15000US060371275202,498,94,79,43,19,26,60,39,419,91,79,61,340,78,4079
15000US060371276031,486,68,63,40,17,16,46,38,423,70,78,33,345,68,4080
15000US060371276032,421,59,19,19,0,12,19,19,402,59,83,41,319,64,4081
15000US060371276041,1197,49,94,61,34,28,60,54,1103,75,343,92,760,101,4082
15000US060371276051,216,57,0,12,0,12,0,12,216,57,34,27,182,61,4083
15000US060371276052,874,97,143,69,61,52,82,56,731,103,179,73,552,110,4084
15000US060371276061,326,65,19,15,11,16,8,14,307,67,49,39,258,68,4085
15000US060371276062,810,68,88,56,47,46,41,30,722,89,84,38,638,89,4086
15000US060371277111,878,85,94,63,0,12,94,63,784,110,135,76,649,129,4087
15000US060371277112,297,78,0,12,0,12,0,12,297,78,23,28,274,85,4088
15000US060371277121,443,97,9,14,9,14,0,12,434,97,81,57,353,85,4089
15000US060371277122,749,99,56,40,8,13,48,39,693,98,172,64,521,116,4090
15000US060371278031,625,105,64,55,64,55,0,12,561,103,207,72,354,105,4091
15000US060371278032,828,120,146,77,55,51,91,63,682,114,111,64,571,111,4092
15000US060371278041,1597,53,94,43,12,14,82,45,1503,68,221,90,1282,102,4093
15000US060371278051,424,98,54,47,0,12,54,47,370,101,36,42,334,98,4094
15000US060371278052,396,85,9,15,0,12,9,15,387,86,45,41,342,89,4095
15000US060371278053,305,61,54,40,30,28,24,37,251,63,65,40,186,67,4096
15000US060371278061,512,88,121,67,27,30,94,60,391,89,90,61,301,90,4097
15000US060371278062,296,62,40,43,12,18,28,41,256,67,113,54,143,55,4098
15000US060371278063,391,73,17,19,8,12,9,14,374,77,41,30,333,82,4099
15000US060371279101,459,99,54,59,28,45,26,39,405,91,89,41,316,94,4100
15000US060371279102,1001,122,169,82,31,28,138,84,832,127,190,89,642,129,4101
15000US060371279201,676,80,99,63,34,35,65,53,577,100,145,68,432,93,4102
15000US060371279202,570,87,138,65,87,55,51,49,432,85,33,29,399,85,4103
15000US060371281011,823,77,88,54,17,25,71,46,735,92,98,50,637,91,4104
15000US060371281012,412,67,45,33,9,14,36,29,367,67,107,51,260,66,4105
15000US060371281021,979,85,163,76,48,43,115,63,816,94,118,46,698,103,4106
15000US060371281022,491,79,46,35,8,13,38,35,445,80,109,60,336,82,4107
15000US060371282101,907,86,102,59,42,33,60,44,805,92,238,79,567,101,4108
15000US060371282102,588,96,162,65,49,41,113,60,426,87,106,54,320,86,4109
15000US060371282201,525,68,91,54,32,36,59,43,434,72,59,42,375,73,4110
15000US060371282202,628,70,34,35,17,20,17,29,594,70,77,42,517,74,4111
15000US060371283021,781,89,128,60,58,39,70,47,653,95,102,49,551,100,4112
15000US060371283022,699,93,139,69,15,17,124,67,560,95,174,72,386,80,4113
15000US060371283031,376,67,116,61,0,12,116,61,260,69,43,41,217,70,4114
15000US060371283032,743,79,192,70,13,19,179,69,551,92,92,64,459,97,4115
15000US060371284001,407,84,0,12,0,12,0,12,407,84,36,33,371,86,4116
15000US060371284002,404,96,0,12,0,12,0,12,404,96,124,58,280,92,4117
15000US060371284003,411,81,32,27,0,12,32,27,379,78,32,23,347,80,4118
15000US060371284004,437,88,0,12,0,12,0,12,437,88,29,24,408,94,4119
15000US060371285001,732,88,7,12,0,12,7,12,725,87,104,52,621,101,4120
15000US060371285002,1339,107,43,50,0,12,43,50,1296,109,245,82,1051,104,4121
15000US060371286011,1232,104,244,112,111,67,133,87,988,108,231,112,757,130,4122
15000US060371286012,488,98,54,60,4,8,50,61,434,92,119,80,315,89,4123
15000US060371286021,332,62,9,14,9,14,0,12,323,61,52,40,271,64,4124
15000US060371286022,484,84,69,69,11,17,58,67,415,93,58,33,357,94,4125
15000US060371286023,514,89,20,22,10,16,10,16,494,90,116,67,378,83,4126
15000US060371287021,418,115,12,20,12,20,0,12,406,116,15,25,391,118,4127
15000US060371287022,629,116,11,19,0,12,11,19,618,113,68,49,550,119,4128
15000US060371287023,1051,171,31,37,0,12,31,37,1020,177,128,85,892,158,4129
15000US060371287024,605,131,0,12,0,12,0,12,605,131,81,68,524,128,4130
15000US060371288011,834,105,72,62,17,18,55,60,762,106,94,44,668,109,4131
15000US060371288012,990,101,0,12,0,12,0,12,990,101,129,60,861,102,4132
15000US060371288021,760,143,0,12,0,12,0,12,760,143,103,66,657,140,4133
15000US060371288022,815,143,18,30,0,12,18,30,797,143,45,44,752,154,4134
15000US060371288023,563,155,31,29,0,12,31,29,532,156,178,110,354,136,4135
15000US060371289101,547,85,16,19,10,16,6,10,531,83,80,47,451,97,4136
15000US060371289102,601,83,6,10,0,12,6,10,595,85,139,72,456,85,4137
15000US060371289103,661,95,32,38,0,12,32,38,629,101,52,33,577,106,4138
15000US060371310101,793,109,100,56,58,45,42,37,693,112,166,73,527,121,4139
15000US060371310102,1114,111,192,97,0,12,192,97,922,116,214,66,708,124,4140
15000US060371310201,769,94,79,60,22,32,57,52,690,101,222,79,468,100,4141
15000US060371310202,409,68,0,12,0,12,0,12,409,68,78,45,331,83,4142
15000US060371310203,435,88,71,52,44,39,27,36,364,81,88,46,276,81,4143
15000US060371311001,455,61,34,35,0,12,34,35,421,62,88,39,333,61,4144
15000US060371311002,301,49,0,12,0,12,0,12,301,49,50,31,251,52,4145
15000US060371311003,290,57,0,12,0,12,0,12,290,57,60,38,230,62,4146
15000US060371312001,494,86,6,9,0,12,6,9,488,87,163,70,325,81,4147
15000US060371312002,364,77,11,16,0,12,11,16,353,75,65,43,288,73,4148
15000US060371312003,302,73,0,12,0,12,0,12,302,73,57,48,245,80,4149
15000US060371313001,217,48,30,27,9,14,21,23,187,52,86,48,101,44,4150
15000US060371313002,314,56,11,17,0,12,11,17,303,54,94,49,209,60,4151
15000US060371313003,340,69,52,39,0,12,52,39,288,70,97,54,191,66,4152
15000US060371313004,329,68,61,63,26,41,35,47,268,58,95,58,173,57,4153
15000US060371314001,971,99,41,44,29,36,12,23,930,99,195,67,735,111,4154
15000US060371314002,941,100,44,40,14,16,30,37,897,102,231,73,666,106,4155
15000US060371316001,536,93,23,21,14,16,9,14,513,97,168,83,345,104,4156
15000US060371316002,271,55,0,12,0,12,0,12,271,55,57,33,214,53,4157
15000US060371316003,313,73,0,12,0,12,0,12,313,73,68,59,245,73,4158
15000US060371316004,348,78,9,14,9,14,0,12,339,77,127,68,212,86,4159
15000US060371317011,1036,93,155,64,50,31,105,58,881,113,149,76,732,119,4160
15000US060371317012,741,92,92,56,29,27,63,53,649,91,203,82,446,106,4161
15000US060371317021,971,76,127,87,34,29,93,79,844,113,307,97,537,121,4162
15000US060371317022,233,62,16,27,16,27,0,12,217,59,18,19,199,59,4163
15000US060371318001,477,105,28,26,10,16,18,21,449,104,103,56,346,84,4164
15000US060371318002,1191,113,169,102,10,17,159,103,1022,108,227,81,795,115,4165
15000US060371319001,277,89,4,7,4,7,0,12,273,89,37,30,236,89,4166
15000US060371319002,397,95,26,28,0,12,26,28,371,96,86,53,285,100,4167
15000US060371319003,383,83,11,17,11,17,0,12,372,83,17,18,355,81,4168
15000US060371319004,351,89,0,12,0,12,0,12,351,89,122,70,229,81,4169
15000US060371320011,254,61,0,12,0,12,0,12,254,61,82,41,172,62,4170
15000US060371320012,307,59,0,12,0,12,0,12,307,59,81,50,226,68,4171
15000US060371320013,582,88,31,35,6,9,25,35,551,92,101,43,450,100,4172
15000US060371320021,337,72,43,51,43,51,0,12,294,70,68,40,226,74,4173
15000US060371320022,166,65,10,15,0,12,10,15,156,64,35,31,121,63,4174
15000US060371320023,608,80,20,24,9,14,11,19,588,82,143,67,445,88,4175
15000US060371321011,573,97,11,17,0,12,11,17,562,99,145,64,417,90,4176
15000US060371321012,453,115,65,69,42,60,23,32,388,100,30,32,358,97,4177
15000US060371321013,518,81,0,12,0,12,0,12,518,81,67,44,451,83,4178
15000US060371321021,279,109,67,75,21,23,46,72,212,93,81,58,131,82,4179
15000US060371321022,587,112,51,35,13,20,38,34,536,112,77,38,459,111,4180
15000US060371321023,1104,145,94,57,26,22,68,56,1010,141,147,61,863,139,4181
15000US060371323001,1316,141,242,127,0,12,242,127,1074,144,394,130,680,164,4182
15000US060371323002,405,94,22,34,0,12,22,34,383,96,63,46,320,96,4183
15000US060371323003,719,131,109,83,0,12,109,83,610,126,58,50,552,130,4184
15000US060371325011,704,84,111,64,22,33,89,57,593,93,238,88,355,87,4185
15000US060371325012,405,60,65,47,53,48,12,19,340,73,154,60,186,72,4186
15000US060371325021,903,83,90,55,14,17,76,52,813,98,166,69,647,119,4187
15000US060371325022,385,69,32,30,11,18,21,25,353,67,97,50,256,74,4188
15000US060371327001,207,47,16,19,8,13,8,13,191,50,69,36,122,46,4189
15000US060371327002,206,54,18,29,0,12,18,29,188,46,60,30,128,46,4190
15000US060371327003,259,66,10,19,10,19,0,12,249,64,116,59,133,44,4191
15000US060371327004,856,85,266,86,91,60,175,72,590,103,84,54,506,115,4192
15000US060371329001,418,68,0,12,0,12,0,12,418,68,128,52,290,76,4193
15000US060371329002,876,77,59,44,31,34,28,28,817,87,140,54,677,99,4194
15000US060371330001,408,101,58,50,30,40,28,33,350,100,137,80,213,78,4195
15000US060371330002,395,80,68,45,0,12,68,45,327,81,108,65,219,83,4196
15000US060371330003,475,104,36,55,0,12,36,55,439,97,105,54,334,98,4197
15000US060371331001,877,110,80,51,26,32,54,44,797,108,346,94,451,99,4198
15000US060371331002,372,84,51,46,0,12,51,46,321,89,21,19,300,89,4199
15000US060371331003,355,71,8,12,8,12,0,12,347,74,36,29,311,67,4200
15000US060371331004,367,55,36,27,12,20,24,18,331,62,62,48,269,60,4201
15000US060371340011,717,64,76,45,0,12,76,45,641,74,97,48,544,83,4202
15000US060371340012,240,54,14,14,9,11,5,7,226,52,23,23,203,53,4203
15000US060371340021,267,49,17,19,4,6,13,18,250,50,111,42,139,39,4204
15000US060371340022,759,63,134,49,69,34,65,39,625,72,172,51,453,65,4205
15000US060371341011,708,85,144,88,0,12,144,88,564,103,104,54,460,103,4206
15000US060371341012,773,82,52,50,45,48,7,11,721,69,164,58,557,76,4207
15000US060371341031,830,89,123,79,16,19,107,77,707,95,73,54,634,101,4208
15000US060371341032,477,85,20,21,0,12,20,21,457,84,93,39,364,87,4209
15000US060371341041,667,104,8,13,8,13,0,12,659,105,147,61,512,109,4210
15000US060371341042,706,97,83,54,9,14,74,51,623,102,113,47,510,98,4211
15000US060371342011,434,75,9,14,0,12,9,14,425,75,37,36,388,82,4212
15000US060371342012,361,90,0,12,0,12,0,12,361,90,81,44,280,92,4213
15000US060371342013,430,94,75,69,55,58,20,32,355,85,86,47,269,88,4214
15000US060371343021,308,75,14,15,0,12,14,15,294,75,72,46,222,67,4215
15000US060371343022,417,75,0,12,0,12,0,12,417,75,96,50,321,65,4216
15000US060371343023,490,77,20,16,0,12,20,16,470,78,73,46,397,89,4217
15000US060371343031,275,75,4,10,0,12,4,10,271,75,72,46,199,69,4218
15000US060371343032,547,107,54,58,43,55,11,18,493,98,34,26,459,104,4219
15000US060371343033,344,71,35,37,15,18,20,32,309,66,101,48,208,65,4220
15000US060371343034,621,99,29,27,29,27,0,12,592,104,110,51,482,106,4221
15000US060371343041,318,55,33,37,0,12,33,37,285,57,83,43,202,51,4222
15000US060371343042,587,38,9,17,9,17,0,12,578,40,93,37,485,50,4223
15000US060371343051,1127,14,203,75,32,28,171,66,924,76,233,78,691,102,4224
15000US060371343061,1240,46,138,89,0,12,138,89,1102,99,169,67,933,119,4225
15000US060371344211,1329,68,9,14,0,12,9,14,1320,68,270,79,1050,88,4226
15000US060371344221,582,96,13,21,0,12,13,21,569,95,49,32,520,102,4227
15000US060371344222,1041,98,0,12,0,12,0,12,1041,98,249,75,792,91,4228
15000US060371344231,551,77,0,12,0,12,0,12,551,77,90,49,461,84,4229
15000US060371344232,738,78,21,27,0,12,21,27,717,78,236,74,481,88,4230
15000US060371344241,547,57,12,12,0,12,12,12,535,60,90,44,445,59,4231
15000US060371344242,380,52,0,12,0,12,0,12,380,52,56,32,324,55,4232
15000US060371345201,1219,94,153,69,0,12,153,69,1066,96,253,66,813,107,4233
15000US060371345202,688,92,121,58,30,34,91,48,567,99,72,41,495,97,4234
15000US060371345211,764,26,145,67,0,12,145,67,619,71,81,52,538,88,4235
15000US060371345221,1271,74,234,93,108,69,126,61,1037,123,178,76,859,116,4236
15000US060371347101,946,97,216,82,42,44,174,72,730,108,88,55,642,111,4237
15000US060371347102,705,96,131,72,18,24,113,72,574,94,126,59,448,97,4238
15000US060371347201,400,81,55,36,35,18,20,31,345,75,76,38,269,82,4239
15000US060371347202,691,88,48,31,12,10,36,29,643,84,70,41,573,86,4240
15000US060371347203,479,89,14,16,0,12,14,16,465,90,84,48,381,90,4241
15000US060371348001,537,84,29,30,12,18,17,22,508,88,79,43,429,98,4242
15000US060371348002,474,108,10,16,10,16,0,12,464,109,58,35,406,109,4243
15000US060371348003,447,87,24,18,9,13,15,13,423,88,101,56,322,93,4244
15000US060371348004,283,83,0,12,0,12,0,12,283,83,47,35,236,78,4245
15000US060371348005,155,56,0,12,0,12,0,12,155,56,46,27,109,56,4246
15000US060371349011,548,93,43,30,32,33,11,15,505,95,129,69,376,92,4247
15000US060371349012,283,67,0,12,0,12,0,12,283,67,86,42,197,63,4248
15000US060371349013,262,70,10,16,10,16,0,12,252,71,65,45,187,64,4249
15000US060371349031,2466,134,130,79,19,26,111,72,2336,160,269,113,2067,173,4250
15000US060371349041,1050,83,136,65,57,43,79,50,914,93,253,84,661,115,4251
15000US060371349042,380,76,0,12,0,12,0,12,380,76,36,27,344,77,4252
15000US060371349051,1964,95,75,61,64,61,11,16,1889,110,176,68,1713,120,4253
15000US060371351021,508,89,11,19,11,19,0,12,497,93,110,61,387,99,4254
15000US060371351022,421,85,31,48,0,12,31,48,390,77,117,52,273,75,4255
15000US060371351023,333,64,15,24,15,24,0,12,318,65,97,56,221,60,4256
15000US060371351111,292,63,24,34,0,12,24,34,268,70,74,48,194,74,4257
15000US060371351112,392,73,28,28,28,28,0,12,364,75,114,60,250,70,4258
15000US060371351113,408,81,52,42,24,26,28,32,356,86,49,36,307,90,4259
15000US060371351131,1337,84,54,35,28,27,26,23,1283,82,169,56,1114,100,4260
15000US060371351141,1742,180,83,62,31,50,52,48,1659,198,264,131,1395,206,4261
15000US060371351142,748,141,0,12,0,12,0,12,748,141,267,119,481,132,4262
15000US060371352011,672,49,40,38,17,25,23,28,632,57,206,60,426,68,4263
15000US060371352012,221,46,1,4,0,12,1,4,220,46,39,23,181,49,4264
15000US060371352021,405,55,23,26,13,19,10,17,382,55,113,44,269,65,4265
15000US060371352022,498,62,58,45,5,11,53,43,440,67,69,42,371,76,4266
15000US060371352023,572,81,24,22,0,12,24,22,548,85,66,41,482,78,4267
15000US060371352031,820,135,0,12,0,12,0,12,820,135,157,69,663,146,4268
15000US060371352032,399,127,52,81,0,12,52,81,347,118,74,78,273,112,4269
15000US060371352033,563,122,20,33,0,12,20,33,543,125,49,46,494,132,4270
15000US060371352034,250,61,0,12,0,12,0,12,250,61,27,29,223,63,4271
15000US060371352035,258,67,0,12,0,12,0,12,258,67,101,56,157,75,4272
15000US060371352036,236,66,0,12,0,12,0,12,236,66,42,64,194,60,4273
15000US060371370001,858,108,52,28,25,19,27,22,806,107,154,49,652,103,4274
15000US060371370002,885,116,0,12,0,12,0,12,885,116,243,104,642,116,4275
15000US060371371031,1325,159,60,76,46,73,14,22,1265,163,229,116,1036,178,4276
15000US060371371032,1209,161,104,95,0,12,104,95,1105,181,139,79,966,175,4277
15000US060371371041,634,70,0,12,0,12,0,12,634,70,126,44,508,79,4278
15000US060371371042,410,71,41,39,14,19,27,37,369,66,65,40,304,63,4279
15000US060371372011,1205,183,64,100,0,12,64,100,1141,193,236,107,905,210,4280
15000US060371372012,465,133,0,12,0,12,0,12,465,133,51,48,414,129,4281
15000US060371372013,550,110,64,84,0,12,64,84,486,130,153,72,333,129,4282
15000US060371373011,744,57,6,10,6,10,0,12,738,58,109,35,629,64,4283
15000US060371373021,672,84,0,12,0,12,0,12,672,84,138,50,534,93,4284
15000US060371373022,927,91,6,11,0,12,6,11,921,93,143,65,778,95,4285
15000US060371374011,288,61,22,21,8,13,14,16,266,59,17,18,249,59,4286
15000US060371374012,556,78,0,12,0,12,0,12,556,78,97,51,459,77,4287
15000US060371374013,783,82,6,10,0,12,6,10,777,82,151,68,626,86,4288
15000US060371374021,866,131,0,12,0,12,0,12,866,131,231,94,635,119,4289
15000US060371374022,584,98,0,12,0,12,0,12,584,98,231,96,353,91,4290
15000US060371374023,565,125,0,12,0,12,0,12,565,125,124,99,441,127,4291
15000US060371375011,1317,113,26,29,0,12,26,29,1291,121,219,58,1072,121,4292
15000US060371375012,383,75,16,17,7,11,9,13,367,79,37,30,330,81,4293
15000US060371375021,379,85,9,14,9,14,0,12,370,84,176,68,194,68,4294
15000US060371375022,702,110,44,46,26,41,18,20,658,108,134,69,524,96,4295
15000US060371375023,694,105,0,12,0,12,0,12,694,105,115,48,579,110,4296
15000US060371375041,674,42,4,6,0,12,4,6,670,43,137,37,533,58,4297
15000US060371380001,894,97,8,13,0,12,8,13,886,98,170,72,716,100,4298
15000US060371380002,299,66,0,12,0,12,0,12,299,66,73,40,226,66,4299
15000US060371380003,585,79,0,12,0,12,0,12,585,79,113,45,472,81,4300
15000US060371390011,805,154,0,12,0,12,0,12,805,154,104,53,701,153,4301
15000US060371390012,651,143,107,83,2,10,105,82,544,129,119,61,425,132,4302
15000US060371390013,245,76,0,12,0,12,0,12,245,76,24,30,221,85,4303
15000US060371390014,357,91,0,12,0,12,0,12,357,91,60,55,297,95,4304
15000US060371392001,351,115,12,20,12,20,0,12,339,117,27,30,312,120,4305
15000US060371392002,412,134,82,95,59,87,23,39,330,97,81,51,249,97,4306
15000US060371392003,1460,184,25,35,0,12,25,35,1435,191,286,130,1149,218,4307
15000US060371393011,474,82,9,16,0,12,9,16,465,81,83,41,382,76,4308
15000US060371393012,277,85,9,15,9,15,0,12,268,86,48,48,220,82,4309
15000US060371393013,804,121,20,23,0,12,20,23,784,116,193,73,591,127,4310
15000US060371393021,908,112,90,67,25,32,65,59,818,124,112,52,706,124,4311
15000US060371393022,1017,106,78,60,33,35,45,47,939,116,286,103,653,103,4312
15000US060371393031,1338,115,110,69,27,26,83,63,1228,140,230,94,998,128,4313
15000US060371393032,613,98,55,45,21,31,34,36,558,102,134,51,424,104,4314
15000US060371394011,366,76,0,12,0,12,0,12,366,76,103,50,263,67,4315
15000US060371394012,841,94,48,46,40,44,8,14,793,104,258,110,535,111,4316
15000US060371394021,416,68,0,12,0,12,0,12,416,68,76,29,340,72,4317
15000US060371394022,292,50,13,22,13,22,0,12,279,48,17,14,262,47,4318
15000US060371394023,198,43,0,12,0,12,0,12,198,43,77,33,121,42,4319
15000US060371395021,714,105,50,55,41,53,9,14,664,114,144,63,520,124,4320
15000US060371395022,483,98,0,12,0,12,0,12,483,98,66,46,417,98,4321
15000US060371395031,1414,198,34,38,0,12,34,38,1380,204,279,107,1101,195,4322
15000US060371395032,1274,195,112,92,35,47,77,80,1162,197,265,122,897,193,4323
15000US060371395041,1071,104,86,61,13,15,73,60,985,107,265,92,720,105,4324
15000US060371395042,699,101,58,54,7,10,51,53,641,109,126,58,515,109,4325
15000US060371396001,955,128,13,20,13,20,0,12,942,127,97,62,845,139,4326
15000US060371396002,1172,134,28,32,15,24,13,21,1144,135,329,130,815,155,4327
15000US060371397011,245,92,0,12,0,12,0,12,245,92,53,48,192,92,4328
15000US060371397012,763,126,0,12,0,12,0,12,763,126,133,69,630,133,4329
15000US060371397013,509,114,0,12,0,12,0,12,509,114,27,33,482,120,4330
15000US060371397014,277,71,18,28,18,28,0,12,259,71,91,53,168,60,4331
15000US060371397015,185,63,0,12,0,12,0,12,185,63,42,40,143,58,4332
15000US060371397021,498,89,0,12,0,12,0,12,498,89,53,51,445,96,4333
15000US060371397022,284,65,0,12,0,12,0,12,284,65,21,34,263,64,4334
15000US060371397023,499,112,0,12,0,12,0,12,499,112,126,97,373,110,4335
15000US060371397024,919,117,10,18,10,18,0,12,909,119,169,95,740,122,4336
15000US060371397031,1038,13,0,12,0,12,0,12,1038,13,189,57,849,58,4337
15000US060371398011,1272,63,0,12,0,12,0,12,1272,63,330,103,942,111,4338
15000US060371398021,1364,52,26,23,0,12,26,23,1338,52,262,92,1076,101,4339
15000US060371411011,745,124,0,12,0,12,0,12,745,124,177,74,568,119,4340
15000US060371411012,1613,153,10,16,0,12,10,16,1603,155,116,61,1487,161,4341
15000US060371411021,460,78,25,29,25,29,0,12,435,81,93,52,342,88,4342
15000US060371411022,865,110,12,14,0,12,12,14,853,112,117,54,736,111,4343
15000US060371412011,838,113,42,31,8,13,34,27,796,110,68,34,728,109,4344
15000US060371412012,862,117,8,13,0,12,8,13,854,117,95,56,759,118,4345
15000US060371412013,312,78,0,12,0,12,0,12,312,78,65,50,247,78,4346
15000US060371412021,241,65,0,12,0,12,0,12,241,65,26,23,215,67,4347
15000US060371412022,729,99,0,12,0,12,0,12,729,99,65,52,664,100,4348
15000US060371412023,422,82,0,12,0,12,0,12,422,82,130,75,292,69,4349
15000US060371413021,750,150,0,12,0,12,0,12,750,150,189,108,561,148,4350
15000US060371413022,567,129,0,12,0,12,0,12,567,129,134,71,433,120,4351
15000US060371413023,1604,216,0,12,0,12,0,12,1604,216,139,91,1465,219,4352
15000US060371413031,1749,67,16,18,16,18,0,12,1733,66,300,79,1433,96,4353
15000US060371413041,957,100,27,26,6,9,21,24,930,102,199,81,731,96,4354
15000US060371413042,494,85,16,23,5,11,11,20,478,89,26,17,452,94,4355
15000US060371414001,832,114,0,12,0,12,0,12,832,114,310,86,522,103,4356
15000US060371414002,382,77,0,12,0,12,0,12,382,77,63,39,319,80,4357
15000US060371414003,835,111,10,16,10,16,0,12,825,109,172,70,653,111,4358
15000US060371415001,1048,60,9,15,0,12,9,15,1039,62,263,80,776,91,4359
15000US060371416001,807,108,9,15,9,15,0,12,798,107,82,46,716,112,4360
15000US060371416002,408,86,0,12,0,12,0,12,408,86,67,54,341,77,4361
15000US060371416003,449,71,6,10,6,10,0,12,443,72,135,59,308,81,4362
15000US060371417001,233,56,0,12,0,12,0,12,233,56,9,16,224,56,4363
15000US060371417002,694,89,8,11,0,12,8,11,686,89,165,68,521,105,4364
15000US060371417003,225,63,0,12,0,12,0,12,225,63,42,31,183,66,4365
15000US060371431001,454,145,0,12,0,12,0,12,454,145,72,96,382,120,4366
15000US060371431002,553,126,11,17,11,17,0,12,542,127,67,59,475,124,4367
15000US060371431003,1255,146,17,26,17,26,0,12,1238,149,170,96,1068,180,4368
15000US060371432001,878,125,27,25,14,16,13,19,851,122,75,58,776,122,4369
15000US060371432002,610,109,34,53,0,12,34,53,576,99,55,49,521,104,4370
15000US060371432003,547,90,0,12,0,12,0,12,547,90,37,33,510,93,4371
15000US060371433001,300,109,0,12,0,12,0,12,300,109,36,56,264,106,4372
15000US060371433002,1087,174,16,25,0,12,16,25,1071,171,164,111,907,166,4373
15000US060371433003,636,146,28,35,0,12,28,35,608,151,104,87,504,136,4374
15000US060371433004,482,117,0,12,0,12,0,12,482,117,21,25,461,121,4375
15000US060371433005,609,105,0,12,0,12,0,12,609,105,90,66,519,105,4376
15000US060371434001,1105,163,0,12,0,12,0,12,1105,163,169,98,936,188,4377
15000US060371434002,880,179,0,12,0,12,0,12,880,179,137,101,743,151,4378
15000US060371434003,373,119,0,12,0,12,0,12,373,119,37,42,336,122,4379
15000US060371434004,673,147,0,12,0,12,0,12,673,147,37,37,636,150,4380
15000US060371435001,471,116,0,12,0,12,0,12,471,116,65,42,406,120,4381
15000US060371435002,500,112,0,12,0,12,0,12,500,112,66,43,434,116,4382
15000US060371435003,777,144,82,89,0,12,82,89,695,128,63,45,632,131,4383
15000US060371435004,456,99,35,34,0,12,35,34,421,111,27,29,394,111,4384
15000US060371436021,488,118,0,12,0,12,0,12,488,118,29,46,459,119,4385
15000US060371436022,793,128,0,12,0,12,0,12,793,128,146,81,647,140,4386
15000US060371436023,927,154,3,7,0,12,3,7,924,154,55,41,869,150,4387
15000US060371436031,1320,66,20,22,0,12,20,22,1300,68,118,60,1182,88,4388
15000US060371436041,743,117,18,20,0,12,18,20,725,118,91,50,634,108,4389
15000US060371436042,1294,119,9,14,0,12,9,14,1285,119,76,44,1209,124,4390
15000US060371437001,1005,120,7,12,0,12,7,12,998,121,165,80,833,122,4391
15000US060371437002,825,115,12,20,0,12,12,20,813,117,43,34,770,118,4392
15000US060371438001,554,134,9,16,9,16,0,12,545,134,40,36,505,145,4393
15000US060371438002,615,132,0,12,0,12,0,12,615,132,95,79,520,118,4394
15000US060371438003,769,149,0,12,0,12,0,12,769,149,163,78,606,143,4395
15000US060371438004,472,141,0,12,0,12,0,12,472,141,41,39,431,141,4396
15000US060371439011,1140,112,0,12,0,12,0,12,1140,112,151,65,989,116,4397
15000US060371439012,485,83,0,12,0,12,0,12,485,83,60,61,425,79,4398
15000US060371439021,740,95,0,12,0,12,0,12,740,95,58,36,682,103,4399
15000US060371439022,608,83,0,12,0,12,0,12,608,83,64,39,544,91,4400
15000US060371810001,324,83,0,12,0,12,0,12,324,83,74,49,250,85,4401
15000US060371810002,461,123,0,12,0,12,0,12,461,123,126,91,335,119,4402
15000US060371810003,292,100,0,12,0,12,0,12,292,100,85,67,207,82,4403
15000US060371810004,447,106,0,12,0,12,0,12,447,106,24,31,423,110,4404
15000US060371810005,731,128,0,12,0,12,0,12,731,128,57,47,674,133,4405
15000US060371813001,425,70,10,16,0,12,10,16,415,67,75,42,340,73,4406
15000US060371813002,357,77,0,12,0,12,0,12,357,77,86,46,271,68,4407
15000US060371813003,601,68,0,12,0,12,0,12,601,68,133,63,468,73,4408
15000US060371814001,444,76,51,48,0,12,51,48,393,67,113,44,280,68,4409
15000US060371814002,310,62,23,28,23,28,0,12,287,61,72,53,215,49,4410
15000US060371814003,804,102,22,20,8,13,14,16,782,105,162,71,620,122,4411
15000US060371815001,419,86,70,64,21,34,49,54,349,79,82,53,267,82,4412
15000US060371815002,496,91,34,37,34,37,0,12,462,84,167,70,295,75,4413
15000US060371815003,382,84,29,27,9,15,20,23,353,83,61,37,292,86,4414
15000US060371816001,430,50,33,27,5,8,28,25,397,52,79,33,318,51,4415
15000US060371816002,617,46,21,24,4,6,17,24,596,50,133,46,463,56,4416
15000US060371831011,331,72,20,32,20,32,0,12,311,80,70,45,241,81,4417
15000US060371831012,465,83,37,29,18,21,19,21,428,83,75,56,353,86,4418
15000US060371831013,511,87,25,40,0,12,25,40,486,81,109,57,377,78,4419
15000US060371831031,658,101,24,34,24,34,0,12,634,98,99,65,535,109,4420
15000US060371831032,752,101,74,66,0,12,74,66,678,90,100,53,578,106,4421
15000US060371831041,780,32,35,27,20,22,15,13,745,40,210,57,535,66,4422
15000US060371832201,363,81,77,52,44,41,33,38,286,79,45,40,241,67,4423
15000US060371832202,349,77,0,12,0,12,0,12,349,77,85,37,264,75,4424
15000US060371832203,480,69,98,59,30,36,68,55,382,83,58,41,324,81,4425
15000US060371832211,283,74,0,12,0,12,0,12,283,74,98,38,185,69,4426
15000US060371832212,734,85,79,53,21,29,58,44,655,85,132,57,523,98,4427
15000US060371832221,275,63,8,13,0,12,8,13,267,63,49,33,218,62,4428
15000US060371832222,570,95,29,27,5,11,24,24,541,96,233,83,308,87,4429
15000US060371832223,412,71,30,31,12,18,18,25,382,73,116,57,266,81,4430
15000US060371833001,172,45,9,13,0,12,9,13,163,43,21,23,142,42,4431
15000US060371833002,402,67,11,12,11,12,0,12,391,68,62,36,329,73,4432
15000US060371833003,440,70,71,46,51,44,20,16,369,68,118,43,251,68,4433
15000US060371834011,428,59,16,15,10,11,6,10,412,58,165,53,247,54,4434
15000US060371834012,326,50,23,27,7,12,16,24,303,52,84,30,219,61,4435
15000US060371834021,355,64,27,31,0,12,27,31,328,66,64,29,264,60,4436
15000US060371834022,575,72,30,29,24,27,6,11,545,68,175,61,370,68,4437
15000US060371835101,129,40,13,12,7,9,6,9,116,42,27,23,89,35,4438
15000US060371835102,248,50,0,12,0,12,0,12,248,50,61,33,187,53,4439
15000US060371835103,371,63,26,25,11,17,15,19,345,61,67,37,278,60,4440
15000US060371835201,556,76,100,67,25,22,75,63,456,72,107,46,349,71,4441
15000US060371835202,507,85,90,50,36,31,54,43,417,69,83,46,334,80,4442
15000US060371836101,239,44,22,18,8,12,14,14,217,44,59,30,158,42,4443
15000US060371836102,715,58,111,41,22,17,89,38,604,71,99,41,505,72,4444
15000US060371836201,748,68,99,47,24,20,75,41,649,77,91,48,558,82,4445
15000US060371836202,219,52,43,36,5,7,38,35,176,49,45,32,131,44,4446
15000US060371837011,557,102,26,34,0,12,26,34,531,104,109,63,422,100,4447
15000US060371837012,358,88,24,31,0,12,24,31,334,85,116,60,218,83,4448
15000US060371837013,412,94,140,73,27,29,113,65,272,98,111,80,161,90,4449
15000US060371837021,525,87,40,45,40,45,0,12,485,91,54,42,431,90,4450
15000US060371837022,548,70,16,19,7,12,9,14,532,68,188,71,344,71,4451
15000US060371838101,580,62,187,69,66,39,121,66,393,75,79,47,314,77,4452
15000US060371838102,764,67,92,53,16,24,76,47,672,75,77,47,595,86,4453
15000US060371838201,472,77,95,53,59,46,36,32,377,91,143,81,234,84,4454
15000US060371838202,622,75,99,59,38,41,61,48,523,81,158,69,365,89,4455
15000US060371851001,518,96,0,12,0,12,0,12,518,96,64,55,454,95,4456
15000US060371851002,1220,155,191,108,55,56,136,89,1029,194,109,75,920,186,4457
15000US060371851003,511,116,1,7,1,7,0,12,510,114,117,97,393,117,4458
15000US060371852021,422,73,82,50,18,27,64,42,340,86,65,44,275,90,4459
15000US060371852022,592,99,133,82,25,41,108,76,459,85,45,39,414,82,4460
15000US060371852023,369,85,32,40,0,12,32,40,337,85,62,49,275,92,4461
15000US060371852031,578,69,70,46,5,8,65,44,508,77,139,51,369,83,4462
15000US060371852032,176,55,12,14,0,12,12,14,164,56,33,24,131,51,4463
15000US060371852033,173,57,0,12,0,12,0,12,173,57,28,20,145,53,4464
15000US060371852041,447,51,13,15,8,12,5,8,434,51,103,43,331,52,4465
15000US060371852042,239,49,18,14,7,8,11,12,221,50,53,39,168,46,4466
15000US060371853101,470,69,131,46,36,22,95,41,339,67,128,58,211,50,4467
15000US060371853102,326,47,26,22,4,6,22,21,300,49,63,33,237,47,4468
15000US060371853201,464,63,31,31,7,11,24,29,433,54,73,40,360,60,4469
15000US060371853202,396,61,78,50,24,23,54,44,318,74,84,44,234,78,4470
15000US060371861001,528,81,25,39,0,12,25,39,503,77,139,53,364,76,4471
15000US060371861002,417,68,13,16,13,16,0,12,404,69,106,51,298,68,4472
15000US060371861003,603,89,8,13,0,12,8,13,595,89,134,55,461,89,4473
15000US060371861004,255,62,0,12,0,12,0,12,255,62,35,26,220,63,4474
15000US060371862011,1168,68,130,85,87,73,43,44,1038,101,333,91,705,125,4475
15000US060371862021,215,49,5,8,0,12,5,8,210,52,24,17,186,50,4476
15000US060371862022,516,53,44,43,0,12,44,43,472,57,95,34,377,64,4477
15000US060371862031,709,101,0,12,0,12,0,12,709,101,164,65,545,100,4478
15000US060371862032,309,75,51,33,27,23,24,25,258,78,133,72,125,49,4479
15000US060371863011,310,50,18,16,0,12,18,16,292,51,68,38,224,48,4480
15000US060371863012,300,51,87,42,34,26,53,35,213,57,67,38,146,50,4481
15000US060371863013,316,53,76,33,21,17,55,32,240,50,88,36,152,49,4482
15000US060371863021,571,84,0,12,0,12,0,12,571,84,178,73,393,88,4483
15000US060371863022,603,105,32,46,0,12,32,46,571,98,76,42,495,110,4484
15000US060371863023,597,99,98,82,36,43,62,67,499,98,63,37,436,97,4485
15000US060371864011,648,59,137,53,31,32,106,46,511,63,140,39,371,61,4486
15000US060371864012,325,49,58,31,18,15,40,27,267,51,104,35,163,52,4487
15000US060371864031,377,46,30,27,9,15,21,23,347,45,100,38,247,46,4488
15000US060371864032,479,51,66,35,8,8,58,35,413,57,120,34,293,53,4489
15000US060371864041,478,48,85,41,38,32,47,29,393,58,82,43,311,56,4490
15000US060371864042,296,50,34,29,0,12,34,29,262,46,65,36,197,43,4491
15000US060371871011,490,85,25,40,0,12,25,40,465,79,96,57,369,73,4492
15000US060371871012,608,112,73,57,28,43,45,42,535,104,168,73,367,101,4493
15000US060371871021,415,85,14,17,14,17,0,12,401,85,62,51,339,90,4494
15000US060371871022,718,94,62,52,56,52,6,9,656,104,214,79,442,81,4495
15000US060371872001,518,59,82,42,45,33,37,29,436,61,103,37,333,61,4496
15000US060371872002,369,56,42,33,0,12,42,33,327,54,50,29,277,53,4497
15000US060371873001,763,100,11,17,0,12,11,17,752,101,9,14,743,103,4498
15000US060371873002,645,90,24,27,0,12,24,27,621,91,91,47,530,90,4499
15000US060371881001,922,128,11,16,0,12,11,16,911,132,72,54,839,132,4500
15000US060371881002,378,105,5,10,0,12,5,10,373,107,52,51,321,101,4501
15000US060371881003,410,81,0,12,0,12,0,12,410,81,136,66,274,74,4502
15000US060371882011,781,87,0,12,0,12,0,12,781,87,95,55,686,93,4503
15000US060371882012,536,81,0,12,0,12,0,12,536,81,67,48,469,76,4504
15000US060371882013,544,86,32,25,9,13,23,21,512,88,72,46,440,86,4505
15000US060371882021,441,75,0,12,0,12,0,12,441,75,71,51,370,86,4506
15000US060371882022,345,72,0,12,0,12,0,12,345,72,46,38,299,82,4507
15000US060371882023,295,60,15,16,15,16,0,12,280,61,40,36,240,62,4508
15000US060371883001,454,69,0,12,0,12,0,12,454,69,72,46,382,73,4509
15000US060371883002,457,96,0,12,0,12,0,12,457,96,56,38,401,92,4510
15000US060371883003,499,99,0,12,0,12,0,12,499,99,119,63,380,87,4511
15000US060371891011,525,99,27,24,0,12,27,24,498,105,60,52,438,112,4512
15000US060371891012,454,101,17,18,0,12,17,18,437,102,75,45,362,101,4513
15000US060371891013,411,77,0,12,0,12,0,12,411,77,26,22,385,79,4514
15000US060371891021,626,99,11,17,11,17,0,12,615,99,85,49,530,95,4515
15000US060371891022,605,96,25,40,0,12,25,40,580,96,49,32,531,99,4516
15000US060371891023,677,101,15,17,0,12,15,17,662,102,63,50,599,95,4517
15000US060371892011,1088,104,110,61,31,34,79,52,978,110,190,74,788,120,4518
15000US060371892012,940,99,33,21,0,12,33,21,907,97,115,46,792,105,4519
15000US060371892021,322,68,0,12,0,12,0,12,322,68,51,34,271,69,4520
15000US060371892022,310,70,15,18,8,13,7,13,295,68,35,31,260,65,4521
15000US060371892023,552,74,18,15,18,15,0,12,534,74,62,46,472,70,4522
15000US060371893001,560,75,0,12,0,12,0,12,560,75,116,58,444,81,4523
15000US060371893002,429,61,0,12,0,12,0,12,429,61,53,39,376,67,4524
15000US060371893003,340,72,0,12,0,12,0,12,340,72,34,39,306,71,4525
15000US060371894001,622,89,0,12,0,12,0,12,622,89,120,60,502,84,4526
15000US060371894002,364,62,0,12,0,12,0,12,364,62,40,29,324,61,4527
15000US060371894003,785,122,9,15,0,12,9,15,776,124,66,39,710,130,4528
15000US060371895001,1331,201,41,42,12,23,29,33,1290,206,12,19,1278,205,4529
15000US060371895002,1298,216,39,47,0,12,39,47,1259,222,104,67,1155,234,4530
15000US060371896001,965,133,15,24,0,12,15,24,950,134,104,66,846,144,4531
15000US060371896002,642,142,13,21,13,21,0,12,629,144,17,22,612,145,4532
15000US060371896003,385,82,0,12,0,12,0,12,385,82,13,22,372,83,4533
15000US060371897011,413,86,0,12,0,12,0,12,413,86,35,56,378,81,4534
15000US060371897012,429,115,17,26,17,26,0,12,412,114,16,26,396,120,4535
15000US060371897013,981,170,20,34,0,12,20,34,961,174,92,60,869,166,4536
15000US060371897021,1330,104,6,9,0,12,6,9,1324,104,162,76,1162,113,4537
15000US060371898001,1133,191,13,21,13,21,0,12,1120,191,144,97,976,194,4538
15000US060371898002,336,117,0,12,0,12,0,12,336,117,35,35,301,114,4539
15000US060371898003,960,161,0,12,0,12,0,12,960,161,83,52,877,153,4540
15000US060371899021,1010,144,16,26,16,26,0,12,994,147,260,116,734,149,4541
15000US060371899022,1387,166,10,16,10,16,0,12,1377,169,134,84,1243,174,4542
15000US060371899023,739,133,17,29,0,12,17,29,722,134,108,78,614,125,4543
15000US060371899031,1477,78,35,40,0,12,35,40,1442,84,177,62,1265,103,4544
15000US060371899041,1541,78,41,39,0,12,41,39,1500,89,195,75,1305,113,4545
15000US060371899051,495,67,0,12,0,12,0,12,495,67,51,42,444,68,4546
15000US060371899052,961,74,13,13,0,12,13,13,948,78,129,49,819,87,4547
15000US060371901001,895,208,0,12,0,12,0,12,895,208,113,80,782,205,4548
15000US060371901002,1053,193,51,49,0,12,51,49,1002,187,72,73,930,196,4549
15000US060371901003,844,200,0,12,0,12,0,12,844,200,34,39,810,201,4550
15000US060371902011,863,120,78,54,0,12,78,54,785,115,217,82,568,108,4551
15000US060371902012,440,101,41,41,32,39,9,14,399,96,23,21,376,99,4552
15000US060371902021,766,145,30,47,30,47,0,12,736,144,232,97,504,130,4553
15000US060371902022,1398,159,24,28,12,19,12,20,1374,164,92,67,1282,157,4554
15000US060371903011,1163,174,53,56,19,29,34,46,1110,173,194,77,916,168,4555
15000US060371903012,869,148,59,61,10,14,49,59,810,147,157,92,653,141,4556
15000US060371903013,693,142,14,23,0,12,14,23,679,142,46,59,633,140,4557
15000US060371904011,1284,94,51,42,0,12,51,42,1233,103,187,84,1046,127,4558
15000US060371904012,531,82,56,48,0,12,56,48,475,81,64,34,411,87,4559
15000US060371904021,1301,74,130,57,11,18,119,54,1171,93,342,78,829,93,4560
15000US060371905101,1161,112,147,92,6,11,141,90,1014,133,196,75,818,139,4561
15000US060371905102,608,102,20,24,0,12,20,24,588,105,32,30,556,108,4562
15000US060371905201,539,86,30,25,30,25,0,12,509,85,120,60,389,92,4563
15000US060371905202,1143,87,86,68,30,36,56,55,1057,105,209,71,848,111,4564
15000US060371907001,796,165,94,65,28,36,66,75,702,160,86,65,616,165,4565
15000US060371907002,374,119,0,12,0,12,0,12,374,119,36,42,338,116,4566
15000US060371907003,652,149,16,24,7,12,9,20,636,145,76,56,560,143,4567
15000US060371908011,642,107,21,24,0,12,21,24,621,109,45,36,576,111,4568
15000US060371908012,704,107,118,74,48,39,70,61,586,107,136,68,450,115,4569
15000US060371908021,640,97,73,52,0,12,73,52,567,93,108,44,459,93,4570
15000US060371908022,284,63,13,16,0,12,13,16,271,65,36,36,235,68,4571
15000US060371908023,426,86,69,51,0,12,69,51,357,90,45,34,312,87,4572
15000US060371909011,225,83,39,36,31,35,8,13,186,71,10,15,176,73,4573
15000US060371909012,860,101,74,54,33,36,41,41,786,99,78,55,708,106,4574
15000US060371909013,422,96,55,40,16,23,39,38,367,96,71,44,296,101,4575
15000US060371909021,654,95,43,40,35,38,8,13,611,96,67,35,544,97,4576
15000US060371909022,619,87,106,51,32,31,74,43,513,93,67,41,446,98,4577
15000US060371909023,317,62,71,48,0,12,71,48,246,73,43,42,203,65,4578
15000US060371910001,559,157,36,51,7,18,29,46,523,154,52,51,471,154,4579
15000US060371910002,886,154,48,36,0,12,48,36,838,159,133,76,705,174,4580
15000US060371910003,610,131,0,12,0,12,0,12,610,131,54,39,556,130,4581
15000US060371911101,857,71,122,61,71,55,51,35,735,89,291,79,444,91,4582
15000US060371911102,290,61,23,26,8,13,15,23,267,58,76,38,191,62,4583
15000US060371911201,972,99,80,52,26,33,54,38,892,100,192,89,700,118,4584
15000US060371911202,674,102,132,67,39,38,93,59,542,108,127,65,415,105,4585
15000US060371912011,904,146,173,112,38,36,135,107,731,149,165,60,566,137,4586
15000US060371912012,829,137,79,49,23,29,56,43,750,134,215,59,535,140,4587
15000US060371912031,779,89,144,66,21,22,123,63,635,99,100,66,535,100,4588
15000US060371912032,406,89,43,46,19,28,24,37,363,90,70,45,293,88,4589
15000US060371912041,837,45,129,47,12,11,117,46,708,59,152,49,556,57,4590
15000US060371913011,273,45,11,13,0,12,11,13,262,47,49,27,213,44,4591
15000US060371913012,638,55,131,50,54,29,77,47,507,69,130,46,377,67,4592
15000US060371913021,768,64,64,39,6,9,58,39,704,75,160,40,544,76,4593
15000US060371913022,158,48,4,8,4,8,0,12,154,47,7,9,147,47,4594
15000US060371914101,676,82,110,63,37,38,73,50,566,82,111,40,455,78,4595
15000US060371914102,927,87,220,84,100,62,120,65,707,100,172,63,535,97,4596
15000US060371914201,781,98,211,89,48,35,163,85,570,110,86,63,484,100,4597
15000US060371914202,365,78,57,48,0,12,57,48,308,81,30,29,278,80,4598
15000US060371915001,333,80,31,27,8,12,23,24,302,75,85,48,217,76,4599
15000US060371915002,551,87,106,53,46,33,60,42,445,83,145,54,300,88,4600
15000US060371915003,853,116,125,65,0,12,125,65,728,114,205,74,523,122,4601
15000US060371916101,804,107,87,54,9,15,78,52,717,113,68,43,649,110,4602
15000US060371916102,651,101,79,51,7,13,72,51,572,102,163,76,409,100,4603
15000US060371916201,1151,64,175,60,35,33,140,56,976,85,233,74,743,104,4604
15000US060371917101,436,89,19,20,0,12,19,20,417,83,38,25,379,85,4605
15000US060371917102,798,95,91,54,0,12,91,54,707,104,109,58,598,102,4606
15000US060371917201,676,105,105,57,9,16,96,54,571,122,91,42,480,121,4607
15000US060371917202,575,91,69,51,22,27,47,43,506,87,99,47,407,92,4608
15000US060371918101,480,99,73,52,8,14,65,50,407,102,16,14,391,104,4609
15000US060371918102,453,81,21,22,14,19,7,10,432,85,23,27,409,82,4610
15000US060371918103,286,83,18,21,11,16,7,12,268,84,51,49,217,76,4611
15000US060371918201,382,73,0,12,0,12,0,12,382,73,47,32,335,72,4612
15000US060371918202,482,66,49,42,0,12,49,42,433,78,80,46,353,76,4613
15000US060371918203,371,65,35,32,17,22,18,21,336,62,23,22,313,63,4614
15000US060371919011,730,129,9,14,0,12,9,14,721,129,127,54,594,126,4615
15000US060371919012,919,130,29,29,7,12,22,26,890,138,79,70,811,148,4616
15000US060371919021,778,113,8,14,0,12,8,14,770,114,117,72,653,114,4617
15000US060371919022,587,98,6,12,0,12,6,12,581,98,39,31,542,93,4618
15000US060371920011,685,97,0,12,0,12,0,12,685,97,162,75,523,99,4619
15000US060371920012,584,90,0,12,0,12,0,12,584,90,59,41,525,91,4620
15000US060371920021,342,73,0,12,0,12,0,12,342,73,18,19,324,74,4621
15000US060371920022,417,74,0,12,0,12,0,12,417,74,49,42,368,70,4622
15000US060371920023,552,77,8,12,0,12,8,12,544,78,86,47,458,81,4623
15000US060371923001,219,52,0,12,0,12,0,12,219,52,36,29,183,57,4624
15000US060371923002,418,77,0,12,0,12,0,12,418,77,64,32,354,75,4625
15000US060371923003,841,104,14,16,6,10,8,12,827,107,76,47,751,112,4626
15000US060371924101,449,81,7,11,0,12,7,11,442,79,66,43,376,75,4627
15000US060371924102,467,98,21,34,0,12,21,34,446,99,39,42,407,93,4628
15000US060371924103,312,74,0,12,0,12,0,12,312,74,28,24,284,82,4629
15000US060371924104,441,85,11,17,11,17,0,12,430,85,68,42,362,86,4630
15000US060371924201,577,117,0,12,0,12,0,12,577,117,67,72,510,110,4631
15000US060371924202,776,112,23,22,16,19,7,11,753,119,109,68,644,139,4632
15000US060371925101,474,99,34,28,15,17,19,21,440,107,90,61,350,102,4633
15000US060371925102,713,105,155,87,16,20,139,83,558,103,87,47,471,108,4634
15000US060371925201,889,88,122,64,33,41,89,48,767,102,58,39,709,94,4635
15000US060371925202,659,97,78,56,8,14,70,54,581,101,73,46,508,101,4636
15000US060371926101,437,101,84,52,14,17,70,49,353,95,40,28,313,95,4637
15000US060371926102,241,70,24,28,0,12,24,28,217,65,72,48,145,63,4638
15000US060371926103,760,119,148,89,30,37,118,80,612,118,127,58,485,115,4639
15000US060371926201,661,86,132,62,25,32,107,55,529,87,28,27,501,88,4640
15000US060371926202,557,85,71,50,37,35,34,38,486,87,66,53,420,86,4641
15000US060371927001,912,92,120,75,78,70,42,44,792,108,110,59,682,117,4642
15000US060371927002,161,73,43,53,31,50,12,18,118,57,33,30,85,59,4643
15000US060371941011,1622,106,14,15,0,12,14,15,1608,108,79,47,1529,120,4644
15000US060371941021,485,96,0,12,0,12,0,12,485,96,90,44,395,96,4645
15000US060371941022,667,88,18,19,0,12,18,19,649,90,44,42,605,86,4646
15000US060371941023,399,74,0,12,0,12,0,12,399,74,66,29,333,80,4647
15000US060371942001,1141,102,0,12,0,12,0,12,1141,102,81,53,1060,111,4648
15000US060371942002,531,105,9,13,9,13,0,12,522,104,46,30,476,105,4649
15000US060371943001,482,89,0,12,0,12,0,12,482,89,59,37,423,88,4650
15000US060371943002,472,86,0,12,0,12,0,12,472,86,50,33,422,92,4651
15000US060371943003,541,76,10,14,0,12,10,14,531,78,19,20,512,80,4652
15000US060371944011,709,101,0,12,0,12,0,12,709,101,39,30,670,104,4653
15000US060371944012,585,85,12,13,0,12,12,13,573,87,90,52,483,90,4654
15000US060371944021,730,144,0,12,0,12,0,12,730,144,0,12,730,144,4655
15000US060371944022,649,142,19,30,0,12,19,30,630,142,102,90,528,132,4656
15000US060371944023,716,144,0,12,0,12,0,12,716,144,97,95,619,144,4657
15000US060371945001,525,62,9,11,0,12,9,11,516,63,113,45,403,62,4658
15000US060371945002,424,49,5,8,0,12,5,8,419,50,106,35,313,57,4659
15000US060371951001,619,85,0,12,0,12,0,12,619,85,54,41,565,90,4660
15000US060371951002,262,78,0,12,0,12,0,12,262,78,41,45,221,84,4661
15000US060371951003,506,110,36,54,0,12,36,54,470,110,28,33,442,110,4662
15000US060371951004,674,108,0,12,0,12,0,12,674,108,56,48,618,111,4663
15000US060371952011,1145,87,36,30,0,12,36,30,1109,88,84,36,1025,89,4664
15000US060371952012,478,69,18,20,9,14,9,15,460,71,61,38,399,68,4665
15000US060371952021,370,64,0,12,0,12,0,12,370,64,72,36,298,65,4666
15000US060371952022,436,79,9,16,0,12,9,16,427,82,40,31,387,84,4667
15000US060371952023,661,76,0,12,0,12,0,12,661,76,79,55,582,79,4668
15000US060371953001,444,72,36,39,0,12,36,39,408,71,53,32,355,66,4669
15000US060371953002,204,56,25,38,25,38,0,12,179,52,18,19,161,53,4670
15000US060371953003,809,94,14,20,0,12,14,20,795,96,142,75,653,102,4671
15000US060371954001,397,99,13,21,13,21,0,12,384,106,62,71,322,97,4672
15000US060371954002,792,136,24,30,11,18,13,23,768,143,152,105,616,154,4673
15000US060371954003,560,112,0,12,0,12,0,12,560,112,50,45,510,119,4674
15000US060371954004,505,115,10,16,0,12,10,16,495,117,93,60,402,123,4675
15000US060371955001,1013,148,22,37,0,12,22,37,991,145,118,110,873,166,4676
15000US060371955002,428,120,23,30,0,12,23,30,405,116,58,55,347,110,4677
15000US060371955003,438,131,15,24,0,12,15,24,423,135,14,27,409,139,4678
15000US060371955004,423,131,9,18,9,18,0,12,414,131,34,43,380,126,4679
15000US060371956001,292,71,14,22,14,22,0,12,278,73,46,41,232,76,4680
15000US060371956002,439,79,29,45,0,12,29,45,410,73,98,48,312,80,4681
15000US060371956003,200,57,9,13,0,12,9,13,191,59,14,16,177,59,4682
15000US060371956004,322,68,46,33,9,13,37,30,276,66,48,39,228,76,4683
15000US060371957101,505,72,83,48,20,19,63,45,422,76,97,44,325,76,4684
15000US060371957102,320,62,79,42,0,12,79,42,241,49,47,32,194,44,4685
15000US060371957103,490,68,52,43,16,26,36,35,438,69,153,61,285,66,4686
15000US060371957201,653,65,38,27,0,12,38,27,615,66,133,41,482,62,4687
15000US060371957202,215,51,29,20,9,14,20,16,186,50,40,27,146,49,4688
15000US060371958021,411,57,40,25,5,7,35,25,371,59,57,32,314,58,4689
15000US060371958022,524,55,43,31,0,12,43,31,481,52,122,46,359,62,4690
15000US060371958031,627,85,32,32,11,18,21,26,595,93,149,76,446,92,4691
15000US060371958032,521,84,38,39,9,14,29,35,483,81,67,40,416,83,4692
15000US060371958041,388,74,24,31,0,12,24,31,364,72,95,46,269,76,4693
15000US060371958042,608,100,41,40,13,19,28,36,567,98,93,41,474,101,4694
15000US060371959011,1118,78,69,45,10,17,59,41,1049,84,173,80,876,98,4695
15000US060371959021,461,72,10,16,0,12,10,16,451,75,61,34,390,71,4696
15000US060371959022,528,66,0,12,0,12,0,12,528,66,29,28,499,71,4697
15000US060371959031,577,70,55,40,29,27,26,25,522,76,127,59,395,76,4698
15000US060371959032,341,66,67,41,20,17,47,40,274,60,50,33,224,59,4699
15000US060371972001,388,76,19,24,19,24,0,12,369,82,100,54,269,80,4700
15000US060371972002,498,93,23,29,15,25,8,13,475,95,89,49,386,93,4701
15000US060371972003,288,85,74,65,34,50,40,45,214,70,64,55,150,61,4702
15000US060371973001,657,99,17,22,0,12,17,22,640,101,70,38,570,100,4703
15000US060371973002,417,70,24,27,14,23,10,16,393,73,78,47,315,70,4704
15000US060371973003,653,93,91,65,62,47,29,43,562,91,86,41,476,89,4705
15000US060371974101,643,90,22,26,0,12,22,26,621,90,122,64,499,83,4706
15000US060371974102,635,91,0,12,0,12,0,12,635,91,20,20,615,96,4707
15000US060371974103,390,78,34,33,0,12,34,33,356,78,34,35,322,82,4708
15000US060371974201,569,90,71,52,29,37,42,38,498,92,103,50,395,87,4709
15000US060371974202,762,97,53,37,33,38,20,20,709,89,58,50,651,100,4710
15000US060371975001,867,106,88,50,72,46,16,18,779,120,75,49,704,117,4711
15000US060371975002,463,96,22,35,22,35,0,12,441,109,35,45,406,99,4712
15000US060371975003,271,73,30,38,30,38,0,12,241,70,0,12,241,70,4713
15000US060371976001,269,62,11,12,0,12,11,12,258,64,15,14,243,64,4714
15000US060371976002,701,63,30,35,0,12,30,35,671,66,153,58,518,73,4715
15000US060371977001,888,106,153,74,77,67,76,42,735,109,135,58,600,101,4716
15000US060371977002,333,84,12,14,6,11,6,9,321,84,80,49,241,82,4717
15000US060371977003,634,109,43,36,23,29,20,22,591,110,158,76,433,109,4718
15000US060371990001,303,85,23,30,23,30,0,12,280,81,29,24,251,80,4719
15000US060371990002,724,107,109,64,42,45,67,51,615,109,182,73,433,100,4720
15000US060371990003,632,110,175,93,47,52,128,80,457,112,85,65,372,97,4721
15000US060371991101,326,47,39,33,33,31,6,9,287,48,41,22,246,47,4722
15000US060371991102,395,49,45,24,18,16,27,20,350,52,173,44,177,50,4723
15000US060371991201,652,74,228,80,86,48,142,68,424,73,169,66,255,67,4724
15000US060371991202,462,66,106,49,8,12,98,48,356,68,58,35,298,70,4725
15000US060371992011,381,85,175,86,55,54,120,77,206,80,77,48,129,66,4726
15000US060371992012,806,96,161,84,53,45,108,67,645,107,205,87,440,107,4727
15000US060371992021,394,58,81,44,19,25,62,38,313,52,111,39,202,47,4728
15000US060371992022,436,58,55,29,19,16,36,25,381,60,122,48,259,50,4729
15000US060371993001,483,84,32,39,0,12,32,39,451,87,21,19,430,85,4730
15000US060371993002,779,86,140,83,37,50,103,71,639,105,183,87,456,90,4731
15000US060371994001,309,80,56,39,32,32,24,25,253,70,118,57,135,55,4732
15000US060371994002,489,70,103,54,25,28,78,50,386,75,113,51,273,75,4733
15000US060371994003,471,84,36,30,8,13,28,27,435,83,81,47,354,91,4734
15000US060371997001,628,78,2,9,2,9,0,12,626,78,133,56,493,86,4735
15000US060371997002,462,65,48,40,15,24,33,34,414,71,126,54,288,78,4736
15000US060371998001,296,71,40,35,24,27,16,23,256,77,80,58,176,60,4737
15000US060371998002,492,91,49,39,10,15,39,37,443,95,176,67,267,86,4738
15000US060371998003,360,82,64,38,26,21,38,31,296,81,59,45,237,79,4739
15000US060371998004,350,80,61,51,23,35,38,37,289,86,92,49,197,79,4740
15000US060371999001,471,49,98,38,3,5,95,39,373,58,163,54,210,52,4741
15000US060371999002,286,46,55,31,22,20,33,26,231,39,95,36,136,47,4742
15000US060372011101,265,42,48,36,7,12,41,35,217,46,57,20,160,47,4743
15000US060372011102,247,49,21,17,8,11,13,13,226,50,58,29,168,51,4744
15000US060372011103,221,48,18,15,0,12,18,15,203,49,31,28,172,46,4745
15000US060372011201,572,99,126,68,14,21,112,63,446,96,92,57,354,84,4746
15000US060372011202,379,78,0,12,0,12,0,12,379,78,60,36,319,83,4747
15000US060372011203,360,75,50,46,14,22,36,40,310,79,81,51,229,79,4748
15000US060372012001,753,31,147,58,36,32,111,49,606,65,128,38,478,68,4749
15000US060372013011,478,80,23,36,0,12,23,36,455,78,140,59,315,91,4750
15000US060372013012,625,76,130,67,42,39,88,64,495,80,171,82,324,84,4751
15000US060372013021,390,67,0,12,0,12,0,12,390,67,210,67,180,44,4752
15000US060372013022,454,81,0,12,0,12,0,12,454,81,121,70,333,77,4753
15000US060372013023,117,45,7,12,7,12,0,12,110,46,25,22,85,42,4754
15000US060372013024,889,119,26,41,0,12,26,41,863,120,87,42,776,115,4755
15000US060372014011,874,82,202,85,102,61,100,69,672,100,232,84,440,106,4756
15000US060372014012,516,82,83,54,0,12,83,54,433,83,126,64,307,83,4757
15000US060372014021,714,79,20,26,0,12,20,26,694,82,264,102,430,97,4758
15000US060372014022,412,82,26,34,5,9,21,33,386,86,129,71,257,83,4759
15000US060372014023,264,55,29,23,5,8,24,22,235,59,102,47,133,58,4760
15000US060372015011,448,77,80,44,58,31,22,31,368,75,110,64,258,77,4761
15000US060372015012,345,69,12,19,12,19,0,12,333,66,136,44,197,67,4762
15000US060372015013,787,89,83,55,39,37,44,40,704,96,94,42,610,97,4763
15000US060372015031,541,57,115,53,27,26,88,51,426,67,90,37,336,65,4764
15000US060372015032,369,54,65,35,16,14,49,33,304,62,98,46,206,54,4765
15000US060372015041,598,41,124,56,52,34,72,46,474,63,118,48,356,57,4766
15000US060372016011,655,46,33,26,30,26,3,5,622,48,197,52,425,61,4767
15000US060372016021,382,64,65,40,21,26,44,34,317,67,47,25,270,74,4768
15000US060372016022,209,60,4,7,0,12,4,7,205,61,28,17,177,60,4769
15000US060372016023,220,52,39,34,4,6,35,34,181,45,61,30,120,41,4770
15000US060372017001,313,59,28,27,14,21,14,16,285,61,57,36,228,68,4771
15000US060372017002,629,98,80,51,44,32,36,39,549,97,145,71,404,91,4772
15000US060372017003,432,91,13,15,0,12,13,15,419,94,78,48,341,93,4773
15000US060372031001,127,53,5,7,5,7,0,12,122,52,12,18,110,50,4774
15000US060372031002,550,82,151,72,23,35,128,62,399,94,120,63,279,82,4775
15000US060372031003,567,76,276,92,81,61,195,80,291,82,114,58,177,80,4776
15000US060372032001,973,74,230,88,114,62,116,63,743,115,183,61,560,111,4777
15000US060372032002,319,71,81,50,6,10,75,49,238,75,88,57,150,63,4778
15000US060372033001,456,44,48,24,15,18,33,32,408,50,165,55,243,53,4779
15000US060372035001,237,51,20,20,12,19,8,7,217,52,38,27,179,51,4780
15000US060372035002,391,60,33,32,5,8,28,30,358,58,119,46,239,50,4781
15000US060372035003,300,49,92,42,11,11,81,41,208,52,61,32,147,46,4782
15000US060372036001,296,75,39,35,10,15,29,32,257,71,53,41,204,67,4783
15000US060372036002,428,72,94,54,66,50,28,27,334,81,145,62,189,72,4784
15000US060372036003,590,83,150,65,42,37,108,57,440,94,155,58,285,93,4785
15000US060372037101,364,58,73,38,13,13,60,36,291,59,64,30,227,58,4786
15000US060372037102,452,74,129,58,75,45,54,43,323,76,107,47,216,71,4787
15000US060372037201,550,87,134,67,3,9,131,67,416,96,146,68,270,81,4788
15000US060372037202,234,60,40,31,15,23,25,26,194,60,101,48,93,53,4789
15000US060372037203,208,78,55,44,0,12,55,44,153,70,53,42,100,63,4790
15000US060372038001,333,78,112,74,37,43,75,63,221,74,15,20,206,80,4791
15000US060372038002,272,69,31,34,31,34,0,12,241,71,50,41,191,68,4792
15000US060372038003,308,75,48,36,0,12,48,36,260,73,105,65,155,54,4793
15000US060372038004,240,65,8,12,0,12,8,12,232,64,81,46,151,71,4794
15000US060372039001,291,44,69,36,5,7,64,36,222,47,28,15,194,47,4795
15000US060372039002,190,34,22,22,12,17,10,14,168,35,60,25,108,32,4796
15000US060372039003,201,37,32,24,10,15,22,19,169,37,43,32,126,42,4797
15000US060372041101,353,56,47,24,29,21,18,16,306,58,88,41,218,64,4798
15000US060372041102,233,46,32,25,10,12,22,20,201,48,90,46,111,45,4799
15000US060372041103,203,49,23,17,4,6,19,16,180,51,58,30,122,52,4800
15000US060372041201,393,68,104,52,46,37,58,47,289,71,42,22,247,71,4801
15000US060372041202,317,64,44,40,19,31,25,26,273,72,93,37,180,67,4802
15000US060372042001,417,62,103,45,30,26,73,41,314,64,101,39,213,62,4803
15000US060372042002,501,66,118,45,16,13,102,46,383,72,101,38,282,63,4804
15000US060372043001,198,46,22,27,9,13,13,22,176,41,79,31,97,51,4805
15000US060372043002,466,73,140,62,74,48,66,46,326,83,137,63,189,73,4806
15000US060372043003,243,61,34,35,15,24,19,24,209,58,81,52,128,54,4807
15000US060372043004,364,68,92,58,17,26,75,51,272,67,97,57,175,58,4808
15000US060372044101,255,40,34,30,0,12,34,30,221,43,60,34,161,44,4809
15000US060372044102,382,51,122,52,35,32,87,50,260,58,44,30,216,57,4810
15000US060372044201,662,60,167,57,44,32,123,48,495,65,115,36,380,65,4811
15000US060372044202,245,47,100,45,26,27,74,41,145,39,21,19,124,37,4812
15000US060372046001,662,84,144,66,46,32,98,60,518,92,121,56,397,97,4813
15000US060372046002,465,73,101,55,26,25,75,49,364,84,125,63,239,76,4814
15000US060372047001,594,94,142,67,17,14,125,66,452,97,153,60,299,94,4815
15000US060372047002,247,56,11,18,0,12,11,18,236,54,91,43,145,54,4816
15000US060372047003,389,90,122,67,9,14,113,66,267,84,91,63,176,73,4817
15000US060372048101,568,78,131,80,35,34,96,73,437,87,114,62,323,83,4818
15000US060372048102,264,60,52,44,15,16,37,42,212,58,35,35,177,60,4819
15000US060372048103,333,74,73,54,0,12,73,54,260,68,90,45,170,63,4820
15000US060372048201,283,38,56,30,26,21,30,22,227,42,98,37,129,39,4821
15000US060372048202,228,43,45,35,9,13,36,32,183,40,89,32,94,37,4822
15000US060372049101,819,35,182,43,46,32,136,45,637,49,239,56,398,61,4823
15000US060372049201,504,44,77,38,12,13,65,35,427,54,106,37,321,54,4824
15000US060372049202,130,33,27,25,27,25,0,12,103,35,22,21,81,32,4825
15000US060372051101,841,33,258,56,51,31,207,54,583,62,109,34,474,52,4826
15000US060372051201,657,50,168,44,50,26,118,44,489,61,133,48,356,69,4827
15000US060372051202,293,46,106,47,45,32,61,37,187,44,35,29,152,41,4828
15000US060372060101,585,108,94,78,29,39,65,64,491,94,126,83,365,100,4829
15000US060372060102,471,107,93,46,34,25,59,42,378,103,64,39,314,106,4830
15000US060372060201,258,43,20,23,12,19,8,13,238,41,8,8,230,42,4831
15000US060372060311,1372,120,40,33,15,25,25,36,1332,118,146,64,1186,120,4832
15000US060372060312,514,106,0,12,0,12,0,12,514,106,52,52,462,98,4833
15000US060372060321,213,80,68,50,22,21,46,41,145,74,30,25,115,73,4834
15000US060372060322,678,126,108,65,7,12,101,64,570,126,181,66,389,119,4835
15000US060372060323,746,117,131,74,92,63,39,42,615,123,159,79,456,116,4836
15000US060372060501,812,37,185,63,34,26,151,59,627,70,268,60,359,74,4837
15000US060372062001,315,88,118,67,75,59,43,48,197,85,105,52,92,67,4838
15000US060372062002,1690,117,232,86,143,78,89,53,1458,135,471,121,987,135,4839
15000US060372063001,742,167,191,105,58,58,133,92,551,154,278,139,273,141,4840
15000US060372063002,650,140,165,111,71,75,94,89,485,131,235,93,250,121,4841
15000US060372063003,1077,179,283,121,141,87,142,82,794,186,241,122,553,175,4842
15000US060372071011,1656,85,111,60,30,28,81,50,1545,96,328,93,1217,132,4843
15000US060372071021,1037,75,88,51,21,18,67,49,949,80,294,76,655,97,4844
15000US060372071031,296,53,14,13,11,12,3,5,282,54,58,37,224,54,4845
15000US060372071032,558,57,36,22,19,17,17,14,522,57,190,57,332,60,4846
15000US060372073011,702,168,247,117,106,90,141,93,455,138,21,29,434,143,4847
15000US060372073012,2858,209,254,132,106,77,148,108,2604,232,552,188,2052,251,4848
15000US060372073021,1896,169,247,122,61,72,186,113,1649,184,218,98,1431,176,4849
15000US060372073022,1175,165,143,100,77,74,66,67,1032,190,259,107,773,171,4850
15000US060372074001,89,31,0,12,0,12,0,12,89,31,38,22,51,27,4851
15000US060372075011,1424,83,35,26,0,12,35,26,1389,83,141,63,1248,101,4852
15000US060372075021,1953,106,94,64,82,60,12,19,1859,134,600,145,1259,158,4853
15000US060372077101,2365,143,60,54,9,14,51,52,2305,151,282,66,2023,163,4854
15000US060372079001,481,145,0,12,0,12,0,12,481,145,11,20,470,144,4855
15000US060372079002,2078,209,11,19,0,12,11,19,2067,209,181,102,1886,222,4856
15000US060372080001,1185,163,37,41,27,38,10,15,1148,177,151,104,997,185,4857
15000US060372080002,931,160,90,62,45,43,45,42,841,162,239,114,602,144,4858
15000US060372080003,290,93,37,42,17,27,20,30,253,102,24,39,229,105,4859
15000US060372083011,547,21,116,49,32,22,84,45,431,48,104,47,327,64,4860
15000US060372083021,242,73,52,43,18,20,34,38,190,65,72,42,118,63,4861
15000US060372083022,271,86,26,25,13,15,13,22,245,81,18,22,227,80,4862
15000US060372083023,931,110,209,91,71,62,138,70,722,120,187,84,535,115,4863
15000US060372084011,640,90,138,65,0,12,138,65,502,89,141,56,361,90,4864
15000US060372084012,804,86,83,57,28,27,55,52,721,97,222,71,499,109,4865
15000US060372084021,358,50,46,28,15,13,31,28,312,53,69,35,243,56,4866
15000US060372084022,446,46,94,40,31,25,63,31,352,43,110,31,242,43,4867
15000US060372085011,413,62,48,35,25,22,23,25,365,63,75,42,290,61,4868
15000US060372085012,375,59,18,14,10,10,8,11,357,59,92,33,265,61,4869
15000US060372085021,533,88,98,57,0,12,98,57,435,96,49,40,386,94,4870
15000US060372085022,432,82,43,41,28,32,15,21,389,90,119,58,270,86,4871
15000US060372085023,282,67,21,22,21,22,0,12,261,66,36,25,225,68,4872
15000US060372086101,496,91,70,51,36,40,34,31,426,81,79,36,347,83,4873
15000US060372086102,950,97,56,45,10,17,46,42,894,103,164,60,730,109,4874
15000US060372086201,295,64,44,36,19,25,25,27,251,63,83,44,168,56,4875
15000US060372086202,799,97,47,40,15,25,32,31,752,94,57,40,695,102,4876
15000US060372086203,578,105,71,54,0,12,71,54,507,101,57,49,450,101,4877
15000US060372087101,1933,83,83,53,36,37,47,39,1850,97,274,91,1576,120,4878
15000US060372087201,967,112,264,103,52,47,212,96,703,120,55,42,648,118,4879
15000US060372087202,538,102,100,61,24,26,76,59,438,104,112,62,326,89,4880
15000US060372088011,794,78,130,58,36,34,94,56,664,89,158,68,506,95,4881
15000US060372088012,413,79,51,39,0,12,51,39,362,87,41,32,321,83,4882
15000US060372088021,776,89,91,57,30,28,61,47,685,91,133,48,552,96,4883
15000US060372088022,587,98,44,41,0,12,44,41,543,98,77,49,466,95,4884
15000US060372089021,355,56,52,30,9,10,43,30,303,55,90,47,213,52,4885
15000US060372089022,296,57,35,32,0,12,35,32,261,52,9,11,252,51,4886
15000US060372089031,613,92,111,63,35,34,76,55,502,91,77,48,425,95,4887
15000US060372089032,558,92,96,63,37,40,59,50,462,98,60,39,402,96,4888
15000US060372089041,719,100,100,58,51,41,49,42,619,98,192,73,427,75,4889
15000US060372089042,523,92,89,61,15,25,74,54,434,91,85,50,349,87,4890
15000US060372091021,1013,102,202,74,83,53,119,60,811,112,121,53,690,117,4891
15000US060372091022,920,106,147,68,0,12,147,68,773,110,150,68,623,108,4892
15000US060372091031,1015,48,232,65,72,39,160,64,783,69,135,45,648,80,4893
15000US060372091041,922,31,195,47,32,24,163,42,727,52,182,55,545,72,4894
15000US060372092001,1700,87,139,66,77,65,62,40,1561,112,261,93,1300,122,4895
15000US060372093001,812,106,141,59,64,39,77,51,671,109,157,62,514,99,4896
15000US060372093002,1129,117,131,68,29,32,102,60,998,116,157,64,841,114,4897
15000US060372094011,724,98,118,62,32,32,86,59,606,109,101,57,505,111,4898
15000US060372094012,716,97,159,71,45,39,114,66,557,94,146,62,411,95,4899
15000US060372094021,544,99,107,55,38,32,69,43,437,98,49,37,388,97,4900
15000US060372094022,643,105,38,36,0,12,38,36,605,105,159,68,446,104,4901
15000US060372094031,737,73,89,51,0,12,89,51,648,78,204,67,444,90,4902
15000US060372094032,603,80,96,57,10,18,86,55,507,80,112,53,395,80,4903
15000US060372095101,393,58,58,36,27,24,31,27,335,59,36,26,299,56,4904
15000US060372095102,596,64,86,44,17,20,69,33,510,70,40,24,470,71,4905
15000US060372095201,633,61,104,51,35,27,69,44,529,65,80,37,449,66,4906
15000US060372095202,279,47,39,31,5,10,34,28,240,47,30,18,210,48,4907
15000US060372098101,335,45,74,33,13,12,61,33,261,47,25,19,236,48,4908
15000US060372098102,372,48,58,29,0,12,58,29,314,55,49,22,265,54,4909
15000US060372098201,510,65,112,42,21,25,91,38,398,73,98,42,300,75,4910
15000US060372098202,325,63,59,37,0,12,59,37,266,66,100,49,166,52,4911
15000US060372100101,396,81,120,45,13,17,107,41,276,79,129,57,147,68,4912
15000US060372100102,301,69,78,59,31,35,47,47,223,68,55,42,168,69,4913
15000US060372100103,573,87,99,62,15,17,84,61,474,91,125,49,349,95,4914
15000US060372110001,233,59,0,12,0,12,0,12,233,59,14,22,219,58,4915
15000US060372110002,252,97,0,12,0,12,0,12,252,97,48,51,204,90,4916
15000US060372110003,226,59,0,12,0,12,0,12,226,59,57,39,169,56,4917
15000US060372110004,132,64,0,12,0,12,0,12,132,64,21,19,111,63,4918
15000US060372110005,331,60,32,38,0,12,32,38,299,58,35,31,264,57,4919
15000US060372110006,571,97,0,12,0,12,0,12,571,97,145,80,426,78,4920
15000US060372111201,526,117,0,12,0,12,0,12,526,117,44,46,482,124,4921
15000US060372111202,1285,185,28,33,19,29,9,16,1257,186,109,94,1148,184,4922
15000US060372111203,610,152,59,50,0,12,59,50,551,151,64,69,487,138,4923
15000US060372111211,293,57,33,26,5,7,28,26,260,66,24,22,236,64,4924
15000US060372111212,584,70,26,16,5,7,21,14,558,70,93,40,465,76,4925
15000US060372111221,392,95,32,35,20,28,12,20,360,90,38,43,322,87,4926
15000US060372111222,867,104,63,52,0,12,63,52,804,103,107,79,697,106,4927
15000US060372112011,301,55,39,25,0,12,39,25,262,57,14,18,248,55,4928
15000US060372112012,595,60,99,43,22,22,77,42,496,62,44,30,452,62,4929
15000US060372112021,914,62,131,41,32,21,99,40,783,65,136,51,647,69,4930
15000US060372113101,537,81,0,12,0,12,0,12,537,81,87,50,450,86,4931
15000US060372113102,764,77,206,80,56,56,150,68,558,95,66,39,492,98,4932
15000US060372113201,505,87,108,63,7,11,101,62,397,97,49,36,348,100,4933
15000US060372113202,698,101,92,75,13,17,79,74,606,110,87,53,519,111,4934
15000US060372114101,818,98,129,53,26,25,103,48,689,111,75,50,614,115,4935
15000US060372114102,319,70,37,29,17,20,20,23,282,69,57,36,225,72,4936
15000US060372114201,907,83,129,57,9,13,120,55,778,93,53,35,725,99,4937
15000US060372114202,396,66,30,22,0,12,30,22,366,69,51,33,315,74,4938
15000US060372115001,475,79,46,48,7,11,39,46,429,75,114,59,315,67,4939
15000US060372115002,964,95,58,38,29,21,29,33,906,99,138,69,768,110,4940
15000US060372115003,315,58,0,12,0,12,0,12,315,58,41,26,274,58,4941
15000US060372117011,429,93,6,10,6,10,0,12,423,94,90,47,333,91,4942
15000US060372117012,373,87,21,24,9,13,12,19,352,90,42,28,310,91,4943
15000US060372117013,342,82,0,12,0,12,0,12,342,82,56,59,286,80,4944
15000US060372117031,1136,126,164,80,66,45,98,68,972,125,122,69,850,141,4945
15000US060372117032,921,104,8,14,8,14,0,12,913,106,115,60,798,113,4946
15000US060372117041,765,96,26,23,9,14,17,18,739,97,120,46,619,103,4947
15000US060372117042,846,96,58,40,0,12,58,40,788,99,82,46,706,100,4948
15000US060372118021,1416,126,118,82,36,36,82,78,1298,150,80,45,1218,150,4949
15000US060372118022,801,112,67,51,6,11,61,50,734,118,14,15,720,119,4950
15000US060372118031,774,109,21,33,0,12,21,33,753,116,69,50,684,121,4951
15000US060372118032,850,108,87,57,9,14,78,59,763,110,67,42,696,104,4952
15000US060372118041,389,83,18,23,0,12,18,23,371,88,36,33,335,93,4953
15000US060372118042,934,88,26,32,0,12,26,32,908,90,70,62,838,91,4954
15000US060372119101,618,114,55,56,19,28,36,48,563,120,53,38,510,119,4955
15000US060372119102,393,90,55,43,7,10,48,43,338,82,0,12,338,82,4956
15000US060372119103,679,100,66,57,6,10,60,56,613,93,37,29,576,93,4957
15000US060372119211,1030,67,29,30,19,25,10,17,1001,70,156,51,845,86,4958
15000US060372119221,616,88,74,56,0,12,74,56,542,99,24,19,518,100,4959
15000US060372119222,733,95,121,53,3,5,118,54,612,97,46,33,566,101,4960
15000US060372121011,668,126,109,78,0,12,109,78,559,107,26,23,533,109,4961
15000US060372121012,690,124,98,71,38,45,60,57,592,118,72,53,520,123,4962
15000US060372121021,501,75,9,13,7,11,2,6,492,73,127,52,365,81,4963
15000US060372121022,731,93,68,36,24,26,44,26,663,105,110,54,553,92,4964
15000US060372122021,772,99,107,70,19,29,88,64,665,94,83,47,582,104,4965
15000US060372122022,437,90,26,30,9,14,17,27,411,87,84,49,327,90,4966
15000US060372122031,505,76,80,57,0,12,80,57,425,75,11,19,414,76,4967
15000US060372122032,768,92,59,46,7,13,52,43,709,103,198,65,511,103,4968
15000US060372122041,584,82,84,50,0,12,84,50,500,85,122,53,378,81,4969
15000US060372122042,669,79,114,59,24,21,90,53,555,96,110,53,445,96,4970
15000US060372123031,1280,74,226,80,41,40,185,76,1054,109,171,76,883,114,4971
15000US060372123041,817,49,75,38,31,27,44,31,742,73,74,31,668,74,4972
15000US060372123051,1026,45,207,59,36,25,171,51,819,62,183,46,636,70,4973
15000US060372123061,528,80,36,34,0,12,36,34,492,86,73,47,419,85,4974
15000US060372123062,625,65,50,46,0,12,50,46,575,71,68,38,507,77,4975
15000US060372124101,600,93,17,28,0,12,17,28,583,94,39,37,544,94,4976
15000US060372124102,1121,108,78,50,6,9,72,50,1043,121,122,58,921,127,4977
15000US060372124201,682,79,54,52,7,12,47,51,628,81,113,52,515,90,4978
15000US060372124202,519,88,35,30,0,12,35,30,484,88,30,31,454,89,4979
15000US060372125011,1021,24,58,37,14,17,44,31,963,49,117,46,846,60,4980
15000US060372125021,500,71,33,28,25,26,8,11,467,69,93,49,374,70,4981
15000US060372125022,811,74,62,49,0,12,62,49,749,85,59,47,690,89,4982
15000US060372126101,1029,97,69,49,39,31,30,33,960,96,90,48,870,95,4983
15000US060372126102,800,108,48,35,17,17,31,31,752,112,98,51,654,115,4984
15000US060372126201,898,112,109,61,26,23,83,55,789,114,139,73,650,112,4985
15000US060372126202,978,113,45,37,6,11,39,35,933,112,156,82,777,122,4986
15000US060372127011,773,44,79,42,47,33,32,31,694,52,160,50,534,69,4987
15000US060372127021,672,80,3,7,0,12,3,7,669,78,66,42,603,82,4988
15000US060372127022,561,90,10,17,0,12,10,17,551,89,68,54,483,85,4989
15000US060372127023,200,63,14,23,0,12,14,23,186,60,23,26,163,59,4990
15000US060372128001,693,98,137,76,38,33,99,68,556,114,99,58,457,108,4991
15000US060372128002,354,83,9,15,9,15,0,12,345,84,47,33,298,86,4992
15000US060372128003,426,104,69,41,21,23,48,38,357,109,76,53,281,98,4993
15000US060372129001,628,102,54,40,21,32,33,40,574,103,133,64,441,104,4994
15000US060372129002,931,103,207,64,79,49,128,62,724,118,167,74,557,134,4995
15000US060372131001,525,67,49,37,0,12,49,37,476,71,34,18,442,69,4996
15000US060372131002,435,62,27,22,17,21,10,10,408,67,51,29,357,68,4997
15000US060372132011,825,90,92,56,17,27,75,49,733,95,114,54,619,90,4998
15000US060372132012,511,77,70,49,50,43,20,23,441,86,109,66,332,81,4999
15000US060372132013,178,63,10,18,1,4,9,16,168,64,52,52,116,49,5000
15000US060372132021,461,84,89,57,14,18,75,54,372,74,57,43,315,74,5001
15000US060372132022,841,89,67,44,10,16,57,39,774,93,118,55,656,98,5002
15000US060372133101,600,95,58,42,14,16,44,40,542,107,89,63,453,91,5003
15000US060372133102,554,100,73,52,15,26,58,43,481,104,95,68,386,98,5004
15000US060372133201,469,63,55,32,10,10,45,32,414,64,135,46,279,53,5005
15000US060372133202,494,67,53,30,19,21,34,23,441,63,118,53,323,59,5006
15000US060372134011,794,108,107,60,17,19,90,57,687,112,110,63,577,111,5007
15000US060372134012,951,108,144,63,46,44,98,55,807,115,110,53,697,112,5008
15000US060372134021,514,98,69,50,34,29,35,37,445,95,25,24,420,93,5009
15000US060372134022,355,77,54,48,20,32,34,37,301,74,80,52,221,65,5010
15000US060372134023,633,94,95,63,24,30,71,56,538,91,116,63,422,84,5011
15000US060372140001,286,84,11,17,11,17,0,12,275,83,32,25,243,84,5012
15000US060372140002,386,83,7,12,0,12,7,12,379,85,84,50,295,87,5013
15000US060372140003,339,72,30,44,0,12,30,44,309,64,73,40,236,64,5014
15000US060372140004,319,62,0,12,0,12,0,12,319,62,111,52,208,58,5015
15000US060372141001,483,103,0,12,0,12,0,12,483,103,51,40,432,106,5016
15000US060372141002,355,76,7,12,0,12,7,12,348,76,87,46,261,72,5017
15000US060372141003,258,74,0,12,0,12,0,12,258,74,56,59,202,66,5018
15000US060372141004,654,100,9,15,0,12,9,15,645,99,101,59,544,105,5019
15000US060372144001,550,96,24,38,0,12,24,38,526,100,50,30,476,101,5020
15000US060372144002,603,106,7,12,0,12,7,12,596,105,33,26,563,101,5021
15000US060372144003,496,92,23,18,0,12,23,18,473,92,33,25,440,95,5022
15000US060372145011,758,101,0,12,0,12,0,12,758,101,108,60,650,114,5023
15000US060372145012,316,67,0,12,0,12,0,12,316,67,42,23,274,73,5024
15000US060372145013,457,79,0,12,0,12,0,12,457,79,39,24,418,81,5025
15000US060372145021,884,126,0,12,0,12,0,12,884,126,60,67,824,136,5026
15000US060372145022,839,148,0,12,0,12,0,12,839,148,79,69,760,151,5027
15000US060372145023,774,134,18,33,18,33,0,12,756,143,18,29,738,138,5028
15000US060372145031,494,83,0,12,0,12,0,12,494,83,27,24,467,85,5029
15000US060372145032,456,83,0,12,0,12,0,12,456,83,80,48,376,79,5030
15000US060372145033,224,67,14,21,0,12,14,21,210,67,32,21,178,70,5031
15000US060372145034,344,76,0,12,0,12,0,12,344,76,21,28,323,74,5032
15000US060372146001,493,78,8,12,8,12,0,12,485,80,50,33,435,90,5033
15000US060372146002,353,65,2,9,0,12,2,9,351,65,73,47,278,73,5034
15000US060372146003,492,80,9,14,0,12,9,14,483,77,18,20,465,78,5035
15000US060372147001,470,99,0,12,0,12,0,12,470,99,58,44,412,93,5036
15000US060372147002,367,91,9,14,9,14,0,12,358,91,59,41,299,89,5037
15000US060372147003,396,75,0,12,0,12,0,12,396,75,83,39,313,77,5038
15000US060372148001,612,93,0,12,0,12,0,12,612,93,84,47,528,96,5039
15000US060372148002,537,94,19,31,0,12,19,31,518,99,34,28,484,102,5040
15000US060372148003,272,73,0,12,0,12,0,12,272,73,44,34,228,77,5041
15000US060372149011,1437,175,36,42,14,23,22,35,1401,186,303,159,1098,189,5042
15000US060372149012,689,165,0,12,0,12,0,12,689,165,28,31,661,165,5043
15000US060372149021,704,108,0,12,0,12,0,12,704,108,57,48,647,110,5044
15000US060372149022,923,105,0,12,0,12,0,12,923,105,83,57,840,106,5045
15000US060372151011,1111,134,19,15,14,13,5,8,1092,137,44,20,1048,137,5046
15000US060372151012,555,91,17,13,0,12,17,13,538,91,23,21,515,97,5047
15000US060372151021,884,154,11,18,0,12,11,18,873,155,74,55,799,157,5048
15000US060372151022,1164,173,12,19,0,12,12,19,1152,170,68,35,1084,173,5049
15000US060372161001,304,52,0,12,0,12,0,12,304,52,49,34,255,55,5050
15000US060372161002,391,59,21,34,21,34,0,12,370,53,103,41,267,63,5051
15000US060372161003,365,67,0,12,0,12,0,12,365,67,7,10,358,67,5052
15000US060372162001,275,114,0,12,0,12,0,12,275,114,0,12,275,114,5053
15000US060372162002,622,120,41,39,15,24,26,32,581,121,92,61,489,120,5054
15000US060372162003,319,104,0,12,0,12,0,12,319,104,73,51,246,112,5055
15000US060372162004,770,133,0,12,0,12,0,12,770,133,17,28,753,140,5056
15000US060372162005,682,139,0,12,0,12,0,12,682,139,130,82,552,152,5057
15000US060372163001,872,179,16,26,16,26,0,12,856,176,109,95,747,188,5058
15000US060372163002,624,145,0,12,0,12,0,12,624,145,99,54,525,139,5059
15000US060372163003,397,123,0,12,0,12,0,12,397,123,110,77,287,124,5060
15000US060372163004,409,141,0,12,0,12,0,12,409,141,29,35,380,139,5061
15000US060372164011,904,164,25,28,0,12,25,28,879,166,143,92,736,165,5062
15000US060372164012,1138,186,82,86,0,12,82,86,1056,178,279,129,777,183,5063
15000US060372164021,709,89,15,17,0,12,15,17,694,91,135,53,559,97,5064
15000US060372164022,708,79,7,12,0,12,7,12,701,78,133,58,568,93,5065
15000US060372167001,626,100,81,61,20,30,61,51,545,94,51,44,494,84,5066
15000US060372167002,508,89,30,34,0,12,30,34,478,93,32,26,446,86,5067
15000US060372167003,462,85,28,37,0,12,28,37,434,79,110,52,324,91,5068
15000US060372168001,376,68,0,12,0,12,0,12,376,68,24,22,352,69,5069
15000US060372168002,380,54,0,12,0,12,0,12,380,54,72,45,308,62,5070
15000US060372168003,350,59,0,12,0,12,0,12,350,59,22,20,328,61,5071
15000US060372168004,332,63,9,15,0,12,9,15,323,64,31,27,292,67,5072
15000US060372169001,525,147,0,12,0,12,0,12,525,147,103,107,422,131,5073
15000US060372169002,238,85,0,12,0,12,0,12,238,85,28,32,210,82,5074
15000US060372169003,807,146,71,83,24,38,47,71,736,148,159,91,577,140,5075
15000US060372169004,401,99,40,40,40,40,0,12,361,104,55,53,306,95,5076
15000US060372169005,487,133,58,80,58,80,0,12,429,124,82,82,347,112,5077
15000US060372170011,408,49,34,35,21,29,13,20,374,56,86,33,288,58,5078
15000US060372170012,394,62,17,26,0,12,17,26,377,65,68,38,309,63,5079
15000US060372170013,229,48,0,12,0,12,0,12,229,48,81,42,148,43,5080
15000US060372170021,948,147,44,38,16,25,28,30,904,154,171,98,733,160,5081
15000US060372170022,599,130,26,31,12,20,14,22,573,135,76,65,497,138,5082
15000US060372170023,760,142,18,31,18,31,0,12,742,142,133,94,609,149,5083
15000US060372171001,618,149,104,83,56,63,48,56,514,143,78,58,436,151,5084
15000US060372171002,599,136,114,83,52,64,62,85,485,133,72,68,413,118,5085
15000US060372171003,147,50,0,12,0,12,0,12,147,50,17,27,130,53,5086
15000US060372171004,460,121,78,85,20,30,58,79,382,110,25,39,357,109,5087
15000US060372171005,523,116,13,21,0,12,13,21,510,117,91,61,419,133,5088
15000US060372172001,495,91,61,52,32,37,29,34,434,94,96,67,338,85,5089
15000US060372172002,306,66,71,45,35,34,36,35,235,77,51,44,184,76,5090
15000US060372172003,376,94,16,18,7,11,9,14,360,94,44,33,316,93,5091
15000US060372172004,431,111,8,12,8,12,0,12,423,110,50,41,373,109,5092
15000US060372181101,758,68,83,44,0,12,83,44,675,83,162,68,513,87,5093
15000US060372181102,420,65,67,58,37,45,30,33,353,80,70,44,283,87,5094
15000US060372181201,922,90,194,77,22,26,172,73,728,107,169,79,559,116,5095
15000US060372181202,231,70,7,11,7,11,0,12,224,69,52,35,172,66,5096
15000US060372181203,293,78,74,30,5,9,69,28,219,74,37,29,182,70,5097
15000US060372182101,272,78,36,36,14,20,22,33,236,80,36,36,200,80,5098
15000US060372182102,396,78,42,38,10,17,32,34,354,77,108,60,246,69,5099
15000US060372182103,460,84,39,37,17,27,22,25,421,88,135,55,286,101,5100
15000US060372182201,432,80,0,12,0,12,0,12,432,80,116,61,316,78,5101
15000US060372182202,926,91,106,61,39,32,67,53,820,99,136,56,684,114,5102
15000US060372182203,245,69,0,12,0,12,0,12,245,69,70,47,175,68,5103
15000US060372183001,557,109,66,62,48,53,18,31,491,114,93,63,398,107,5104
15000US060372183002,297,104,65,50,20,33,45,51,232,112,24,36,208,109,5105
15000US060372183003,336,87,36,53,36,53,0,12,300,101,84,57,216,108,5106
15000US060372183004,521,92,29,34,0,12,29,34,492,100,79,61,413,108,5107
15000US060372183005,426,110,51,52,19,21,32,50,375,114,110,56,265,112,5108
15000US060372184001,580,94,92,63,10,16,82,61,488,98,106,56,382,101,5109
15000US060372184002,385,84,9,13,0,12,9,13,376,87,60,38,316,88,5110
15000US060372184003,211,75,10,16,10,16,0,12,201,77,48,48,153,77,5111
15000US060372184004,240,61,104,52,24,40,80,49,136,54,29,37,107,53,5112
15000US060372185001,526,58,90,42,27,20,63,34,436,65,147,57,289,61,5113
15000US060372185002,470,60,71,38,17,16,54,36,399,56,117,38,282,61,5114
15000US060372186001,395,76,69,39,21,28,48,29,326,77,103,51,223,78,5115
15000US060372186002,200,56,15,22,15,22,0,12,185,54,57,35,128,51,5116
15000US060372186003,455,76,60,48,21,23,39,42,395,81,59,46,336,80,5117
15000US060372187011,410,72,101,52,23,19,78,53,309,70,24,22,285,72,5118
15000US060372187012,446,65,38,26,19,16,19,23,408,62,123,56,285,58,5119
15000US060372187021,294,56,77,40,24,27,53,32,217,59,78,39,139,48,5120
15000US060372187022,513,72,169,50,62,31,107,39,344,69,76,35,268,64,5121
15000US060372188001,378,62,31,25,6,8,25,24,347,58,65,30,282,62,5122
15000US060372188002,525,68,85,43,16,20,69,42,440,65,75,45,365,69,5123
15000US060372189001,744,126,58,54,10,15,48,52,686,110,98,74,588,108,5124
15000US060372189002,529,122,128,87,12,20,116,82,401,103,97,60,304,93,5125
15000US060372189003,766,133,94,78,0,12,94,78,672,132,246,87,426,129,5126
15000US060372190101,390,59,68,32,37,23,31,26,322,63,88,35,234,61,5127
15000US060372190102,455,60,60,40,33,31,27,28,395,65,101,40,294,63,5128
15000US060372190201,584,102,109,64,28,32,81,53,475,95,108,56,367,94,5129
15000US060372190202,505,84,7,12,0,12,7,12,498,83,176,73,322,87,5130
15000US060372190203,344,95,99,64,13,19,86,61,245,83,72,47,173,74,5131
15000US060372193001,374,92,67,51,47,40,20,32,307,87,109,55,198,85,5132
15000US060372193002,484,86,105,55,27,34,78,55,379,89,102,53,277,82,5133
15000US060372193003,611,95,96,62,0,12,96,62,515,104,71,55,444,95,5134
15000US060372195001,273,53,20,25,5,8,15,24,253,50,58,31,195,50,5135
15000US060372195002,450,52,19,23,5,7,14,21,431,55,142,53,289,62,5136
15000US060372197001,314,89,8,14,8,14,0,12,306,90,64,47,242,93,5137
15000US060372197002,411,114,76,58,21,19,55,57,335,111,106,46,229,104,5138
15000US060372197003,629,123,53,59,34,54,19,22,576,121,161,92,415,117,5139
15000US060372198001,305,53,72,34,39,29,33,23,233,47,64,31,169,45,5140
15000US060372198002,398,54,63,37,5,8,58,37,335,56,133,47,202,51,5141
15000US060372198003,323,49,75,36,10,13,65,35,248,54,50,29,198,52,5142
15000US060372199011,430,97,88,61,10,13,78,58,342,81,154,72,188,77,5143
15000US060372199012,542,108,86,58,15,23,71,53,456,110,118,70,338,104,5144
15000US060372199013,470,106,78,60,53,53,25,28,392,105,66,50,326,99,5145
15000US060372199021,585,107,67,53,34,40,33,34,518,109,61,48,457,111,5146
15000US060372199022,286,72,30,34,0,12,30,34,256,70,80,52,176,66,5147
15000US060372199023,331,78,16,17,16,17,0,12,315,81,114,67,201,71,5148
15000US060372200001,646,122,94,68,15,23,79,65,552,124,140,90,412,110,5149
15000US060372200002,452,120,18,21,0,12,18,21,434,121,160,88,274,105,5150
15000US060372200003,310,79,6,13,6,13,0,12,304,80,129,62,175,72,5151
15000US060372200004,226,88,11,16,11,16,0,12,215,89,67,62,148,77,5152
15000US060372200005,386,103,112,62,28,26,84,54,274,97,88,54,186,86,5153
15000US060372201001,295,84,32,47,0,12,32,47,263,76,112,81,151,65,5154
15000US060372201002,413,97,105,57,11,17,94,54,308,99,103,68,205,89,5155
15000US060372201003,345,79,51,38,12,18,39,34,294,78,68,32,226,73,5156
15000US060372211101,241,60,28,32,0,12,28,32,213,61,41,42,172,58,5157
15000US060372211102,820,76,177,77,57,41,120,68,643,89,139,69,504,98,5158
15000US060372211201,355,55,88,35,27,20,61,34,267,55,42,26,225,53,5159
15000US060372211202,499,55,102,46,45,36,57,31,397,60,87,37,310,60,5160
15000US060372212101,348,54,13,15,0,12,13,15,335,54,75,36,260,56,5161
15000US060372212102,532,60,64,32,15,15,49,29,468,68,106,39,362,69,5162
15000US060372212201,397,55,51,34,4,6,47,34,346,60,34,27,312,67,5163
15000US060372212202,623,51,85,45,19,20,66,41,538,65,90,31,448,64,5164
15000US060372213021,712,91,155,77,53,46,102,63,557,108,101,62,456,118,5165
15000US060372213022,671,92,58,55,0,12,58,55,613,116,93,79,520,115,5166
15000US060372213031,442,54,20,20,3,5,17,19,422,55,31,21,391,56,5167
15000US060372213032,326,48,33,26,23,25,10,10,293,49,73,35,220,49,5168
15000US060372213041,642,87,57,42,21,22,36,35,585,92,46,35,539,96,5169
15000US060372213042,469,87,102,61,65,57,37,31,367,91,45,28,322,91,5170
15000US060372214011,396,76,82,53,25,40,57,43,314,77,92,51,222,70,5171
15000US060372214012,857,113,124,64,20,22,104,60,733,121,226,89,507,137,5172
15000US060372214021,583,52,98,45,10,15,88,43,485,59,143,42,342,54,5173
15000US060372214022,342,51,34,23,0,12,34,23,308,50,93,29,215,51,5174
15000US060372215001,799,93,212,85,68,48,144,77,587,104,184,69,403,111,5175
15000US060372215002,395,71,111,61,57,39,54,49,284,80,77,53,207,82,5176
15000US060372216011,503,55,160,48,54,35,106,38,343,63,67,40,276,60,5177
15000US060372216012,396,64,59,38,33,27,26,26,337,63,64,30,273,62,5178
15000US060372216021,426,53,108,36,22,17,86,33,318,54,50,33,268,55,5179
15000US060372216022,226,47,68,35,24,25,44,24,158,43,63,37,95,35,5180
15000US060372216023,216,45,75,37,17,20,58,32,141,42,27,23,114,41,5181
15000US060372217101,498,50,48,30,5,8,43,26,450,51,70,31,380,55,5182
15000US060372217102,410,51,68,30,6,9,62,32,342,51,127,33,215,46,5183
15000US060372218101,347,53,78,33,21,14,57,34,269,50,44,25,225,47,5184
15000US060372218102,537,60,25,22,12,17,13,16,512,60,48,29,464,57,5185
15000US060372218201,254,60,35,34,27,32,8,13,219,60,60,41,159,61,5186
15000US060372218202,715,88,8,13,0,12,8,13,707,89,32,26,675,91,5187
15000US060372219001,584,64,7,10,7,10,0,12,577,64,111,55,466,75,5188
15000US060372219002,276,64,98,52,0,12,98,52,178,60,64,61,114,52,5189
15000US060372220011,501,70,93,55,20,24,73,50,408,66,65,45,343,68,5190
15000US060372220012,400,62,58,38,16,17,42,36,342,61,77,44,265,60,5191
15000US060372220021,316,92,15,28,0,12,15,28,301,88,77,61,224,83,5192
15000US060372220022,346,87,57,48,32,35,25,34,289,81,118,50,171,84,5193
15000US060372220023,241,86,49,45,6,11,43,43,192,76,72,49,120,70,5194
15000US060372220024,422,107,44,40,4,10,40,38,378,110,120,77,258,99,5195
15000US060372221001,507,90,100,52,13,15,87,51,407,85,137,61,270,90,5196
15000US060372221002,509,89,132,68,56,52,76,45,377,97,83,59,294,87,5197
15000US060372221003,144,62,3,7,0,12,3,7,141,61,47,44,94,52,5198
15000US060372222001,660,95,84,55,38,36,46,43,576,93,110,54,466,89,5199
15000US060372222002,527,98,110,61,59,44,51,45,417,98,144,64,273,95,5200
15000US060372225001,400,80,72,40,15,21,57,37,328,83,132,63,196,81,5201
15000US060372225002,558,84,94,57,25,29,69,46,464,95,104,51,360,94,5202
15000US060372225003,390,82,72,47,26,26,46,38,318,85,106,55,212,77,5203
15000US060372226001,508,84,108,63,40,44,68,47,400,84,97,45,303,85,5204
15000US060372226002,691,105,81,50,9,14,72,48,610,101,100,51,510,109,5205
15000US060372226003,429,91,57,39,18,14,39,37,372,91,100,59,272,94,5206
15000US060372227001,141,32,4,6,0,12,4,6,137,32,13,8,124,32,5207
15000US060372240101,507,117,103,57,49,41,54,40,404,118,213,97,191,82,5208
15000US060372240102,717,124,138,83,24,39,114,76,579,127,128,59,451,127,5209
15000US060372240201,532,60,89,50,53,41,36,31,443,61,67,33,376,64,5210
15000US060372240202,357,61,131,52,31,27,100,39,226,59,59,38,167,46,5211
15000US060372242001,494,45,117,42,37,27,80,34,377,48,94,37,283,57,5212
15000US060372242002,224,46,29,26,29,26,0,12,195,47,39,20,156,48,5213
15000US060372243101,418,55,100,42,19,22,81,36,318,62,51,34,267,60,5214
15000US060372243102,234,54,41,28,31,23,10,17,193,55,34,29,159,53,5215
15000US060372243201,757,79,151,70,24,28,127,65,606,89,108,48,498,93,5216
15000US060372243202,310,64,78,46,28,31,50,34,232,59,72,47,160,65,5217
15000US060372244101,553,69,38,39,7,11,31,38,515,73,46,27,469,79,5218
15000US060372244102,501,82,98,64,13,15,85,61,403,85,103,48,300,84,5219
15000US060372244201,564,45,105,46,38,29,67,36,459,61,114,43,345,60,5220
15000US060372244202,169,37,20,14,0,12,20,14,149,38,38,27,111,38,5221
15000US060372246001,473,55,144,52,23,21,121,53,329,62,116,42,213,59,5222
15000US060372246002,312,55,60,32,13,14,47,33,252,61,57,32,195,56,5223
15000US060372247001,556,53,32,30,15,24,17,19,524,58,13,11,511,59,5224
15000US060372247002,251,44,4,7,0,12,4,7,247,45,5,8,242,44,5225
15000US060372247003,167,38,0,12,0,12,0,12,167,38,0,12,167,38,5226
15000US060372260011,359,53,108,49,29,23,79,44,251,47,74,37,177,54,5227
15000US060372260012,132,43,44,29,7,13,37,27,88,41,23,24,65,40,5228
15000US060372260021,699,73,73,39,26,24,47,33,626,73,85,42,541,74,5229
15000US060372260022,269,57,115,37,46,33,69,27,154,55,87,45,67,37,5230
15000US060372264101,551,50,186,57,59,36,127,51,365,70,71,34,294,65,5231
15000US060372264102,310,51,78,46,9,15,69,46,232,41,41,26,191,42,5232
15000US060372264201,402,78,124,56,21,24,103,49,278,76,49,38,229,74,5233
15000US060372264202,356,81,103,54,24,27,79,53,253,79,40,30,213,75,5234
15000US060372264203,522,87,96,55,25,35,71,47,426,90,135,59,291,84,5235
15000US060372267001,456,99,203,89,52,53,151,77,253,80,46,39,207,82,5236
15000US060372267002,387,90,67,56,8,12,59,54,320,85,23,27,297,83,5237
15000US060372267003,317,93,32,34,1,9,31,35,285,88,106,68,179,90,5238
15000US060372267004,224,63,129,59,45,32,84,51,95,51,52,39,43,34,5239
15000US060372270101,781,99,255,101,84,65,171,97,526,115,100,62,426,119,5240
15000US060372270102,294,89,62,49,55,50,7,12,232,98,41,42,191,89,5241
15000US060372270201,396,51,76,38,28,24,48,32,320,55,74,41,246,62,5242
15000US060372270202,339,51,138,49,44,32,94,40,201,49,92,39,109,47,5243
15000US060372281001,204,93,44,45,8,12,36,43,160,88,16,22,144,91,5244
15000US060372281002,504,104,177,101,18,32,159,99,327,80,96,48,231,85,5245
15000US060372281003,266,84,13,21,0,12,13,21,253,86,47,39,206,89,5246
15000US060372282101,480,49,75,36,31,22,44,30,405,51,181,44,224,52,5247
15000US060372282102,518,54,153,50,24,20,129,46,365,51,84,39,281,55,5248
15000US060372282201,213,46,118,47,23,26,95,41,95,40,23,21,72,36,5249
15000US060372282202,293,52,95,47,18,15,77,43,198,49,66,30,132,45,5250
15000US060372282203,395,52,108,43,45,31,63,34,287,50,31,20,256,51,5251
15000US060372283101,218,36,44,30,0,12,44,30,174,42,48,24,126,43,5252
15000US060372283102,340,62,83,42,17,19,66,35,257,65,60,35,197,58,5253
15000US060372283103,353,44,107,39,35,24,72,36,246,52,69,35,177,56,5254
15000US060372283104,110,34,10,16,0,12,10,16,100,32,12,19,88,32,5255
15000US060372283201,161,39,24,27,0,12,24,27,137,39,25,24,112,36,5256
15000US060372283202,310,52,66,33,6,8,60,31,244,52,73,36,171,52,5257
15000US060372283203,237,52,84,42,20,22,64,36,153,45,56,30,97,36,5258
15000US060372284101,167,38,24,22,8,13,16,18,143,39,14,13,129,41,5259
15000US060372284102,176,48,67,33,42,27,25,22,109,40,30,22,79,36,5260
15000US060372284103,387,48,115,51,0,12,115,51,272,60,95,44,177,62,5261
15000US060372284201,196,54,60,33,14,12,46,33,136,50,24,25,112,48,5262
15000US060372284202,530,52,206,63,43,35,163,61,324,64,56,31,268,62,5263
15000US060372285001,424,88,85,61,23,34,62,49,339,82,106,50,233,78,5264
15000US060372285002,462,102,149,87,29,27,120,81,313,89,95,52,218,82,5265
15000US060372285003,233,68,86,63,23,37,63,51,147,72,37,43,110,58,5266
15000US060372286001,645,80,149,70,0,12,149,70,496,103,94,54,402,103,5267
15000US060372286002,418,71,118,60,23,32,95,60,300,63,121,56,179,63,5268
15000US060372287101,563,73,179,72,70,46,109,60,384,96,96,53,288,80,5269
15000US060372287102,390,74,59,38,31,35,28,25,331,73,82,38,249,77,5270
15000US060372287201,224,56,41,30,8,12,33,27,183,56,44,31,139,54,5271
15000US060372287202,350,53,126,43,32,28,94,41,224,56,69,36,155,51,5272
15000US060372287203,407,63,72,42,18,20,54,37,335,73,26,24,309,67,5273
15000US060372288001,163,69,85,61,8,13,77,67,78,43,29,33,49,37,5274
15000US060372288002,190,69,81,61,17,29,64,50,109,61,31,32,78,53,5275
15000US060372288003,354,91,154,63,15,25,139,58,200,81,11,18,189,77,5276
15000US060372288004,493,95,132,72,8,13,124,72,361,91,120,57,241,93,5277
15000US060372289001,361,74,165,74,28,29,137,69,196,50,84,35,112,44,5278
15000US060372289002,339,71,132,62,26,24,106,55,207,56,87,36,120,50,5279
15000US060372291001,591,55,160,64,39,30,121,56,431,75,104,53,327,69,5280
15000US060372291002,384,58,102,60,10,15,92,56,282,68,64,43,218,61,5281
15000US060372292001,506,82,33,38,33,38,0,12,473,82,134,67,339,91,5282
15000US060372292002,619,88,125,69,29,32,96,63,494,96,42,36,452,100,5283
15000US060372293001,529,97,116,63,18,21,98,59,413,91,88,48,325,88,5284
15000US060372293002,385,69,114,53,34,38,80,49,271,61,22,23,249,60,5285
15000US060372293003,364,81,125,67,6,9,119,67,239,75,46,38,193,69,5286
15000US060372294101,417,68,210,57,68,38,142,48,207,66,50,33,157,63,5287
15000US060372294102,374,62,112,49,21,19,91,46,262,60,19,20,243,59,5288
15000US060372294201,524,66,195,59,65,39,130,53,329,65,37,24,292,64,5289
15000US060372294202,531,61,117,49,23,27,94,41,414,62,54,27,360,67,5290
15000US060372311001,203,52,64,41,18,19,46,35,139,45,25,18,114,42,5291
15000US060372311002,221,67,100,51,28,26,72,44,121,53,25,26,96,49,5292
15000US060372311003,240,67,148,58,39,41,109,58,92,54,48,39,44,40,5293
15000US060372312101,415,75,92,55,9,15,83,57,323,84,73,48,250,85,5294
15000US060372312102,736,80,134,72,35,40,99,67,602,98,150,57,452,105,5295
15000US060372312201,732,100,279,85,94,57,185,74,453,91,159,64,294,81,5296
15000US060372312202,471,90,130,56,26,30,104,50,341,87,30,33,311,88,5297
15000US060372313001,842,110,254,115,37,37,217,110,588,124,161,62,427,117,5298
15000US060372313002,315,83,65,50,19,32,46,36,250,96,106,58,144,81,5299
15000US060372313003,298,80,35,44,0,12,35,44,263,77,72,52,191,72,5300
15000US060372313004,186,72,8,13,0,12,8,13,178,74,33,27,145,77,5301
15000US060372314001,495,103,123,73,32,30,91,65,372,106,128,70,244,95,5302
15000US060372314002,502,96,109,65,52,47,57,48,393,105,88,55,305,115,5303
15000US060372314003,521,91,71,66,54,62,17,20,450,98,158,73,292,98,5304
15000US060372315001,481,85,22,26,11,17,11,18,459,79,117,63,342,82,5305
15000US060372315002,563,92,145,82,8,12,137,81,418,94,148,80,270,81,5306
15000US060372315003,404,76,20,30,0,12,20,30,384,77,121,62,263,82,5307
15000US060372316001,301,79,65,47,0,12,65,47,236,76,110,51,126,67,5308
15000US060372316002,428,90,73,49,20,30,53,38,355,88,78,53,277,87,5309
15000US060372316003,334,90,74,54,0,12,74,54,260,77,67,46,193,80,5310
15000US060372316004,443,93,65,51,16,18,49,47,378,91,64,46,314,82,5311
15000US060372316005,455,99,83,58,25,32,58,54,372,87,91,56,281,88,5312
15000US060372317101,247,63,26,29,0,12,26,29,221,58,52,35,169,64,5313
15000US060372317102,395,81,112,69,21,32,91,58,283,82,74,48,209,74,5314
15000US060372317103,524,90,150,71,24,30,126,67,374,93,108,65,266,88,5315
15000US060372317201,1037,105,167,79,28,23,139,74,870,126,203,71,667,123,5316
15000US060372317202,208,95,42,41,0,12,42,41,166,83,90,58,76,64,5317
15000US060372317203,305,75,44,41,14,21,30,35,261,70,57,43,204,70,5318
15000US060372318001,261,83,77,54,16,19,61,50,184,78,16,22,168,82,5319
15000US060372318002,733,92,276,84,59,57,217,74,457,81,106,37,351,83,5320
15000US060372318003,262,70,78,60,0,12,78,60,184,54,38,27,146,54,5321
15000US060372319001,637,107,145,63,65,47,80,50,492,103,133,66,359,105,5322
15000US060372319002,797,93,384,98,104,57,280,101,413,101,105,63,308,97,5323
15000US060372321101,409,63,91,43,10,16,81,42,318,55,89,40,229,60,5324
15000US060372321102,433,61,92,36,23,18,69,39,341,62,105,44,236,57,5325
15000US060372321201,308,75,120,61,33,38,87,50,188,68,53,46,135,61,5326
15000US060372321202,317,74,127,70,47,53,80,43,190,56,31,27,159,59,5327
15000US060372321203,680,96,179,70,45,42,134,58,501,101,124,59,377,99,5328
15000US060372322001,211,64,49,42,11,11,38,41,162,54,49,27,113,48,5329
15000US060372322002,310,72,58,44,17,23,41,39,252,66,100,45,152,58,5330
15000US060372322003,350,78,92,55,0,12,92,55,258,81,91,39,167,78,5331
15000US060372323001,407,95,70,65,25,42,45,46,337,99,74,48,263,90,5332
15000US060372323002,310,92,46,54,46,54,0,12,264,82,93,58,171,65,5333
15000US060372323003,369,102,67,67,47,60,20,32,302,101,36,31,266,100,5334
15000US060372324001,303,84,49,43,9,14,40,42,254,83,28,23,226,87,5335
15000US060372324002,296,67,39,44,15,25,24,37,257,74,86,47,171,70,5336
15000US060372324003,395,87,107,64,41,43,66,44,288,89,68,54,220,88,5337
15000US060372324004,611,97,82,47,31,32,51,43,529,90,138,61,391,88,5338
15000US060372324005,295,73,62,51,62,51,0,12,233,72,30,24,203,77,5339
15000US060372325001,447,99,134,74,21,26,113,66,313,98,87,52,226,95,5340
15000US060372325002,316,81,61,54,6,10,55,53,255,73,83,57,172,54,5341
15000US060372325003,349,89,49,56,23,38,26,41,300,88,84,45,216,81,5342
15000US060372325004,247,92,86,66,26,39,60,50,161,75,83,52,78,60,5343
15000US060372326001,666,120,91,52,40,34,51,48,575,116,58,40,517,126,5344
15000US060372326002,609,114,175,93,54,53,121,81,434,97,147,71,287,97,5345
15000US060372326003,524,129,147,88,81,68,66,54,377,105,129,69,248,99,5346
15000US060372327001,797,84,226,80,44,39,182,74,571,99,142,66,429,92,5347
15000US060372327002,514,83,174,79,66,47,108,65,340,84,93,50,247,84,5348
15000US060372327003,246,76,107,53,17,19,90,55,139,62,16,19,123,59,5349
15000US060372328001,356,62,80,44,16,18,64,39,276,65,85,46,191,60,5350
15000US060372328002,580,62,201,57,40,27,161,55,379,61,117,44,262,63,5351
15000US060372340001,682,125,125,69,53,38,72,56,557,117,140,79,417,102,5352
15000US060372340002,289,71,0,12,0,12,0,12,289,71,40,31,249,77,5353
15000US060372340003,217,62,0,12,0,12,0,12,217,62,51,36,166,60,5354
15000US060372340004,519,103,52,48,0,12,52,48,467,103,94,62,373,100,5355
15000US060372340005,285,95,45,50,15,23,30,45,240,85,123,62,117,65,5356
15000US060372342001,384,80,0,12,0,12,0,12,384,80,120,70,264,76,5357
15000US060372342002,245,71,60,53,40,49,20,23,185,63,86,49,99,43,5358
15000US060372342003,485,85,17,21,7,13,10,15,468,92,81,44,387,94,5359
15000US060372343001,706,173,125,76,45,37,80,72,581,181,146,89,435,170,5360
15000US060372343002,543,169,66,55,31,36,35,41,477,181,174,126,303,132,5361
15000US060372343003,569,131,32,49,0,12,32,49,537,126,85,72,452,137,5362
15000US060372343004,590,142,110,102,110,102,0,12,480,142,87,69,393,144,5363
15000US060372345011,481,62,59,37,24,21,35,28,422,63,160,60,262,69,5364
15000US060372345012,432,65,16,15,10,12,6,9,416,64,137,56,279,65,5365
15000US060372345021,337,97,81,58,75,62,6,10,256,97,99,73,157,64,5366
15000US060372345022,256,73,19,23,0,12,19,23,237,72,71,47,166,67,5367
15000US060372345023,569,113,80,82,0,12,80,82,489,104,180,72,309,106,5368
15000US060372346001,499,101,182,87,99,75,83,69,317,101,94,69,223,96,5369
15000US060372346002,291,92,50,41,7,12,43,40,241,85,80,49,161,77,5370
15000US060372346003,365,99,28,26,28,26,0,12,337,101,90,56,247,106,5371
15000US060372346004,562,92,11,17,0,12,11,17,551,93,129,57,422,100,5372
15000US060372347001,405,104,11,16,11,16,0,12,394,106,131,72,263,108,5373
15000US060372347002,235,65,0,12,0,12,0,12,235,65,106,58,129,64,5374
15000US060372347003,520,117,103,60,68,50,35,40,417,118,131,82,286,102,5375
15000US060372347004,302,91,24,29,15,24,9,14,278,88,134,67,144,91,5376
15000US060372348001,296,71,33,36,6,10,27,35,263,72,76,52,187,77,5377
15000US060372348002,298,77,38,39,9,15,29,41,260,77,90,57,170,75,5378
15000US060372348003,235,71,15,23,0,12,15,23,220,70,80,58,140,65,5379
15000US060372348004,312,97,44,46,44,46,0,12,268,95,147,87,121,55,5380
15000US060372349011,351,100,67,46,13,23,54,40,284,103,133,86,151,79,5381
15000US060372349012,698,121,154,104,44,57,110,91,544,138,214,78,330,116,5382
15000US060372349021,384,107,77,56,25,25,52,50,307,109,92,71,215,91,5383
15000US060372349022,500,115,103,68,47,41,56,48,397,115,83,56,314,109,5384
15000US060372349023,562,128,253,115,23,26,230,110,309,123,113,82,196,96,5385
15000US060372351001,412,79,15,18,15,18,0,12,397,80,46,32,351,83,5386
15000US060372351002,469,91,33,37,0,12,33,37,436,85,104,45,332,90,5387
15000US060372351003,462,82,9,15,0,12,9,15,453,83,59,37,394,84,5388
15000US060372351004,396,87,8,12,8,12,0,12,388,88,67,44,321,83,5389
15000US060372352011,319,62,59,40,23,22,36,32,260,63,57,29,203,58,5390
15000US060372352012,266,60,39,23,11,12,28,22,227,57,43,29,184,56,5391
15000US060372352013,352,57,53,38,21,27,32,29,299,60,52,23,247,62,5392
15000US060372352021,920,111,312,110,94,55,218,97,608,111,181,75,427,106,5393
15000US060372352022,602,94,10,16,10,16,0,12,592,94,183,68,409,96,5394
15000US060372352023,355,81,18,19,18,19,0,12,337,83,89,52,248,83,5395
15000US060372360001,966,134,0,12,0,12,0,12,966,134,194,113,772,133,5396
15000US060372360002,478,103,18,26,18,26,0,12,460,107,169,91,291,99,5397
15000US060372360003,250,76,52,57,34,50,18,28,198,71,36,39,162,68,5398
15000US060372360004,469,114,42,66,0,12,42,66,427,113,55,51,372,116,5399
15000US060372361001,324,109,49,79,49,79,0,12,275,104,101,66,174,103,5400
15000US060372361002,548,144,55,64,0,12,55,64,493,140,63,41,430,145,5401
15000US060372361003,1090,159,314,129,70,69,244,108,776,179,252,98,524,167,5402
15000US060372361004,709,145,245,120,124,78,121,88,464,129,224,107,240,97,5403
15000US060372361005,248,84,11,17,11,17,0,12,237,87,55,47,182,87,5404
15000US060372362021,860,185,215,121,102,84,113,88,645,189,165,109,480,178,5405
15000US060372362022,888,197,227,116,104,85,123,102,661,183,320,135,341,148,5406
15000US060372362023,770,182,123,106,26,41,97,96,647,205,205,116,442,183,5407
15000US060372362031,1008,97,219,80,75,55,144,62,789,103,220,81,569,112,5408
15000US060372362032,475,95,69,55,36,39,33,38,406,89,138,61,268,88,5409
15000US060372362041,826,102,243,83,70,52,173,72,583,114,186,66,397,115,5410
15000US060372362042,430,95,140,64,74,43,66,50,290,93,112,63,178,70,5411
15000US060372364001,494,98,35,37,0,12,35,37,459,99,71,39,388,87,5412
15000US060372364002,745,103,53,45,46,44,7,11,692,113,305,95,387,105,5413
15000US060372364003,750,111,24,37,0,12,24,37,726,119,176,94,550,106,5414
15000US060372371011,173,42,51,30,6,8,45,28,122,36,40,23,82,34,5415
15000US060372371012,230,54,58,32,18,16,40,27,172,53,21,19,151,54,5416
15000US060372371013,124,36,12,15,6,10,6,10,112,40,51,31,61,29,5417
15000US060372371014,207,66,49,35,0,12,49,35,158,56,46,27,112,50,5418
15000US060372371015,323,55,100,47,0,12,100,47,223,60,75,39,148,57,5419
15000US060372371021,363,62,125,48,40,30,85,37,238,66,114,43,124,51,5420
15000US060372371022,529,74,123,56,23,28,100,51,406,63,104,36,302,64,5421
15000US060372372011,293,59,46,27,8,12,38,25,247,62,64,29,183,64,5422
15000US060372372012,443,66,95,38,20,16,75,35,348,67,127,53,221,64,5423
15000US060372372013,269,52,0,12,0,12,0,12,269,52,137,48,132,51,5424
15000US060372372021,322,92,41,39,0,12,41,39,281,93,127,70,154,77,5425
15000US060372372022,238,79,33,36,21,31,12,19,205,75,46,50,159,67,5426
15000US060372372023,418,106,67,65,31,37,36,55,351,94,128,65,223,79,5427
15000US060372372024,371,95,65,56,27,31,38,47,306,93,133,63,173,82,5428
15000US060372373001,329,107,89,66,75,64,14,15,240,104,73,58,167,95,5429
15000US060372373002,350,88,83,74,47,55,36,53,267,82,40,27,227,84,5430
15000US060372373003,534,103,75,67,75,67,0,12,459,94,164,75,295,92,5431
15000US060372373004,309,84,27,31,0,12,27,31,282,77,91,59,191,74,5432
15000US060372373005,308,100,24,36,24,36,0,12,284,96,111,63,173,89,5433
15000US060372374011,231,59,48,45,23,32,25,37,183,45,53,29,130,45,5434
15000US060372374012,425,68,99,53,84,50,15,20,326,69,91,42,235,68,5435
15000US060372374013,366,74,111,55,36,28,75,47,255,66,60,26,195,66,5436
15000US060372374021,395,65,40,31,21,24,19,22,355,61,138,45,217,53,5437
15000US060372374022,270,55,8,12,0,12,8,12,262,57,76,34,186,65,5438
15000US060372374023,307,57,55,37,25,28,30,27,252,51,84,37,168,58,5439
15000US060372375001,529,56,129,48,33,24,96,44,400,63,84,38,316,68,5440
15000US060372375002,291,55,94,38,24,23,70,40,197,57,71,38,126,53,5441
15000US060372376001,309,78,25,29,9,15,16,26,284,74,45,34,239,70,5442
15000US060372376002,374,79,58,44,13,14,45,43,316,86,78,53,238,82,5443
15000US060372376003,193,64,72,40,42,41,30,30,121,62,58,43,63,50,5444
15000US060372376004,301,73,45,37,15,24,30,29,256,76,79,43,177,78,5445
15000US060372377101,430,90,137,65,67,53,70,44,293,81,40,39,253,82,5446
15000US060372377102,577,100,157,72,45,40,112,64,420,105,63,44,357,105,5447
15000US060372377201,258,57,51,42,15,22,36,37,207,56,96,46,111,47,5448
15000US060372377202,568,73,160,54,21,17,139,55,408,85,103,46,305,81,5449
15000US060372378001,266,93,42,41,0,12,42,41,224,88,52,48,172,88,5450
15000US060372378002,289,64,81,61,30,42,51,46,208,80,39,28,169,84,5451
15000US060372378003,210,74,52,49,0,12,52,49,158,66,107,59,51,29,5452
15000US060372378004,447,99,39,42,17,26,22,34,408,98,134,76,274,87,5453
15000US060372379001,226,77,66,63,24,33,42,55,160,64,64,42,96,51,5454
15000US060372379002,413,88,42,39,0,12,42,39,371,88,170,76,201,76,5455
15000US060372379003,334,76,71,49,58,48,13,15,263,71,135,70,128,59,5456
15000US060372379004,352,87,23,37,0,12,23,37,329,90,85,47,244,93,5457
15000US060372380001,208,81,69,71,20,33,49,63,139,71,71,53,68,51,5458
15000US060372380002,218,115,0,12,0,12,0,12,218,115,40,48,178,106,5459
15000US060372380003,289,133,82,107,68,105,14,23,207,89,61,50,146,85,5460
15000US060372380004,425,138,74,90,0,12,74,90,351,124,179,107,172,95,5461
15000US060372380005,393,121,0,12,0,12,0,12,393,121,81,57,312,130,5462
15000US060372380006,459,143,17,26,17,26,0,12,442,141,68,52,374,148,5463
15000US060372381001,538,107,117,80,24,25,93,76,421,96,185,73,236,69,5464
15000US060372381002,541,124,98,57,26,28,72,54,443,109,129,77,314,110,5465
15000US060372381003,273,78,0,12,0,12,0,12,273,78,41,26,232,78,5466
15000US060372381004,402,81,9,15,9,15,0,12,393,85,166,82,227,76,5467
15000US060372382001,622,221,75,113,0,12,75,113,547,192,127,80,420,178,5468
15000US060372382002,676,189,167,120,75,73,92,100,509,172,220,139,289,146,5469
15000US060372382003,377,167,74,96,54,72,20,46,303,150,151,92,152,129,5470
15000US060372382004,547,185,145,106,0,12,145,106,402,168,81,83,321,161,5471
15000US060372383101,691,101,183,67,8,16,175,69,508,110,145,70,363,104,5472
15000US060372383102,680,92,234,83,70,50,164,75,446,99,111,68,335,89,5473
15000US060372383201,613,79,336,84,97,62,239,88,277,94,25,29,252,92,5474
15000US060372383202,257,80,93,60,11,20,82,56,164,66,64,39,100,62,5475
15000US060372383203,239,58,44,44,17,28,27,32,195,64,85,41,110,60,5476
15000US060372384001,352,98,6,9,6,9,0,12,346,99,134,80,212,82,5477
15000US060372384002,548,106,18,27,0,12,18,27,530,108,288,86,242,86,5478
15000US060372384003,416,98,41,54,0,12,41,54,375,88,102,59,273,86,5479
15000US060372384004,449,107,0,12,0,12,0,12,449,107,142,81,307,109,5480
15000US060372392011,348,69,113,50,23,22,90,46,235,65,45,28,190,63,5481
15000US060372392012,317,80,59,42,39,33,20,24,258,73,35,30,223,68,5482
15000US060372392013,218,56,62,38,30,30,32,23,156,53,56,32,100,46,5483
15000US060372392021,491,96,216,87,79,50,137,76,275,88,56,38,219,84,5484
15000US060372392022,242,71,68,34,29,32,39,27,174,66,43,31,131,62,5485
15000US060372392023,293,77,72,47,21,27,51,38,221,73,72,47,149,66,5486
15000US060372393101,275,59,12,12,6,9,6,7,263,59,84,48,179,64,5487
15000US060372393102,464,68,107,50,13,15,94,48,357,80,93,57,264,71,5488
15000US060372393103,268,61,102,43,20,23,82,39,166,52,23,18,143,50,5489
15000US060372393201,480,60,111,52,26,28,85,47,369,59,115,46,254,55,5490
15000US060372393202,370,60,121,53,30,27,91,45,249,58,83,37,166,56,5491
15000US060372393301,388,47,108,51,36,28,72,40,280,57,51,32,229,52,5492
15000US060372393302,308,44,90,39,14,17,76,40,218,49,59,30,159,48,5493
15000US060372395011,335,52,89,37,14,13,75,38,246,52,96,34,150,49,5494
15000US060372395012,235,46,32,28,7,11,25,26,203,48,55,31,148,46,5495
15000US060372395013,328,49,78,42,43,33,35,26,250,57,45,21,205,56,5496
15000US060372395021,274,55,65,39,15,18,50,36,209,53,69,35,140,47,5497
15000US060372395022,257,51,58,36,0,12,58,36,199,49,16,14,183,47,5498
15000US060372395023,321,64,67,37,21,21,46,30,254,65,76,42,178,62,5499
15000US060372396011,332,64,94,49,3,6,91,49,238,62,65,41,173,57,5500
15000US060372396012,516,72,135,56,38,31,97,48,381,71,90,46,291,71,5501
15000US060372396021,396,58,95,37,38,26,57,32,301,63,77,33,224,58,5502
15000US060372396022,453,58,196,63,33,25,163,55,257,68,49,32,208,65,5503
15000US060372397011,585,70,172,64,30,26,142,60,413,81,93,38,320,79,5504
15000US060372397012,458,78,187,71,56,42,131,64,271,69,47,30,224,72,5505
15000US060372397021,344,72,85,48,8,14,77,48,259,66,103,52,156,55,5506
15000US060372397022,188,62,35,29,16,16,19,23,153,65,50,32,103,63,5507
15000US060372397023,255,51,55,40,35,35,20,22,200,52,52,38,148,56,5508
15000US060372397024,265,72,38,34,0,12,38,34,227,71,67,42,160,66,5509
15000US060372398011,181,47,53,34,12,14,41,29,128,39,18,15,110,38,5510
15000US060372398012,388,62,155,58,59,38,96,47,233,64,59,34,174,61,5511
15000US060372398013,265,54,98,40,0,12,98,40,167,43,59,37,108,45,5512
15000US060372398021,251,66,122,63,51,44,71,55,129,58,28,30,101,59,5513
15000US060372398022,388,85,172,77,14,23,158,79,216,78,37,31,179,76,5514
15000US060372398023,340,85,108,54,0,12,108,54,232,67,39,28,193,67,5515
15000US060372398024,322,61,124,56,33,31,91,51,198,67,62,42,136,59,5516
15000US060372400101,219,57,69,39,20,24,49,37,150,52,21,23,129,53,5517
15000US060372400102,346,63,78,48,38,35,40,31,268,60,114,44,154,51,5518
15000US060372400103,412,65,50,31,7,11,43,29,362,72,68,37,294,71,5519
15000US060372400201,424,82,114,66,22,35,92,56,310,77,81,55,229,70,5520
15000US060372400202,427,73,100,66,46,41,54,51,327,72,82,41,245,68,5521
15000US060372400203,419,78,69,44,9,14,60,45,350,73,120,48,230,74,5522
15000US060372402001,235,59,53,40,10,16,43,35,182,58,86,45,96,42,5523
15000US060372402002,575,104,118,58,32,32,86,53,457,108,90,51,367,101,5524
15000US060372402003,588,97,204,85,78,51,126,64,384,93,170,65,214,78,5525
15000US060372403001,424,115,130,61,40,40,90,44,294,104,64,47,230,95,5526
15000US060372403002,436,113,118,67,0,12,118,67,318,117,57,54,261,114,5527
15000US060372403003,479,103,107,65,14,22,93,63,372,107,189,91,183,80,5528
15000US060372403004,173,88,10,15,0,12,10,15,163,87,6,10,157,89,5529
15000US060372404011,452,103,144,78,54,59,90,52,308,106,53,37,255,101,5530
15000US060372404012,488,106,181,78,56,49,125,67,307,105,42,33,265,100,5531
15000US060372404013,418,93,198,79,5,10,193,80,220,79,55,54,165,65,5532
15000US060372404021,308,75,29,28,16,22,13,20,279,83,128,70,151,61,5533
15000US060372404022,446,87,79,52,42,39,37,39,367,86,81,56,286,93,5534
15000US060372404023,361,92,47,43,0,12,47,43,314,86,154,69,160,70,5535
15000US060372405001,363,89,111,61,0,12,111,61,252,79,39,30,213,79,5536
15000US060372405002,425,91,192,82,59,45,133,71,233,85,94,61,139,73,5537
15000US060372405003,377,90,105,66,17,29,88,60,272,82,73,46,199,75,5538
15000US060372405004,389,88,138,73,112,66,26,32,251,74,56,44,195,71,5539
15000US060372406001,298,83,90,51,13,20,77,48,208,79,28,27,180,78,5540
15000US060372406002,313,70,90,58,20,26,70,56,223,64,80,56,143,65,5541
15000US060372406003,336,92,102,65,50,50,52,43,234,72,44,31,190,73,5542
15000US060372406004,316,74,76,57,21,19,55,53,240,70,80,45,160,62,5543
15000US060372407001,359,76,126,55,16,25,110,54,233,70,52,35,181,66,5544
15000US060372407002,238,73,35,40,0,12,35,40,203,66,56,41,147,64,5545
15000US060372407003,474,80,109,57,63,46,46,43,365,91,56,38,309,91,5546
15000US060372407004,306,77,38,41,7,13,31,38,268,86,73,43,195,77,5547
15000US060372407005,297,66,67,37,24,29,43,30,230,71,117,61,113,50,5548
15000US060372408001,304,50,68,34,29,25,39,24,236,48,57,37,179,53,5549
15000US060372408002,395,58,118,44,18,19,100,44,277,54,72,36,205,52,5550
15000US060372408003,364,55,91,39,36,26,55,33,273,61,59,33,214,58,5551
15000US060372409001,185,63,54,42,17,18,37,40,131,62,50,39,81,51,5552
15000US060372409002,337,98,26,31,0,12,26,31,311,103,52,42,259,100,5553
15000US060372409003,244,95,95,76,14,23,81,72,149,76,40,32,109,68,5554
15000US060372409004,293,83,139,81,54,45,85,72,154,67,28,31,126,65,5555
15000US060372409005,300,103,71,67,17,26,54,61,229,94,41,42,188,86,5556
15000US060372410011,446,83,109,60,10,15,99,66,337,87,144,64,193,71,5557
15000US060372410012,285,86,71,57,37,48,34,35,214,77,65,44,149,75,5558
15000US060372410013,404,92,103,58,37,33,66,51,301,86,114,58,187,81,5559
15000US060372410021,340,69,77,58,31,34,46,45,263,63,55,28,208,62,5560
15000US060372410022,321,67,18,17,5,9,13,14,303,68,101,55,202,63,5561
15000US060372410023,307,64,89,39,22,20,67,41,218,63,30,23,188,65,5562
15000US060372411101,505,56,98,43,18,21,80,41,407,66,105,46,302,71,5563
15000US060372411102,268,57,84,41,38,27,46,32,184,56,40,30,144,53,5564
15000US060372411201,369,71,50,35,0,12,50,35,319,75,109,59,210,70,5565
15000US060372411202,354,78,172,75,53,42,119,65,182,67,95,55,87,51,5566
15000US060372411203,287,75,74,51,20,33,54,41,213,64,31,30,182,67,5567
15000US060372411204,242,72,50,40,0,12,50,40,192,77,50,34,142,72,5568
15000US060372412011,314,57,37,24,25,17,12,19,277,59,110,46,167,50,5569
15000US060372412012,285,61,73,33,40,23,33,24,212,55,52,25,160,53,5570
15000US060372412013,242,60,90,48,17,25,73,41,152,53,52,34,100,47,5571
15000US060372412021,371,101,47,36,15,18,32,30,324,98,145,80,179,72,5572
15000US060372412022,254,66,58,39,12,14,46,38,196,65,55,41,141,57,5573
15000US060372412023,202,71,79,61,29,42,50,50,123,56,19,29,104,49,5574
15000US060372412024,269,88,65,54,40,42,25,32,204,80,74,54,130,68,5575
15000US060372412025,267,77,124,69,0,12,124,69,143,60,48,31,95,63,5576
15000US060372413001,301,45,43,30,27,23,16,19,258,53,63,37,195,47,5577
15000US060372413002,391,42,60,29,39,29,21,19,331,47,66,33,265,51,5578
15000US060372414001,449,53,117,50,14,21,103,48,332,63,36,24,296,61,5579
15000US060372414002,431,51,47,28,12,12,35,25,384,53,144,48,240,56,5580
15000US060372420001,441,68,126,54,12,15,114,55,315,61,135,47,180,55,5581
15000US060372420002,439,65,122,49,19,19,103,48,317,73,135,54,182,56,5582
15000US060372420003,186,46,73,40,31,27,42,31,113,41,60,33,53,32,5583
15000US060372421001,735,30,431,63,120,51,311,59,304,67,142,54,162,58,5584
15000US060372422001,320,84,43,39,7,11,36,38,277,76,62,42,215,80,5585
15000US060372422002,177,55,41,36,29,33,12,19,136,51,54,38,82,47,5586
15000US060372422003,657,92,103,65,5,10,98,63,554,95,196,69,358,99,5587
15000US060372422004,450,89,98,48,0,12,98,48,352,86,104,64,248,88,5588
15000US060372423001,591,120,208,85,47,41,161,84,383,121,75,56,308,113,5589
15000US060372423002,194,95,92,64,62,59,30,45,102,83,20,22,82,86,5590
15000US060372423003,410,110,36,40,17,24,19,29,374,111,110,73,264,106,5591
15000US060372426001,324,75,123,63,76,49,47,43,201,74,68,40,133,66,5592
15000US060372426002,579,99,375,97,96,53,279,93,204,77,127,63,77,48,5593
15000US060372426003,381,86,206,64,58,43,148,67,175,70,69,50,106,50,5594
15000US060372427001,260,77,123,69,76,57,47,42,137,70,19,29,118,66,5595
15000US060372427002,192,75,15,24,11,18,4,12,177,79,25,26,152,77,5596
15000US060372427003,256,85,102,72,32,41,70,59,154,53,55,44,99,45,5597
15000US060372427004,357,84,187,70,104,54,83,51,170,69,48,45,122,63,5598
15000US060372427005,151,68,73,56,8,19,65,56,78,54,47,41,31,37,5599
15000US060372430001,311,77,54,38,8,15,46,36,257,77,119,62,138,61,5600
15000US060372430002,372,82,143,78,107,67,36,43,229,75,110,54,119,65,5601
15000US060372430003,351,79,69,58,6,10,63,57,282,76,95,50,187,73,5602
15000US060372430004,307,80,114,66,22,28,92,61,193,66,30,24,163,67,5603
15000US060372431001,655,101,227,72,151,74,76,48,428,104,92,51,336,100,5604
15000US060372431002,489,100,202,75,71,49,131,65,287,83,104,51,183,82,5605
15000US060372431003,294,77,89,47,31,31,58,35,205,73,73,43,132,65,5606
15000US060372611011,725,95,0,12,0,12,0,12,725,95,109,54,616,103,5607
15000US060372611012,754,100,0,12,0,12,0,12,754,100,182,93,572,96,5608
15000US060372611021,235,67,0,12,0,12,0,12,235,67,66,37,169,64,5609
15000US060372611022,1382,106,0,12,0,12,0,12,1382,106,307,106,1075,107,5610
15000US060372612001,1113,104,7,12,0,12,7,12,1106,106,196,70,910,102,5611
15000US060372612002,599,96,0,12,0,12,0,12,599,96,59,34,540,101,5612
15000US060372621001,203,68,0,12,0,12,0,12,203,68,37,27,166,64,5613
15000US060372621002,203,77,0,12,0,12,0,12,203,77,28,25,175,82,5614
15000US060372621003,742,101,0,12,0,12,0,12,742,101,101,45,641,106,5615
15000US060372622001,1316,94,0,12,0,12,0,12,1316,94,228,78,1088,110,5616
15000US060372622002,503,96,0,12,0,12,0,12,503,96,57,45,446,100,5617
15000US060372623011,923,48,0,12,0,12,0,12,923,48,164,55,759,75,5618
15000US060372623021,655,87,0,12,0,12,0,12,655,87,22,19,633,88,5619
15000US060372623022,536,75,0,12,0,12,0,12,536,75,109,54,427,81,5620
15000US060372623031,486,72,0,12,0,12,0,12,486,72,88,32,398,72,5621
15000US060372623032,288,60,7,12,0,12,7,12,281,64,79,46,202,59,5622
15000US060372623033,308,66,0,12,0,12,0,12,308,66,97,47,211,59,5623
15000US060372624001,366,75,0,12,0,12,0,12,366,75,91,47,275,73,5624
15000US060372624002,755,80,0,12,0,12,0,12,755,80,139,55,616,93,5625
15000US060372625011,424,58,0,12,0,12,0,12,424,58,54,34,370,62,5626
15000US060372625012,302,53,0,12,0,12,0,12,302,53,82,38,220,63,5627
15000US060372625013,741,73,0,12,0,12,0,12,741,73,188,73,553,83,5628
15000US060372626011,1362,89,8,12,8,12,0,12,1354,90,172,57,1182,96,5629
15000US060372626041,201,52,19,30,19,30,0,12,182,54,19,30,163,53,5630
15000US060372626042,538,123,0,12,0,12,0,12,538,123,106,54,432,127,5631
15000US060372626043,555,83,0,12,0,12,0,12,555,83,123,58,432,92,5632
15000US060372626044,1333,160,12,19,12,19,0,12,1321,158,223,95,1098,180,5633
15000US060372627041,1487,117,11,17,11,17,0,12,1476,112,230,74,1246,127,5634
15000US060372627061,748,82,0,12,0,12,0,12,748,82,93,62,655,88,5635
15000US060372627062,386,65,0,12,0,12,0,12,386,65,63,42,323,61,5636
15000US060372627063,265,53,0,12,0,12,0,12,265,53,36,26,229,50,5637
15000US060372628021,596,82,0,12,0,12,0,12,596,82,55,41,541,92,5638
15000US060372628022,265,66,0,12,0,12,0,12,265,66,16,18,249,69,5639
15000US060372628023,526,88,0,12,0,12,0,12,526,88,144,71,382,82,5640
15000US060372640001,201,58,0,12,0,12,0,12,201,58,69,42,132,61,5641
15000US060372640002,463,94,0,12,0,12,0,12,463,94,23,22,440,96,5642
15000US060372640003,524,79,0,12,0,12,0,12,524,79,65,39,459,83,5643
15000US060372641021,1550,118,10,14,10,14,0,12,1540,117,121,61,1419,128,5644
15000US060372641031,1494,91,0,12,0,12,0,12,1494,91,140,73,1354,110,5645
15000US060372643011,753,133,22,34,0,12,22,34,731,137,48,51,683,146,5646
15000US060372643012,1141,159,24,29,0,12,24,29,1117,161,121,75,996,162,5647
15000US060372643013,1120,178,0,12,0,12,0,12,1120,178,131,94,989,192,5648
15000US060372643021,1063,181,0,12,0,12,0,12,1063,181,188,92,875,179,5649
15000US060372643022,1138,145,15,26,0,12,15,26,1123,141,132,69,991,150,5650
15000US060372643023,670,137,0,12,0,12,0,12,670,137,71,51,599,141,5651
15000US060372651001,882,92,0,12,0,12,0,12,882,92,426,105,456,93,5652
15000US060372651002,560,84,0,12,0,12,0,12,560,84,132,56,428,82,5653
15000US060372652011,722,89,0,12,0,12,0,12,722,89,158,85,564,98,5654
15000US060372652012,192,61,0,12,0,12,0,12,192,61,30,21,162,66,5655
15000US060372652021,391,122,0,12,0,12,0,12,391,122,199,100,192,77,5656
15000US060372652022,160,79,0,12,0,12,0,12,160,79,52,47,108,63,5657
15000US060372652023,357,125,0,12,0,12,0,12,357,125,0,12,357,125,5658
15000US060372652024,962,197,17,27,0,12,17,27,945,200,102,63,843,203,5659
15000US060372653011,0,19,0,19,0,19,0,19,0,19,0,19,0,19,5660
15000US060372653031,468,85,0,12,0,12,0,12,468,85,46,35,422,85,5661
15000US060372653032,981,103,21,24,8,13,13,21,960,100,119,65,841,101,5662
15000US060372653041,539,76,28,34,0,12,28,34,511,76,30,35,481,69,5663
15000US060372653042,404,72,0,12,0,12,0,12,404,72,19,23,385,73,5664
15000US060372653051,1742,119,0,12,0,12,0,12,1742,119,130,93,1612,127,5665
15000US060372654101,233,41,0,12,0,12,0,12,233,41,52,31,181,39,5666
15000US060372654102,380,43,0,12,0,12,0,12,380,43,64,23,316,46,5667
15000US060372654201,301,37,0,12,0,12,0,12,301,37,61,32,240,46,5668
15000US060372654202,443,42,5,8,0,12,5,8,438,43,53,31,385,49,5669
15000US060372655101,1714,136,0,12,0,12,0,12,1714,136,146,97,1568,152,5670
15000US060372655102,600,120,12,19,0,12,12,19,588,121,31,30,557,119,5671
15000US060372655201,481,117,0,12,0,12,0,12,481,117,70,48,411,116,5672
15000US060372655202,329,80,16,24,0,12,16,24,313,75,10,16,303,74,5673
15000US060372655203,1393,168,27,38,27,38,0,12,1366,172,257,85,1109,170,5674
15000US060372656011,497,76,7,12,0,12,7,12,490,76,102,54,388,89,5675
15000US060372656012,926,73,11,18,0,12,11,18,915,75,109,60,806,86,5676
15000US060372656021,513,111,0,12,0,12,0,12,513,111,99,49,414,111,5677
15000US060372656022,998,145,0,12,0,12,0,12,998,145,197,86,801,154,5678
15000US060372657001,1079,168,0,12,0,12,0,12,1079,168,255,99,824,183,5679
15000US060372657002,744,153,0,12,0,12,0,12,744,153,38,36,706,154,5680
15000US060372657003,703,131,21,31,21,31,0,12,682,129,123,79,559,142,5681
15000US060372671001,1338,146,37,41,16,25,21,33,1301,148,178,72,1123,156,5682
15000US060372671002,357,86,0,12,0,12,0,12,357,86,116,81,241,76,5683
15000US060372671003,1078,145,61,63,61,63,0,12,1017,145,30,34,987,148,5684
15000US060372671004,255,76,0,12,0,12,0,12,255,76,83,65,172,66,5685
15000US060372672001,1516,146,44,69,0,12,44,69,1472,153,198,128,1274,164,5686
15000US060372672002,849,144,0,12,0,12,0,12,849,144,167,102,682,124,5687
15000US060372672003,392,114,0,12,0,12,0,12,392,114,40,38,352,126,5688
15000US060372673001,603,150,64,71,26,38,38,58,539,140,98,84,441,138,5689
15000US060372673002,1544,143,19,33,5,23,14,23,1525,154,254,129,1271,180,5690
15000US060372674021,916,163,14,22,14,22,0,12,902,163,47,60,855,158,5691
15000US060372674022,1762,157,11,19,11,19,0,12,1751,159,186,125,1565,199,5692
15000US060372674031,1193,100,0,12,0,12,0,12,1193,100,185,72,1008,107,5693
15000US060372674032,578,101,21,24,9,15,12,19,557,105,46,36,511,108,5694
15000US060372674041,1544,84,10,15,0,12,10,15,1534,85,183,90,1351,123,5695
15000US060372675011,942,161,0,12,0,12,0,12,942,161,33,53,909,168,5696
15000US060372675012,803,155,62,75,16,24,46,73,741,138,138,86,603,152,5697
15000US060372675013,900,157,13,20,0,12,13,20,887,159,91,54,796,156,5698
15000US060372675021,760,105,30,37,0,12,30,37,730,104,48,27,682,109,5699
15000US060372675022,852,106,101,75,64,68,37,31,751,121,94,83,657,103,5700
15000US060372676001,515,95,0,12,0,12,0,12,515,95,71,52,444,94,5701
15000US060372676002,293,84,0,12,0,12,0,12,293,84,46,30,247,90,5702
15000US060372676003,429,76,14,24,0,12,14,24,415,77,41,32,374,81,5703
15000US060372677001,928,124,6,9,0,12,6,9,922,123,161,61,761,125,5704
15000US060372677002,777,124,27,44,0,12,27,44,750,129,144,59,606,108,5705
15000US060372678001,277,75,6,13,6,13,0,12,271,76,89,61,182,68,5706
15000US060372678002,375,86,0,12,0,12,0,12,375,86,161,72,214,60,5707
15000US060372678003,546,88,0,12,0,12,0,12,546,88,119,60,427,90,5708
15000US060372679011,786,121,0,12,0,12,0,12,786,121,129,56,657,137,5709
15000US060372679012,671,110,0,12,0,12,0,12,671,110,204,85,467,107,5710
15000US060372679021,347,69,0,12,0,12,0,12,347,69,31,23,316,70,5711
15000US060372679022,698,94,0,12,0,12,0,12,698,94,76,55,622,99,5712
15000US060372679023,521,97,0,12,0,12,0,12,521,97,24,22,497,98,5713
15000US060372690001,213,67,0,12,0,12,0,12,213,67,38,36,175,61,5714
15000US060372690002,320,79,0,12,0,12,0,12,320,79,133,70,187,77,5715
15000US060372690003,347,87,0,12,0,12,0,12,347,87,56,61,291,86,5716
15000US060372690004,1029,131,13,20,0,12,13,20,1016,133,137,87,879,142,5717
15000US060372690005,407,108,13,20,0,12,13,20,394,107,128,84,266,90,5718
15000US060372691001,488,80,0,12,0,12,0,12,488,80,94,39,394,84,5719
15000US060372691002,220,62,26,41,0,12,26,41,194,59,48,34,146,54,5720
15000US060372691003,368,57,0,12,0,12,0,12,368,57,65,37,303,54,5721
15000US060372691004,823,123,27,43,27,43,0,12,796,119,144,82,652,110,5722
15000US060372693001,281,60,0,12,0,12,0,12,281,60,49,46,232,48,5723
15000US060372693002,267,59,22,34,22,34,0,12,245,59,22,20,223,66,5724
15000US060372693003,330,66,0,12,0,12,0,12,330,66,88,36,242,76,5725
15000US060372693004,346,77,0,12,0,12,0,12,346,77,56,35,290,89,5726
15000US060372693005,303,49,0,12,0,12,0,12,303,49,54,36,249,48,5727
15000US060372695001,257,52,0,12,0,12,0,12,257,52,63,27,194,58,5728
15000US060372695002,320,65,6,10,0,12,6,10,314,65,78,60,236,57,5729
15000US060372695003,460,66,0,12,0,12,0,12,460,66,89,43,371,68,5730
15000US060372695004,374,63,6,9,0,12,6,9,368,61,91,37,277,65,5731
15000US060372696011,263,86,56,51,27,31,29,34,207,81,40,36,167,75,5732
15000US060372696012,233,73,42,42,0,12,42,42,191,69,40,44,151,55,5733
15000US060372696013,562,99,64,67,0,12,64,67,498,92,86,55,412,100,5734
15000US060372696021,736,83,34,35,0,12,34,35,702,83,91,59,611,89,5735
15000US060372696022,373,72,33,35,15,24,18,25,340,69,43,40,297,66,5736
15000US060372697001,561,107,14,21,14,21,0,12,547,108,48,38,499,107,5737
15000US060372697002,541,102,6,10,0,12,6,10,535,102,7,12,528,101,5738
15000US060372697003,279,68,12,17,12,17,0,12,267,68,8,13,259,67,5739
15000US060372697004,300,65,0,12,0,12,0,12,300,65,31,30,269,72,5740
15000US060372698001,538,92,0,12,0,12,0,12,538,92,80,45,458,89,5741
15000US060372698002,1081,90,19,20,9,13,10,16,1062,90,78,37,984,101,5742
15000US060372699031,1702,79,22,25,9,15,13,21,1680,79,185,82,1495,107,5743
15000US060372699041,309,96,0,12,0,12,0,12,309,96,0,12,309,96,5744
15000US060372699042,1218,149,14,19,14,19,0,12,1204,151,90,69,1114,150,5745
15000US060372699043,550,138,27,34,0,12,27,34,523,138,21,28,502,137,5746
15000US060372699051,258,65,20,28,0,12,20,28,238,56,20,19,218,57,5747
15000US060372699052,1109,69,7,13,0,12,7,13,1102,72,21,24,1081,73,5748
15000US060372699061,1526,73,39,42,15,18,24,37,1487,81,131,61,1356,98,5749
15000US060372699071,1407,54,106,60,6,9,100,60,1301,78,115,57,1186,89,5750
15000US060372701001,976,146,0,12,0,12,0,12,976,146,92,86,884,142,5751
15000US060372701002,403,106,0,12,0,12,0,12,403,106,69,54,334,92,5752
15000US060372701003,1127,132,22,34,0,12,22,34,1105,134,96,56,1009,141,5753
15000US060372702001,461,96,0,12,0,12,0,12,461,96,84,50,377,96,5754
15000US060372702002,263,82,33,51,0,12,33,51,230,73,76,58,154,59,5755
15000US060372702003,463,95,20,26,0,12,20,26,443,95,62,37,381,101,5756
15000US060372703001,190,49,0,12,0,12,0,12,190,49,18,15,172,52,5757
15000US060372703002,354,51,0,12,0,12,0,12,354,51,55,27,299,52,5758
15000US060372703003,407,63,33,36,15,24,18,27,374,64,64,33,310,65,5759
15000US060372711001,222,47,20,18,0,12,20,18,202,46,29,19,173,49,5760
15000US060372711002,332,44,0,12,0,12,0,12,332,44,55,24,277,44,5761
15000US060372711003,396,53,0,12,0,12,0,12,396,53,46,22,350,53,5762
15000US060372712001,697,99,7,10,7,10,0,12,690,100,43,38,647,101,5763
15000US060372712002,506,99,19,28,0,12,19,28,487,102,37,46,450,99,5764
15000US060372713001,287,76,16,25,0,12,16,25,271,76,16,26,255,77,5765
15000US060372713002,482,105,17,26,0,12,17,26,465,106,69,71,396,108,5766
15000US060372713003,611,109,0,12,0,12,0,12,611,109,76,56,535,113,5767
15000US060372713004,278,79,39,64,0,12,39,64,239,65,64,45,175,67,5768
15000US060372713005,376,101,72,72,17,26,55,68,304,107,30,34,274,113,5769
15000US060372714001,190,56,0,12,0,12,0,12,190,56,48,35,142,54,5770
15000US060372714002,417,64,0,12,0,12,0,12,417,64,44,32,373,70,5771
15000US060372714003,733,79,0,12,0,12,0,12,733,79,180,76,553,103,5772
15000US060372715001,412,75,10,16,0,12,10,16,402,76,42,23,360,75,5773
15000US060372715002,215,39,0,12,0,12,0,12,215,39,11,12,204,40,5774
15000US060372715003,780,83,13,20,0,12,13,20,767,83,110,65,657,93,5775
15000US060372716001,535,96,50,57,9,14,41,49,485,99,35,25,450,101,5776
15000US060372716002,480,88,18,24,0,12,18,24,462,85,73,47,389,92,5777
15000US060372716003,242,44,0,12,0,12,0,12,242,44,34,25,208,47,5778
15000US060372716004,609,85,35,30,0,12,35,30,574,86,22,35,552,81,5779
15000US060372717011,406,102,14,24,0,12,14,24,392,100,111,60,281,94,5780
15000US060372717012,344,82,0,12,0,12,0,12,344,82,67,49,277,77,5781
15000US060372717013,1191,158,20,30,0,12,20,30,1171,162,148,85,1023,176,5782
15000US060372717014,873,154,13,21,13,21,0,12,860,152,203,117,657,174,5783
15000US060372717021,561,81,19,14,0,12,19,14,542,81,63,36,479,81,5784
15000US060372717022,521,108,0,12,0,12,0,12,521,108,22,22,499,110,5785
15000US060372717023,785,94,63,55,0,12,63,55,722,92,30,28,692,95,5786
15000US060372718011,489,91,0,12,0,12,0,12,489,91,37,34,452,92,5787
15000US060372718012,974,113,45,33,23,25,22,25,929,118,15,18,914,114,5788
15000US060372718013,217,70,0,12,0,12,0,12,217,70,20,22,197,67,5789
15000US060372718021,525,137,0,12,0,12,0,12,525,137,169,96,356,113,5790
15000US060372718022,1539,166,50,42,37,40,13,29,1489,168,200,106,1289,181,5791
15000US060372718023,663,135,36,43,0,12,36,43,627,130,92,74,535,125,5792
15000US060372719011,430,65,0,12,0,12,0,12,430,65,40,26,390,69,5793
15000US060372719012,591,74,10,14,0,12,10,14,581,73,87,36,494,83,5794
15000US060372719013,297,66,0,12,0,12,0,12,297,66,69,45,228,68,5795
15000US060372719021,228,39,0,12,0,12,0,12,228,39,35,24,193,40,5796
15000US060372719022,469,74,14,17,10,15,4,10,455,71,46,31,409,73,5797
15000US060372719023,1106,87,11,16,11,16,0,12,1095,88,106,65,989,96,5798
15000US060372721001,445,85,0,12,0,12,0,12,445,85,74,41,371,81,5799
15000US060372721002,294,68,17,18,0,12,17,18,277,70,56,55,221,61,5800
15000US060372721003,262,65,33,27,11,16,22,23,229,61,63,36,166,59,5801
15000US060372721004,417,82,10,16,10,16,0,12,407,83,67,32,340,85,5802
15000US060372721005,340,89,10,15,10,15,0,12,330,89,55,60,275,84,5803
15000US060372722011,647,80,55,48,36,39,19,21,592,90,118,62,474,93,5804
15000US060372722012,517,78,26,42,0,12,26,42,491,78,64,46,427,82,5805
15000US060372722021,453,73,28,32,0,12,28,32,425,77,103,61,322,70,5806
15000US060372722022,1171,77,91,57,64,51,27,31,1080,86,188,78,892,94,5807
15000US060372723011,403,70,17,15,8,13,9,15,386,71,100,66,286,74,5808
15000US060372723012,479,90,9,15,9,15,0,12,470,88,45,36,425,87,5809
15000US060372723013,380,80,0,12,0,12,0,12,380,80,79,54,301,73,5810
15000US060372723021,1072,103,55,45,25,23,30,39,1017,111,176,59,841,109,5811
15000US060372723022,868,92,14,11,0,12,14,11,854,94,146,54,708,110,5812
15000US060372731001,247,45,0,12,0,12,0,12,247,45,67,34,180,41,5813
15000US060372731002,444,65,0,12,0,12,0,12,444,65,37,29,407,62,5814
15000US060372731003,309,50,0,12,0,12,0,12,309,50,95,46,214,51,5815
15000US060372732001,347,65,0,12,0,12,0,12,347,65,9,12,338,67,5816
15000US060372732002,457,99,59,61,8,12,51,59,398,96,47,37,351,95,5817
15000US060372732003,318,74,21,35,0,12,21,35,297,66,58,41,239,67,5818
15000US060372732004,423,87,31,30,6,10,25,29,392,81,58,29,334,78,5819
15000US060372733001,806,97,31,26,10,16,21,21,775,99,137,106,638,136,5820
15000US060372733002,357,84,67,71,0,12,67,71,290,83,39,31,251,75,5821
15000US060372733003,461,110,21,35,0,12,21,35,440,105,60,52,380,97,5822
15000US060372734021,282,83,0,12,0,12,0,12,282,83,23,26,259,82,5823
15000US060372734022,581,161,23,19,0,12,23,19,558,160,69,56,489,171,5824
15000US060372734023,507,139,12,19,0,12,12,19,495,139,14,23,481,138,5825
15000US060372734024,502,119,14,24,0,12,14,24,488,119,62,51,426,118,5826
15000US060372735021,318,71,0,12,0,12,0,12,318,71,30,28,288,68,5827
15000US060372735022,184,63,0,12,0,12,0,12,184,63,28,19,156,63,5828
15000US060372735023,613,102,13,21,0,12,13,21,600,101,36,26,564,100,5829
15000US060372735024,532,98,8,13,0,12,8,13,524,98,15,16,509,100,5830
15000US060372736001,213,61,20,30,0,12,20,30,193,50,6,9,187,53,5831
15000US060372736002,241,54,0,12,0,12,0,12,241,54,13,19,228,53,5832
15000US060372736003,211,64,0,12,0,12,0,12,211,64,25,26,186,64,5833
15000US060372736004,480,83,16,13,16,13,0,12,464,86,69,49,395,87,5834
15000US060372737001,405,85,0,12,0,12,0,12,405,85,126,68,279,87,5835
15000US060372737002,447,84,23,36,23,36,0,12,424,81,18,20,406,81,5836
15000US060372737003,378,74,0,12,0,12,0,12,378,74,17,20,361,74,5837
15000US060372738001,847,91,15,17,7,12,8,12,832,89,109,54,723,100,5838
15000US060372738002,449,72,0,12,0,12,0,12,449,72,17,25,432,69,5839
15000US060372738003,280,56,0,12,0,12,0,12,280,56,20,20,260,58,5840
15000US060372739021,535,112,0,12,0,12,0,12,535,112,78,58,457,112,5841
15000US060372739022,463,133,0,12,0,12,0,12,463,133,56,45,407,133,5842
15000US060372739023,470,141,0,12,0,12,0,12,470,141,105,89,365,115,5843
15000US060372739024,524,109,12,20,0,12,12,20,512,109,96,43,416,106,5844
15000US060372739025,235,69,0,12,0,12,0,12,235,69,29,31,206,71,5845
15000US060372741001,1824,186,0,12,0,12,0,12,1824,186,240,115,1584,212,5846
15000US060372741002,353,108,0,12,0,12,0,12,353,108,81,81,272,99,5847
15000US060372742021,916,172,70,75,13,20,57,73,846,176,195,109,651,158,5848
15000US060372742022,535,123,0,12,0,12,0,12,535,123,54,44,481,129,5849
15000US060372742023,331,119,12,21,0,12,12,21,319,118,96,59,223,112,5850
15000US060372742024,570,162,0,12,0,12,0,12,570,162,132,122,438,164,5851
15000US060372751011,497,29,13,13,4,6,9,11,484,31,137,38,347,45,5852
15000US060372751021,905,105,95,54,52,52,43,36,810,106,135,44,675,104,5853
15000US060372751022,383,78,19,29,0,12,19,29,364,82,59,37,305,82,5854
15000US060372752001,544,88,18,22,9,15,9,14,526,88,37,29,489,89,5855
15000US060372752002,580,111,10,15,0,12,10,15,570,112,131,59,439,107,5856
15000US060372752003,497,81,23,24,7,13,16,19,474,88,23,21,451,89,5857
15000US060372753021,529,138,0,12,0,12,0,12,529,138,78,56,451,152,5858
15000US060372753022,1214,176,0,12,0,12,0,12,1214,176,246,122,968,161,5859
15000US060372753023,793,123,0,12,0,12,0,12,793,123,225,89,568,128,5860
15000US060372753111,350,102,11,22,0,12,11,22,339,102,89,76,250,97,5861
15000US060372753112,665,111,41,60,0,12,41,60,624,111,140,67,484,114,5862
15000US060372753113,561,90,9,16,0,12,9,16,552,89,16,24,536,95,5863
15000US060372753114,784,119,0,12,0,12,0,12,784,119,113,51,671,129,5864
15000US060372754001,508,84,89,78,34,48,55,61,419,71,61,33,358,69,5865
15000US060372754002,1345,114,0,12,0,12,0,12,1345,114,122,59,1223,126,5866
15000US060372755001,397,83,8,14,0,12,8,14,389,83,130,71,259,79,5867
15000US060372755002,289,70,0,12,0,12,0,12,289,70,73,39,216,71,5868
15000US060372755003,270,63,0,12,0,12,0,12,270,63,62,39,208,65,5869
15000US060372755004,815,92,330,104,129,80,201,80,485,97,185,81,300,88,5870
15000US060372756021,4050,174,38,62,0,17,38,62,4012,167,164,95,3848,187,5871
15000US060372756031,376,61,7,12,7,12,0,12,369,61,29,23,340,66,5872
15000US060372756032,217,65,0,12,0,12,0,12,217,65,70,45,147,53,5873
15000US060372756033,594,81,6,10,6,10,0,12,588,82,127,52,461,91,5874
15000US060372760001,356,103,0,12,0,12,0,12,356,103,36,40,320,104,5875
15000US060372760002,415,62,15,24,0,12,15,24,400,66,125,54,275,59,5876
15000US060372760003,625,114,0,12,0,12,0,12,625,114,169,105,456,117,5877
15000US060372760004,547,83,17,28,17,28,0,12,530,87,70,54,460,87,5878
15000US060372760005,338,91,0,12,0,12,0,12,338,91,41,40,297,94,5879
15000US060372761001,858,162,0,12,0,12,0,12,858,162,124,92,734,176,5880
15000US060372761002,1796,206,16,24,16,24,0,12,1780,205,253,149,1527,212,5881
15000US060372761003,301,116,38,41,21,33,17,27,263,117,37,42,226,110,5882
15000US060372764001,278,65,9,15,9,15,0,12,269,65,38,29,231,61,5883
15000US060372764002,364,60,0,12,0,12,0,12,364,60,64,36,300,68,5884
15000US060372764003,338,57,41,33,30,30,11,17,297,67,41,31,256,71,5885
15000US060372764004,303,75,0,12,0,12,0,12,303,75,97,40,206,76,5886
15000US060372764005,223,48,0,12,0,12,0,12,223,48,31,24,192,48,5887
15000US060372765001,420,47,11,12,5,7,6,10,409,48,98,37,311,46,5888
15000US060372765002,280,40,0,12,0,12,0,12,280,40,27,19,253,43,5889
15000US060372766011,365,74,0,12,0,12,0,12,365,74,31,23,334,69,5890
15000US060372766012,378,78,0,12,0,12,0,12,378,78,24,20,354,79,5891
15000US060372766013,358,84,0,12,0,12,0,12,358,84,23,24,335,82,5892
15000US060372766014,537,113,11,17,0,12,11,17,526,112,63,44,463,113,5893
15000US060372766031,1419,176,0,12,0,12,0,12,1419,176,135,87,1284,184,5894
15000US060372766032,1784,195,23,29,12,21,11,19,1761,201,115,75,1646,212,5895
15000US060372766041,1213,181,13,20,0,12,13,20,1200,184,135,48,1065,184,5896
15000US060372766042,1018,165,0,12,0,12,0,12,1018,165,104,58,914,176,5897
15000US060372770001,425,97,0,12,0,12,0,12,425,97,96,66,329,90,5898
15000US060372770002,413,92,0,12,0,12,0,12,413,92,71,59,342,86,5899
15000US060372770003,541,98,0,12,0,12,0,12,541,98,42,40,499,104,5900
15000US060372770004,370,77,17,28,0,12,17,28,353,85,62,51,291,93,5901
15000US060372770005,478,114,0,12,0,12,0,12,478,114,129,94,349,110,5902
15000US060372771001,391,70,0,12,0,12,0,12,391,70,49,51,342,65,5903
15000US060372771002,249,47,0,12,0,12,0,12,249,47,44,29,205,43,5904
15000US060372771003,425,71,8,13,0,12,8,13,417,72,82,37,335,74,5905
15000US060372772001,1025,73,64,44,29,24,35,34,961,81,167,61,794,83,5906
15000US060372772002,18,27,0,12,0,12,0,12,18,27,0,12,18,27,5907
15000US060372774001,439,66,71,46,0,12,71,46,368,68,33,26,335,62,5908
15000US060372774002,219,55,30,25,8,11,22,23,189,53,22,19,167,53,5909
15000US060372780011,379,66,31,30,15,25,16,16,348,62,60,24,288,61,5910
15000US060372780012,577,68,15,22,0,12,15,22,562,70,64,28,498,74,5911
15000US060372781021,267,52,11,16,0,12,11,16,256,53,17,18,239,56,5912
15000US060372781022,705,85,0,12,0,12,0,12,705,85,75,38,630,90,5913
15000US060372781023,478,68,0,12,0,12,0,12,478,68,34,29,444,79,5914
15000US060372911101,785,88,151,63,74,52,77,51,634,90,165,77,469,109,5915
15000US060372911102,471,85,97,58,49,46,48,35,374,77,86,47,288,85,5916
15000US060372911201,613,35,123,48,38,28,85,41,490,56,83,33,407,57,5917
15000US060372911301,269,60,5,7,5,7,0,12,264,60,69,29,195,58,5918
15000US060372911302,528,67,75,48,23,29,52,41,453,75,115,55,338,72,5919
15000US060372911303,228,52,24,20,0,12,24,20,204,49,69,34,135,48,5920
15000US060372912101,398,96,56,39,0,12,56,39,342,92,124,54,218,85,5921
15000US060372912102,814,92,88,62,20,33,68,53,726,105,179,78,547,104,5922
15000US060372912103,273,69,60,40,0,12,60,40,213,78,29,32,184,72,5923
15000US060372912201,189,49,50,41,16,26,34,31,139,45,28,18,111,47,5924
15000US060372912202,593,62,71,41,31,28,40,34,522,72,81,33,441,79,5925
15000US060372912203,258,58,58,41,0,12,58,41,200,60,70,44,130,42,5926
15000US060372913001,384,51,0,12,0,12,0,12,384,51,133,42,251,48,5927
15000US060372913002,282,44,19,19,5,7,14,19,263,44,49,23,214,47,5928
15000US060372913003,324,47,5,7,0,12,5,7,319,47,135,38,184,46,5929
15000US060372920001,254,67,23,35,0,12,23,35,231,64,65,43,166,64,5930
15000US060372920002,384,85,73,54,54,46,19,30,311,81,46,41,265,84,5931
15000US060372920003,890,112,225,93,44,41,181,83,665,114,186,76,479,97,5932
15000US060372920004,296,59,15,18,8,12,7,13,281,63,34,27,247,70,5933
15000US060372932011,526,130,48,54,0,12,48,54,478,130,121,69,357,124,5934
15000US060372932012,801,143,74,56,43,35,31,48,727,138,100,66,627,155,5935
15000US060372932013,857,142,124,91,37,44,87,78,733,150,155,81,578,171,5936
15000US060372932021,294,73,82,60,31,35,51,49,212,66,43,33,169,61,5937
15000US060372932022,643,97,184,96,51,49,133,89,459,105,132,61,327,106,5938
15000US060372932023,848,110,147,68,60,48,87,58,701,122,140,65,561,127,5939
15000US060372933011,1046,57,0,12,0,12,0,12,1046,57,245,64,801,92,5940
15000US060372933021,883,97,41,36,22,35,19,20,842,97,198,62,644,118,5941
15000US060372933022,787,100,106,72,11,19,95,69,681,109,92,46,589,117,5942
15000US060372933041,711,114,80,51,24,24,56,44,631,117,146,73,485,107,5943
15000US060372933042,667,99,72,45,25,22,47,40,595,114,57,44,538,113,5944
15000US060372933061,274,58,14,15,6,8,8,12,260,61,74,45,186,58,5945
15000US060372933062,514,58,5,8,5,8,0,12,509,58,143,41,366,57,5946
15000US060372933071,580,64,63,41,5,7,58,42,517,60,74,37,443,70,5947
15000US060372933072,342,63,62,50,25,26,37,42,280,65,34,36,246,59,5948
15000US060372941101,407,86,40,43,0,12,40,43,367,89,94,63,273,75,5949
15000US060372941102,473,81,72,61,0,12,72,61,401,97,101,56,300,99,5950
15000US060372941103,244,74,0,12,0,12,0,12,244,74,54,45,190,70,5951
15000US060372941201,127,34,20,18,0,12,20,18,107,34,42,25,65,35,5952
15000US060372941202,277,43,73,37,23,19,50,33,204,50,17,17,187,49,5953
15000US060372941203,149,43,52,40,14,22,38,32,97,33,35,17,62,31,5954
15000US060372942001,319,80,6,10,0,12,6,10,313,79,29,31,284,84,5955
15000US060372942002,662,108,49,56,25,40,24,40,613,113,156,68,457,107,5956
15000US060372942003,358,88,24,31,10,15,14,25,334,84,96,47,238,79,5957
15000US060372943011,424,42,26,22,0,12,26,22,398,42,114,39,284,55,5958
15000US060372943012,258,44,18,16,5,7,13,14,240,45,63,30,177,45,5959
15000US060372943021,539,91,118,69,0,12,118,69,421,82,89,49,332,83,5960
15000US060372943022,632,94,24,35,0,12,24,35,608,97,129,55,479,96,5961
15000US060372944101,578,86,234,84,88,58,146,63,344,85,97,44,247,84,5962
15000US060372944102,1045,90,124,60,74,51,50,43,921,97,256,87,665,114,5963
15000US060372944211,439,66,62,39,22,25,40,30,377,60,89,41,288,54,5964
15000US060372944212,228,58,61,46,34,37,27,26,167,64,30,24,137,61,5965
15000US060372944213,284,76,71,48,30,31,41,38,213,72,8,12,205,70,5966
15000US060372945101,475,73,31,30,16,17,15,25,444,83,61,47,383,87,5967
15000US060372945102,606,88,131,57,42,40,89,46,475,98,84,53,391,97,5968
15000US060372945201,387,54,38,24,4,7,34,22,349,55,77,34,272,59,5969
15000US060372945202,532,55,134,52,47,32,87,50,398,59,74,36,324,62,5970
15000US060372946101,283,58,33,28,0,12,33,28,250,55,63,36,187,54,5971
15000US060372946102,900,63,161,68,22,25,139,66,739,85,251,80,488,101,5972
15000US060372946201,388,84,102,61,34,41,68,48,286,77,118,63,168,63,5973
15000US060372946202,442,74,86,63,17,18,69,60,356,78,122,48,234,81,5974
15000US060372946203,320,72,104,67,21,33,83,62,216,69,34,27,182,70,5975
15000US060372947011,149,38,27,23,16,16,11,16,122,40,32,22,90,38,5976
15000US060372947012,280,44,53,30,22,19,31,24,227,49,65,34,162,48,5977
15000US060372947013,460,51,128,46,45,29,83,40,332,59,112,45,220,59,5978
15000US060372948101,465,67,136,54,37,26,99,48,329,63,83,39,246,61,5979
15000US060372948102,478,60,168,42,40,31,128,43,310,62,69,39,241,63,5980
15000US060372948201,579,51,138,55,38,29,100,48,441,67,115,54,326,58,5981
15000US060372948202,320,56,118,46,46,33,72,36,202,54,61,28,141,48,5982
15000US060372948301,695,56,178,53,21,23,157,53,517,68,120,50,397,69,5983
15000US060372948302,306,55,75,34,27,23,48,24,231,60,52,29,179,56,5984
15000US060372949001,473,44,136,50,21,24,115,44,337,56,85,39,252,60,5985
15000US060372949002,408,43,95,40,25,18,70,35,313,42,76,32,237,44,5986
15000US060372951031,1366,141,35,42,0,12,35,42,1331,150,202,109,1129,152,5987
15000US060372951032,632,115,12,20,0,12,12,20,620,115,97,65,523,138,5988
15000US060372962101,188,57,24,35,1,5,23,35,164,48,68,44,96,56,5989
15000US060372962102,352,67,23,21,23,21,0,12,329,65,87,47,242,62,5990
15000US060372962103,380,76,112,63,5,7,107,62,268,76,35,24,233,76,5991
15000US060372962201,183,72,26,40,0,12,26,40,157,69,16,22,141,70,5992
15000US060372962202,867,118,299,99,55,58,244,108,568,122,170,88,398,124,5993
15000US060372962203,573,85,50,50,35,39,15,26,523,95,106,50,417,86,5994
15000US060372963001,454,85,53,39,10,15,43,36,401,89,76,38,325,92,5995
15000US060372963002,1461,92,8,13,8,13,0,12,1453,92,192,70,1261,103,5996
15000US060372964011,793,93,7,11,7,11,0,12,786,92,167,61,619,97,5997
15000US060372964012,478,75,0,12,0,12,0,12,478,75,231,91,247,69,5998
15000US060372964021,400,65,54,46,19,29,35,36,346,68,88,41,258,72,5999
15000US060372964022,293,84,23,36,23,36,0,12,270,83,112,61,158,69,6000
15000US060372964023,418,75,8,14,0,12,8,14,410,76,72,50,338,86,6001
15000US060372965001,421,103,48,43,17,29,31,49,373,100,115,88,258,77,6002
15000US060372965002,550,102,61,47,19,23,42,41,489,107,55,39,434,109,6003
15000US060372965003,354,89,52,46,12,18,40,41,302,92,149,89,153,85,6004
15000US060372966001,358,104,41,42,17,28,24,31,317,105,31,34,286,105,6005
15000US060372966002,462,122,88,64,18,19,70,62,374,124,41,35,333,117,6006
15000US060372966003,338,98,44,37,44,37,0,12,294,101,80,69,214,97,6007
15000US060372966004,734,134,248,106,126,89,122,88,486,132,148,79,338,107,6008
15000US060372969011,639,99,146,76,38,42,108,71,493,98,112,57,381,96,6009
15000US060372969012,586,103,151,76,40,41,111,67,435,92,152,56,283,90,6010
15000US060372969013,236,69,0,12,0,12,0,12,236,69,106,59,130,57,6011
15000US060372969021,505,97,29,26,0,12,29,26,476,96,72,45,404,92,6012
15000US060372969022,910,112,48,50,18,21,30,47,862,110,131,68,731,106,6013
15000US060372969023,262,78,0,12,0,12,0,12,262,78,49,41,213,77,6014
15000US060372970001,448,90,0,12,0,12,0,12,448,90,143,87,305,83,6015
15000US060372970002,225,60,0,12,0,12,0,12,225,60,62,54,163,61,6016
15000US060372970003,627,137,42,63,42,63,0,12,585,126,174,91,411,114,6017
15000US060372970004,522,98,13,21,0,12,13,21,509,95,86,63,423,104,6018
15000US060372970005,394,106,0,12,0,12,0,12,394,106,25,30,369,103,6019
15000US060372971101,709,111,118,67,45,55,73,63,591,106,177,54,414,104,6020
15000US060372971102,867,117,272,98,30,22,242,100,595,136,189,92,406,121,6021
15000US060372971201,408,96,87,52,32,29,55,45,321,99,57,46,264,98,6022
15000US060372971202,665,91,104,46,48,49,56,38,561,98,121,67,440,86,6023
15000US060372972011,769,104,107,78,33,37,74,64,662,105,112,66,550,110,6024
15000US060372972012,594,114,38,30,8,13,30,27,556,116,102,80,454,109,6025
15000US060372972021,688,92,57,61,57,61,0,12,631,93,104,55,527,104,6026
15000US060372972022,614,105,109,91,57,63,52,64,505,95,97,51,408,86,6027
15000US060372972023,191,80,6,11,0,12,6,11,185,80,36,44,149,65,6028
15000US060372973001,358,57,16,14,11,11,5,8,342,58,99,42,243,54,6029
15000US060372973002,132,46,0,12,0,12,0,12,132,46,16,14,116,46,6030
15000US060372973003,262,50,6,9,0,12,6,9,256,52,83,40,173,51,6031
15000US060372974001,284,52,9,13,0,12,9,13,275,51,68,37,207,55,6032
15000US060372974002,1012,84,6,11,6,11,0,12,1006,85,246,69,760,96,6033
15000US060372974003,243,48,0,12,0,12,0,12,243,48,46,29,197,48,6034
15000US060372975001,693,135,72,94,0,12,72,94,621,159,79,53,542,164,6035
15000US060372975002,335,158,0,12,0,12,0,12,335,158,43,53,292,135,6036
15000US060372975003,471,120,0,12,0,12,0,12,471,120,0,12,471,120,6037
15000US060372975004,382,83,0,12,0,12,0,12,382,83,64,52,318,95,6038
15000US060372975005,252,72,0,12,0,12,0,12,252,72,50,49,202,83,6039
15000US060372976011,470,96,18,22,9,16,9,15,452,96,53,44,399,98,6040
15000US060372976012,380,80,83,73,83,73,0,12,297,71,57,38,240,72,6041
15000US060372976013,322,75,0,12,0,12,0,12,322,75,48,41,274,73,6042
15000US060372976021,466,105,18,19,9,14,9,14,448,106,120,55,328,102,6043
15000US060372976022,725,97,36,31,0,12,36,31,689,104,155,80,534,87,6044
15000US060372976023,506,94,54,35,32,26,22,25,452,95,37,28,415,91,6045
15000US060373001001,552,97,0,12,0,12,0,12,552,97,106,56,446,99,6046
15000US060373001002,372,73,0,12,0,12,0,12,372,73,70,49,302,74,6047
15000US060373001003,452,112,0,12,0,12,0,12,452,112,76,51,376,119,6048
15000US060373001004,558,112,0,12,0,12,0,12,558,112,122,84,436,107,6049
15000US060373002001,455,65,0,12,0,12,0,12,455,65,95,48,360,72,6050
15000US060373002002,339,51,0,12,0,12,0,12,339,51,63,41,276,53,6051
15000US060373002003,309,68,24,27,12,18,12,19,285,73,43,35,242,72,6052
15000US060373002004,266,77,0,12,0,12,0,12,266,77,62,49,204,71,6053
15000US060373002005,558,88,9,14,0,12,9,14,549,89,36,25,513,90,6054
15000US060373003011,497,118,0,12,0,12,0,12,497,118,61,59,436,122,6055
15000US060373003012,341,83,0,12,0,12,0,12,341,83,77,66,264,78,6056
15000US060373003013,259,93,0,12,0,12,0,12,259,93,77,49,182,100,6057
15000US060373003014,196,65,0,12,0,12,0,12,196,65,24,26,172,61,6058
15000US060373003015,284,105,0,12,0,12,0,12,284,105,74,53,210,116,6059
15000US060373003016,555,110,0,12,0,12,0,12,555,110,140,76,415,107,6060
15000US060373004001,439,96,21,35,21,35,0,12,418,102,79,53,339,107,6061
15000US060373004002,341,84,9,16,9,16,0,12,332,82,127,88,205,72,6062
15000US060373004003,376,79,0,12,0,12,0,12,376,79,85,58,291,90,6063
15000US060373004004,263,82,0,12,0,12,0,12,263,82,92,70,171,81,6064
15000US060373004005,221,57,0,12,0,12,0,12,221,57,30,36,191,61,6065
15000US060373004006,325,85,12,23,12,23,0,12,313,82,81,49,232,86,6066
15000US060373005011,487,64,9,15,9,15,0,12,478,63,112,52,366,68,6067
15000US060373005012,193,46,0,12,0,12,0,12,193,46,61,37,132,47,6068
15000US060373005013,343,57,0,12,0,12,0,12,343,57,57,63,286,78,6069
15000US060373005021,929,153,67,81,0,12,67,81,862,144,141,87,721,161,6070
15000US060373005022,844,122,14,25,0,12,14,25,830,121,46,43,784,123,6071
15000US060373005023,541,100,0,12,0,12,0,12,541,100,102,63,439,110,6072
15000US060373006001,360,79,14,22,14,22,0,12,346,79,57,45,289,82,6073
15000US060373006002,253,99,0,12,0,12,0,12,253,99,17,25,236,99,6074
15000US060373006003,1227,141,28,31,0,12,28,31,1199,145,201,111,998,148,6075
15000US060373006004,825,147,0,12,0,12,0,12,825,147,419,135,406,112,6076
15000US060373006005,726,123,13,21,13,21,0,12,713,126,135,60,578,125,6077
15000US060373007011,327,109,0,12,0,12,0,12,327,109,52,60,275,110,6078
15000US060373007012,257,79,0,12,0,12,0,12,257,79,47,35,210,84,6079
15000US060373007013,246,76,0,12,0,12,0,12,246,76,0,12,246,76,6080
15000US060373007014,537,101,0,12,0,12,0,12,537,101,105,61,432,112,6081
15000US060373007015,760,107,0,12,0,12,0,12,760,107,130,68,630,128,6082
15000US060373007021,961,121,0,12,0,12,0,12,961,121,140,83,821,131,6083
15000US060373007022,936,92,0,12,0,12,0,12,936,92,81,52,855,101,6084
15000US060373008001,1058,148,94,71,21,27,73,64,964,154,177,70,787,172,6085
15000US060373008002,398,114,24,38,0,12,24,38,374,110,47,44,327,109,6086
15000US060373008003,436,95,0,12,0,12,0,12,436,95,120,67,316,88,6087
15000US060373008004,473,141,42,65,0,12,42,65,431,126,118,91,313,124,6088
15000US060373008005,310,99,0,12,0,12,0,12,310,99,46,41,264,112,6089
15000US060373009011,474,115,0,12,0,12,0,12,474,115,134,79,340,96,6090
15000US060373009012,462,120,0,12,0,12,0,12,462,120,101,91,361,127,6091
15000US060373009013,1197,148,21,36,21,36,0,12,1176,151,135,71,1041,161,6092
15000US060373009021,225,31,5,7,5,7,0,12,220,31,72,27,148,31,6093
15000US060373009022,484,36,7,11,0,12,7,11,477,37,101,39,376,45,6094
15000US060373010001,420,95,25,28,8,11,17,26,395,94,89,61,306,85,6095
15000US060373010002,573,84,30,43,30,43,0,12,543,80,146,62,397,80,6096
15000US060373010003,498,99,16,20,8,14,8,13,482,103,135,67,347,87,6097
15000US060373010004,530,108,33,44,0,12,33,44,497,104,107,65,390,97,6098
15000US060373011001,259,83,27,46,0,12,27,46,232,83,13,20,219,87,6099
15000US060373011002,278,69,0,12,0,12,0,12,278,69,81,57,197,77,6100
15000US060373011003,339,98,0,12,0,12,0,12,339,98,131,69,208,100,6101
15000US060373011004,297,74,13,22,0,12,13,22,284,82,0,12,284,82,6102
15000US060373011005,615,137,11,17,11,17,0,12,604,137,198,122,406,129,6103
15000US060373011006,895,176,45,55,0,12,45,55,850,186,187,102,663,181,6104
15000US060373012031,743,107,31,38,0,12,31,38,712,101,164,84,548,96,6105
15000US060373012032,1086,104,33,40,0,12,33,40,1053,105,351,107,702,119,6106
15000US060373012041,627,131,0,12,0,12,0,12,627,131,100,82,527,127,6107
15000US060373012042,691,139,0,12,0,12,0,12,691,139,125,90,566,148,6108
15000US060373012043,733,126,82,67,48,52,34,41,651,137,323,119,328,118,6109
15000US060373012051,331,47,0,12,0,12,0,12,331,47,110,44,221,52,6110
15000US060373012052,128,36,0,12,0,12,0,12,128,36,36,27,92,34,6111
15000US060373012053,270,41,9,13,9,13,0,12,261,44,62,30,199,43,6112
15000US060373012061,783,81,171,64,84,60,87,56,612,90,181,76,431,94,6113
15000US060373012062,320,61,17,18,0,12,17,18,303,65,100,60,203,57,6114
15000US060373012063,348,74,9,15,0,12,9,15,339,76,102,60,237,73,6115
15000US060373012064,471,97,27,35,6,9,21,33,444,102,84,57,360,92,6116
15000US060373013001,251,40,0,12,0,12,0,12,251,40,17,15,234,41,6117
15000US060373013002,456,45,12,14,7,11,5,8,444,46,91,40,353,59,6118
15000US060373014001,351,83,0,12,0,12,0,12,351,83,112,71,239,71,6119
15000US060373014002,445,82,0,12,0,12,0,12,445,82,69,43,376,95,6120
15000US060373014003,214,59,0,12,0,12,0,12,214,59,66,28,148,57,6121
15000US060373014004,228,57,18,30,0,12,18,30,210,51,48,38,162,50,6122
15000US060373015011,204,48,0,12,0,12,0,12,204,48,59,33,145,48,6123
15000US060373015012,370,46,4,6,0,12,4,6,366,47,96,45,270,54,6124
15000US060373015021,613,117,64,61,0,12,64,61,549,125,174,90,375,117,6125
15000US060373015022,1007,144,208,115,99,92,109,90,799,131,283,117,516,129,6126
15000US060373015023,855,147,278,102,108,69,170,87,577,153,254,135,323,127,6127
15000US060373016011,647,141,54,44,18,31,36,32,593,144,248,109,345,114,6128
15000US060373016012,437,117,0,12,0,12,0,12,437,117,123,71,314,120,6129
15000US060373016013,629,131,87,64,17,27,70,68,542,134,82,67,460,130,6130
15000US060373016014,620,126,112,80,66,78,46,39,508,116,209,109,299,92,6131
15000US060373016021,899,87,108,60,32,36,76,49,791,88,92,49,699,94,6132
15000US060373016022,314,58,28,22,9,14,19,19,286,60,46,34,240,63,6133
15000US060373016023,404,71,12,18,0,12,12,18,392,74,34,25,358,74,6134
15000US060373017011,495,76,38,44,25,38,13,19,457,83,175,62,282,83,6135
15000US060373017012,587,88,5,9,0,12,5,9,582,89,168,81,414,99,6136
15000US060373017021,681,120,102,76,26,43,76,65,579,124,180,82,399,114,6137
15000US060373017022,575,103,78,44,42,44,36,20,497,103,211,80,286,94,6138
15000US060373017023,427,109,34,29,12,16,22,26,393,113,89,61,304,108,6139
15000US060373017024,261,93,38,35,0,12,38,35,223,87,55,45,168,80,6140
15000US060373018011,438,83,25,30,7,10,18,29,413,91,155,70,258,93,6141
15000US060373018012,842,108,25,22,9,14,16,18,817,103,260,83,557,104,6142
15000US060373018013,461,67,32,26,0,12,32,26,429,71,67,38,362,74,6143
15000US060373018021,847,97,85,58,7,10,78,57,762,104,246,88,516,104,6144
15000US060373018022,555,92,80,51,11,20,69,51,475,96,180,78,295,84,6145
15000US060373019001,1048,169,62,74,0,12,62,74,986,169,203,86,783,176,6146
15000US060373019002,740,120,19,29,0,12,19,29,721,117,257,108,464,120,6147
15000US060373019003,374,106,0,12,0,12,0,12,374,106,106,81,268,110,6148
15000US060373019004,1056,153,92,82,0,12,92,82,964,145,108,58,856,164,6149
15000US060373020021,450,103,67,36,7,11,60,36,383,98,93,61,290,81,6150
15000US060373020022,954,100,54,47,14,16,40,45,900,102,221,77,679,121,6151
15000US060373020023,302,82,34,39,34,39,0,12,268,84,44,38,224,79,6152
15000US060373020031,1427,37,165,86,48,51,117,70,1262,92,631,103,631,122,6153
15000US060373020041,1584,85,155,75,64,56,91,51,1429,103,377,113,1052,128,6154
15000US060373021021,724,118,0,12,0,12,0,12,724,118,96,62,628,113,6155
15000US060373021022,470,124,34,43,19,37,15,23,436,120,110,60,326,119,6156
15000US060373021023,659,128,120,85,49,57,71,65,539,130,228,105,311,110,6157
15000US060373021024,382,118,38,48,13,22,25,41,344,115,51,48,293,113,6158
15000US060373021025,379,89,0,12,0,12,0,12,379,89,45,43,334,91,6159
15000US060373021031,567,97,62,42,43,44,19,21,505,95,135,55,370,98,6160
15000US060373021032,843,108,153,63,26,23,127,64,690,106,219,67,471,97,6161
15000US060373021033,585,90,114,62,47,40,67,49,471,87,158,67,313,73,6162
15000US060373021041,326,66,8,13,8,13,0,12,318,68,31,26,287,65,6163
15000US060373021042,484,84,92,63,34,37,58,50,392,82,88,61,304,81,6164
15000US060373021043,629,85,78,52,15,24,63,48,551,88,130,68,421,88,6165
15000US060373022011,359,67,61,35,31,30,30,26,298,73,112,52,186,60,6166
15000US060373022012,493,76,224,77,52,49,172,63,269,63,102,51,167,53,6167
15000US060373022013,841,93,44,38,27,26,17,27,797,95,438,94,359,95,6168
15000US060373022021,573,103,100,64,17,22,83,60,473,111,184,88,289,100,6169
15000US060373022022,721,101,158,79,77,56,81,53,563,93,101,43,462,95,6170
15000US060373022023,353,76,43,33,0,12,43,33,310,75,79,44,231,73,6171
15000US060373022024,280,68,30,24,15,16,15,19,250,69,112,59,138,75,6172
15000US060373023011,468,69,34,30,10,17,24,27,434,69,111,60,323,74,6173
15000US060373023012,1021,82,79,50,23,26,56,39,942,101,246,76,696,109,6174
15000US060373023021,492,71,60,47,30,33,30,33,432,74,132,50,300,76,6175
15000US060373023022,529,87,104,61,16,26,88,61,425,90,75,43,350,90,6176
15000US060373023023,393,70,19,26,2,4,17,26,374,67,132,47,242,62,6177
15000US060373023024,384,72,40,34,15,16,25,30,344,74,67,37,277,76,6178
15000US060373024011,582,127,170,97,45,55,125,87,412,129,89,49,323,127,6179
15000US060373024012,582,156,52,47,8,16,44,42,530,157,199,117,331,138,6180
15000US060373024013,362,97,93,84,13,21,80,81,269,89,77,75,192,91,6181
15000US060373024014,304,112,24,37,0,12,24,37,280,103,114,91,166,75,6182
15000US060373024015,358,132,142,115,0,12,142,115,216,111,32,38,184,105,6183
15000US060373025031,676,87,84,52,0,12,84,52,592,98,210,82,382,89,6184
15000US060373025032,488,76,117,67,46,34,71,58,371,86,142,55,229,79,6185
15000US060373025033,271,71,24,28,9,16,15,21,247,76,119,57,128,61,6186
15000US060373025041,844,94,123,69,18,21,105,63,721,98,382,94,339,78,6187
15000US060373025042,291,57,66,35,7,13,59,33,225,61,92,48,133,46,6188
15000US060373025043,349,69,32,29,9,15,23,25,317,74,93,56,224,67,6189
15000US060373025051,624,92,110,64,35,38,75,51,514,94,192,68,322,83,6190
15000US060373025052,279,77,40,37,31,35,9,15,239,77,90,48,149,62,6191
15000US060373025053,536,94,158,70,28,33,130,62,378,102,103,56,275,80,6192
15000US060373025061,209,69,5,8,0,12,5,8,204,70,86,57,118,56,6193
15000US060373025062,591,87,33,41,9,15,24,37,558,90,119,52,439,90,6194
15000US060373025063,575,93,88,66,42,48,46,41,487,98,127,49,360,93,6195
15000US060373101001,420,93,0,12,0,12,0,12,420,93,54,49,366,102,6196
15000US060373101002,517,94,0,12,0,12,0,12,517,94,188,98,329,109,6197
15000US060373101003,571,120,14,24,0,12,14,24,557,125,109,101,448,112,6198
15000US060373101004,421,99,0,12,0,12,0,12,421,99,67,52,354,106,6199
15000US060373102011,226,64,20,37,20,37,0,12,206,61,90,49,116,71,6200
15000US060373102012,391,100,0,12,0,12,0,12,391,100,38,35,353,97,6201
15000US060373102013,495,125,75,98,75,98,0,12,420,98,64,50,356,108,6202
15000US060373102014,933,157,53,51,33,36,20,33,880,155,144,105,736,136,6203
15000US060373102021,591,92,34,29,3,6,31,28,557,98,105,60,452,87,6204
15000US060373102022,969,115,36,25,0,12,36,25,933,114,198,91,735,121,6205
15000US060373102023,199,50,0,12,0,12,0,12,199,50,31,27,168,50,6206
15000US060373103001,272,54,0,12,0,12,0,12,272,54,59,32,213,61,6207
15000US060373103002,206,55,0,12,0,12,0,12,206,55,42,43,164,43,6208
15000US060373103003,219,46,0,12,0,12,0,12,219,46,86,48,133,43,6209
15000US060373103004,315,61,0,12,0,12,0,12,315,61,71,47,244,52,6210
15000US060373104001,219,53,0,12,0,12,0,12,219,53,15,16,204,55,6211
15000US060373104002,427,82,2,6,2,6,0,12,425,82,86,43,339,86,6212
15000US060373104003,595,88,49,34,36,32,13,14,546,87,69,39,477,94,6213
15000US060373105011,316,82,0,12,0,12,0,12,316,82,97,61,219,73,6214
15000US060373105012,645,93,53,32,7,11,46,29,592,96,141,81,451,87,6215
15000US060373105013,429,94,16,19,0,12,16,19,413,92,88,59,325,82,6216
15000US060373106011,854,131,80,64,55,64,25,23,774,127,199,91,575,122,6217
15000US060373106012,798,150,15,31,0,12,15,31,783,146,142,78,641,133,6218
15000US060373106013,747,137,63,64,0,12,63,64,684,144,175,111,509,136,6219
15000US060373106021,457,69,8,12,0,12,8,12,449,71,47,33,402,74,6220
15000US060373106022,620,65,9,13,0,12,9,13,611,63,145,52,466,76,6221
15000US060373107011,717,87,25,22,0,12,25,22,692,92,106,49,586,108,6222
15000US060373107012,437,82,0,12,0,12,0,12,437,82,288,86,149,71,6223
15000US060373107021,978,176,32,36,0,12,32,36,946,178,284,144,662,159,6224
15000US060373107022,1545,210,27,32,0,12,27,32,1518,210,504,127,1014,208,6225
15000US060373107023,959,163,153,85,35,41,118,80,806,159,110,61,696,153,6226
15000US060373107031,1158,148,131,121,36,59,95,102,1027,155,295,131,732,140,6227
15000US060373107032,870,145,37,58,0,12,37,58,833,141,337,117,496,143,6228
15000US060373108001,300,61,9,14,9,14,0,12,291,63,44,40,247,51,6229
15000US060373108002,200,42,0,12,0,12,0,12,200,42,59,33,141,47,6230
15000US060373108003,604,85,68,45,9,13,59,43,536,85,164,53,372,91,6231
15000US060373108004,443,75,8,12,0,12,8,12,435,75,55,29,380,79,6232
15000US060373108005,422,65,0,12,0,12,0,12,422,65,62,32,360,66,6233
15000US060373109001,384,101,40,62,40,62,0,12,344,93,84,60,260,92,6234
15000US060373109002,471,104,0,12,0,12,0,12,471,104,136,83,335,96,6235
15000US060373109003,289,84,0,12,0,12,0,12,289,84,11,20,278,85,6236
15000US060373109004,471,115,11,18,0,12,11,18,460,117,107,59,353,116,6237
15000US060373109005,369,106,0,12,0,12,0,12,369,106,208,99,161,89,6238
15000US060373109006,344,115,0,12,0,12,0,12,344,115,41,42,303,118,6239
15000US060373110001,220,44,0,12,0,12,0,12,220,44,48,33,172,48,6240
15000US060373110002,280,58,0,12,0,12,0,12,280,58,37,27,243,61,6241
15000US060373110003,665,77,23,30,0,12,23,30,642,78,88,63,554,81,6242
15000US060373110004,249,48,0,12,0,12,0,12,249,48,65,46,184,53,6243
15000US060373111001,445,86,27,30,27,30,0,12,418,81,104,53,314,77,6244
15000US060373111002,544,80,32,29,17,20,15,20,512,84,100,50,412,95,6245
15000US060373111003,316,58,0,12,0,12,0,12,316,58,47,35,269,66,6246
15000US060373112001,387,71,12,19,12,19,0,12,375,72,82,44,293,74,6247
15000US060373112002,557,82,23,36,0,12,23,36,534,84,13,14,521,86,6248
15000US060373112003,329,69,6,8,6,8,0,12,323,69,60,35,263,69,6249
15000US060373113001,284,56,50,49,18,19,32,47,234,49,69,39,165,55,6250
15000US060373113002,597,91,6,9,0,12,6,9,591,92,87,55,504,97,6251
15000US060373113003,622,94,19,23,9,16,10,17,603,95,85,39,518,95,6252
15000US060373114001,457,48,5,7,0,12,5,7,452,48,81,44,371,50,6253
15000US060373114002,536,52,4,5,0,12,4,5,532,52,135,58,397,58,6254
15000US060373115001,760,114,0,12,0,12,0,12,760,114,59,50,701,123,6255
15000US060373115002,671,112,15,24,0,12,15,24,656,110,146,62,510,112,6256
15000US060373115003,957,122,34,35,21,30,13,21,923,129,193,105,730,131,6257
15000US060373116001,533,117,0,12,0,12,0,12,533,117,37,35,496,120,6258
15000US060373116002,1883,231,0,12,0,12,0,12,1883,231,239,131,1644,225,6259
15000US060373116003,418,100,0,12,0,12,0,12,418,100,96,67,322,89,6260
15000US060373116004,580,112,12,20,1,8,11,18,568,112,129,78,439,106,6261
15000US060373116005,343,124,13,21,13,21,0,12,330,128,49,42,281,130,6262
15000US060373117001,678,140,68,85,0,12,68,85,610,134,91,57,519,132,6263
15000US060373117002,383,95,19,30,19,30,0,12,364,96,41,35,323,95,6264
15000US060373117003,273,94,20,30,20,30,0,12,253,88,48,59,205,71,6265
15000US060373117004,323,101,0,12,0,12,0,12,323,101,53,53,270,109,6266
15000US060373117005,399,116,0,12,0,12,0,12,399,116,35,39,364,121,6267
15000US060373117006,477,144,0,12,0,12,0,12,477,144,61,54,416,156,6268
15000US060373118011,601,104,58,54,0,12,58,54,543,109,102,55,441,104,6269
15000US060373118012,634,91,6,11,0,12,6,11,628,91,122,49,506,98,6270
15000US060373118021,643,123,106,75,57,54,49,49,537,124,49,30,488,129,6271
15000US060373118022,728,134,51,38,33,31,18,23,677,136,290,120,387,124,6272
15000US060373200001,0,12,0,12,0,12,0,12,0,12,0,12,0,12,6273
15000US060373201001,617,85,39,33,9,14,30,30,578,88,167,69,411,85,6274
15000US060373201002,269,62,15,16,15,16,0,12,254,64,93,50,161,56,6275
15000US060373201003,546,90,118,68,62,48,56,53,428,89,77,48,351,94,6276
15000US060373201004,308,75,39,41,8,12,31,38,269,75,98,59,171,56,6277
15000US060373202011,385,94,92,69,40,43,52,55,293,97,56,50,237,108,6278
15000US060373202012,454,103,76,59,32,47,44,37,378,110,153,81,225,90,6279
15000US060373202013,273,105,62,53,0,12,62,53,211,97,31,28,180,99,6280
15000US060373202021,521,101,35,24,28,23,7,10,486,100,38,25,448,102,6281
15000US060373202022,473,90,24,39,24,39,0,12,449,91,81,47,368,95,6282
15000US060373202023,223,71,24,38,0,12,24,38,199,69,88,60,111,56,6283
15000US060373202024,263,82,41,44,20,31,21,32,222,82,41,44,181,80,6284
15000US060373203001,577,99,15,17,0,12,15,17,562,104,165,78,397,85,6285
15000US060373203002,257,78,63,59,51,56,12,18,194,80,65,56,129,66,6286
15000US060373203003,205,84,70,54,25,40,45,37,135,67,39,27,96,64,6287
15000US060373203004,149,50,40,34,22,35,18,16,109,45,0,12,109,45,6288
15000US060373203005,165,55,19,18,0,12,19,18,146,55,30,22,116,56,6289
15000US060373203006,383,94,51,45,28,24,23,37,332,94,38,39,294,93,6290
15000US060374002041,1020,113,0,12,0,12,0,12,1020,113,127,55,893,128,6291
15000US060374002042,469,104,0,12,0,12,0,12,469,104,107,63,362,111,6292
15000US060374002043,608,106,0,12,0,12,0,12,608,106,123,97,485,100,6293
15000US060374002051,974,75,9,14,0,12,9,14,965,76,199,68,766,80,6294
15000US060374002061,949,76,0,12,0,12,0,12,949,76,130,53,819,95,6295
15000US060374002062,879,82,0,12,0,12,0,12,879,82,199,70,680,91,6296
15000US060374002071,400,72,5,10,0,12,5,10,395,71,78,38,317,77,6297
15000US060374002072,699,81,0,12,0,12,0,12,699,81,180,61,519,80,6298
15000US060374002073,410,66,17,19,10,15,7,11,393,68,95,55,298,70,6299
15000US060374002074,0,12,0,12,0,12,0,12,0,12,0,12,0,12,6300
15000US060374003021,443,65,15,29,0,12,15,29,428,73,106,47,322,75,6301
15000US060374003022,694,78,45,37,18,20,27,33,649,84,191,64,458,87,6302
15000US060374003041,775,112,14,23,14,23,0,12,761,115,293,112,468,128,6303
15000US060374003042,543,135,16,26,16,26,0,12,527,137,105,58,422,140,6304
15000US060374003043,432,118,0,12,0,12,0,12,432,118,194,118,238,103,6305
15000US060374003044,735,156,14,22,0,12,14,22,721,157,124,75,597,178,6306
15000US060374004021,836,72,11,15,11,15,0,12,825,68,144,62,681,86,6307
15000US060374004022,572,71,48,33,0,12,48,33,524,76,120,50,404,78,6308
15000US060374004031,632,81,8,13,0,12,8,13,624,80,122,51,502,81,6309
15000US060374004032,754,73,24,24,24,24,0,12,730,78,74,39,656,80,6310
15000US060374004041,582,82,31,29,31,29,0,12,551,84,131,63,420,86,6311
15000US060374004042,369,67,0,12,0,12,0,12,369,67,73,53,296,67,6312
15000US060374004043,445,73,0,12,0,12,0,12,445,73,56,31,389,80,6313
15000US060374005011,706,26,20,16,8,11,12,13,686,28,150,44,536,47,6314
15000US060374006021,341,68,0,12,0,12,0,12,341,68,86,48,255,65,6315
15000US060374006022,476,94,21,28,12,18,9,18,455,97,71,39,384,98,6316
15000US060374006023,465,83,33,43,0,12,33,43,432,78,155,54,277,83,6317
15000US060374006031,1251,109,61,37,29,31,32,25,1190,107,212,71,978,104,6318
15000US060374006032,489,71,10,16,0,12,10,16,479,71,42,27,437,71,6319
15000US060374006041,478,73,0,12,0,12,0,12,478,73,73,43,405,75,6320
15000US060374006042,545,89,55,56,54,53,1,14,490,89,56,33,434,87,6321
15000US060374008001,930,90,39,25,11,12,28,22,891,91,230,58,661,85,6322
15000US060374009001,242,51,12,19,12,19,0,12,230,53,20,21,210,57,6323
15000US060374009002,706,87,54,45,40,43,14,21,652,91,174,63,478,96,6324
15000US060374009003,445,86,0,12,0,12,0,12,445,86,116,58,329,84,6325
15000US060374010011,446,68,0,12,0,12,0,12,446,68,124,55,322,68,6326
15000US060374010012,226,61,3,7,0,12,3,7,223,61,7,11,216,63,6327
15000US060374010013,346,60,0,12,0,12,0,12,346,60,75,39,271,68,6328
15000US060374010021,279,59,15,20,0,12,15,20,264,59,58,35,206,55,6329
15000US060374010022,741,93,36,27,31,24,5,10,705,94,235,76,470,94,6330
15000US060374010023,594,99,0,12,0,12,0,12,594,99,117,64,477,98,6331
15000US060374011011,261,80,0,12,0,12,0,12,261,80,67,56,194,73,6332
15000US060374011012,575,135,106,88,0,12,106,88,469,140,132,88,337,126,6333
15000US060374011013,381,137,34,54,0,12,34,54,347,129,76,68,271,119,6334
15000US060374011014,763,152,132,102,48,48,84,91,631,163,186,93,445,151,6335
15000US060374011021,380,66,39,37,11,16,28,32,341,72,108,49,233,75,6336
15000US060374011022,434,97,14,21,14,21,0,12,420,102,51,29,369,103,6337
15000US060374011023,234,61,45,40,23,25,22,30,189,59,33,30,156,56,6338
15000US060374012011,515,74,44,52,44,52,0,12,471,77,104,46,367,83,6339
15000US060374012012,507,67,56,41,32,34,24,26,451,64,69,41,382,69,6340
15000US060374012021,391,67,0,12,0,12,0,12,391,67,69,33,322,76,6341
15000US060374012022,350,54,8,13,8,13,0,12,342,55,70,41,272,68,6342
15000US060374012023,613,63,59,39,40,39,19,23,554,72,183,65,371,77,6343
15000US060374012031,712,95,53,35,22,21,31,31,659,92,259,87,400,89,6344
15000US060374012032,975,89,52,58,47,55,5,9,923,89,276,79,647,112,6345
15000US060374013031,797,33,26,26,0,12,26,26,771,38,137,50,634,58,6346
15000US060374013041,988,112,21,31,21,31,0,12,967,118,201,89,766,134,6347
15000US060374013042,113,97,0,12,0,12,0,12,113,97,0,12,113,97,6348
15000US060374013043,623,116,0,12,0,12,0,12,623,116,136,77,487,129,6349
15000US060374013044,298,86,0,12,0,12,0,12,298,86,53,46,245,87,6350
15000US060374013111,597,142,16,25,16,25,0,12,581,144,198,114,383,144,6351
15000US060374013112,552,138,39,60,0,12,39,60,513,135,79,60,434,119,6352
15000US060374013113,531,139,42,46,0,12,42,46,489,146,91,56,398,155,6353
15000US060374013114,589,177,0,12,0,12,0,12,589,177,120,73,469,188,6354
15000US060374013121,1071,155,0,12,0,12,0,12,1071,155,384,150,687,157,6355
15000US060374013122,879,124,13,22,13,22,0,12,866,120,284,111,582,107,6356
15000US060374015001,881,105,37,39,15,18,22,35,844,114,301,93,543,120,6357
15000US060374015002,602,87,93,56,84,55,9,14,509,91,117,51,392,92,6358
15000US060374015003,307,83,47,48,10,16,37,46,260,87,56,46,204,80,6359
15000US060374016011,467,113,0,12,0,12,0,12,467,113,326,116,141,67,6360
15000US060374016012,969,127,58,38,31,28,27,32,911,130,260,86,651,123,6361
15000US060374016013,652,124,19,29,19,29,0,12,633,127,87,55,546,133,6362
15000US060374016021,1007,111,117,76,93,69,24,38,890,119,244,86,646,110,6363
15000US060374016022,438,75,13,21,0,12,13,21,425,77,75,37,350,80,6364
15000US060374016023,450,81,27,24,17,19,10,14,423,84,137,66,286,84,6365
15000US060374016031,661,77,9,17,0,12,9,17,652,79,163,60,489,91,6366
15000US060374016032,592,88,26,26,18,20,8,16,566,90,203,81,363,98,6367
15000US060374017011,508,84,54,46,31,37,23,28,454,89,112,47,342,82,6368
15000US060374017012,1219,85,68,49,20,22,48,44,1151,90,268,92,883,114,6369
15000US060374017031,829,105,104,62,31,26,73,58,725,106,107,70,618,119,6370
15000US060374017032,667,101,80,54,24,21,56,55,587,95,103,52,484,107,6371
15000US060374017041,559,90,132,85,32,45,100,76,427,104,97,51,330,96,6372
15000US060374017042,353,83,43,43,15,17,28,39,310,75,79,50,231,75,6373
15000US060374017043,960,104,56,50,43,47,13,16,904,110,327,90,577,96,6374
15000US060374018001,859,130,22,36,22,36,0,12,837,127,145,69,692,133,6375
15000US060374018002,905,144,11,18,0,12,11,18,894,147,166,100,728,146,6376
15000US060374018003,968,132,0,12,0,12,0,12,968,132,156,71,812,141,6377
15000US060374019011,87,25,13,20,13,20,0,12,74,18,9,9,65,17,6378
15000US060374019012,17,9,0,12,0,12,0,12,17,9,4,6,13,10,6379
15000US060374019021,554,134,0,12,0,12,0,12,554,134,38,34,516,134,6380
15000US060374019022,1044,157,28,44,0,12,28,44,1016,164,211,104,805,130,6381
15000US060374019023,474,94,0,12,0,12,0,12,474,94,44,39,430,97,6382
15000US060374019024,571,113,0,12,0,12,0,12,571,113,14,22,557,116,6383
15000US060374020011,683,92,133,72,10,18,123,80,550,96,105,52,445,92,6384
15000US060374020012,416,85,57,47,16,24,41,39,359,98,75,47,284,96,6385
15000US060374020021,581,97,32,47,3,7,29,47,549,92,194,93,355,75,6386
15000US060374020022,493,98,82,46,61,39,21,24,411,106,30,27,381,108,6387
15000US060374020023,505,82,8,13,0,12,8,13,497,82,136,78,361,87,6388
15000US060374021011,506,79,10,14,5,12,5,9,496,78,128,54,368,78,6389
15000US060374021012,279,87,42,42,42,42,0,12,237,77,58,43,179,75,6390
15000US060374021013,294,66,0,12,0,12,0,12,294,66,155,58,139,60,6391
15000US060374021021,626,107,25,29,20,28,5,10,601,110,187,77,414,95,6392
15000US060374021022,507,98,91,58,74,51,17,23,416,90,80,48,336,82,6393
15000US060374021023,140,51,46,36,28,27,18,27,94,46,42,40,52,31,6394
15000US060374022001,723,112,67,60,20,29,47,55,656,123,102,57,554,124,6395
15000US060374022002,651,139,161,104,23,28,138,99,490,125,65,52,425,125,6396
15000US060374022003,683,120,0,12,0,12,0,12,683,120,250,107,433,104,6397
15000US060374023011,735,89,172,67,55,43,117,56,563,98,125,44,438,95,6398
15000US060374023012,609,90,128,68,6,14,122,68,481,85,78,41,403,81,6399
15000US060374023031,359,81,24,19,9,14,15,18,335,84,67,43,268,82,6400
15000US060374023032,265,56,55,34,23,29,32,23,210,54,50,36,160,51,6401
15000US060374023033,247,64,30,21,19,19,11,15,217,67,36,30,181,66,6402
15000US060374023034,242,64,32,28,11,16,21,25,210,68,47,35,163,71,6403
15000US060374023041,565,57,205,59,53,32,152,56,360,67,51,33,309,61,6404
15000US060374023042,380,61,76,39,25,22,51,33,304,62,68,30,236,59,6405
15000US060374024021,240,84,43,41,29,32,14,25,197,87,71,82,126,80,6406
15000US060374024022,303,123,12,23,0,12,12,23,291,117,74,82,217,138,6407
15000US060374024023,627,137,105,64,21,32,84,61,522,149,180,133,342,146,6408
15000US060374024024,759,135,42,55,0,12,42,55,717,144,87,81,630,153,6409
15000US060374024031,180,56,15,24,0,12,15,24,165,59,62,45,103,52,6410
15000US060374024032,793,83,61,50,11,13,50,49,732,87,230,81,502,87,6411
15000US060374024041,4,6,0,12,0,12,0,12,4,6,0,12,4,6,6412
15000US060374024051,202,43,17,16,9,11,8,12,185,44,67,35,118,47,6413
15000US060374024052,150,45,16,22,0,12,16,22,134,41,23,19,111,44,6414
15000US060374024053,295,48,29,19,12,13,17,15,266,46,117,43,149,50,6415
15000US060374024061,499,80,191,79,31,27,160,77,308,81,100,55,208,76,6416
15000US060374024062,688,92,73,54,21,30,52,41,615,102,170,70,445,92,6417
15000US060374025011,629,91,188,76,25,27,163,75,441,106,70,45,371,105,6418
15000US060374025012,683,73,221,70,51,39,170,64,462,90,36,30,426,97,6419
15000US060374025021,295,81,115,62,19,20,96,59,180,72,18,20,162,72,6420
15000US060374025022,1395,111,231,75,88,47,143,65,1164,135,309,106,855,156,6421
15000US060374026001,134,73,0,12,0,12,0,12,134,73,14,23,120,82,6422
15000US060374026002,601,173,64,52,17,28,47,43,537,177,207,135,330,157,6423
15000US060374026003,583,152,44,41,0,12,44,41,539,153,188,128,351,132,6424
15000US060374026004,731,159,29,32,14,23,15,23,702,162,139,63,563,170,6425
15000US060374026005,405,89,14,23,14,23,0,12,391,90,157,68,234,92,6426
15000US060374027021,648,83,210,57,69,42,141,53,438,90,115,60,323,91,6427
15000US060374027022,268,72,59,40,8,12,51,37,209,69,67,37,142,66,6428
15000US060374027023,201,71,45,40,32,35,13,21,156,64,24,26,132,57,6429
15000US060374027024,448,77,161,69,63,51,98,48,287,69,113,56,174,68,6430
15000US060374027031,651,91,137,69,38,42,99,56,514,90,101,51,413,86,6431
15000US060374027032,621,84,11,17,0,12,11,17,610,85,84,44,526,86,6432
15000US060374027051,292,45,15,12,10,11,5,9,277,44,99,41,178,45,6433
15000US060374027052,560,50,21,15,13,11,8,11,539,53,137,35,402,59,6434
15000US060374027061,408,60,78,43,4,6,74,42,330,58,52,23,278,60,6435
15000US060374027062,270,59,17,21,4,6,13,20,253,63,25,23,228,62,6436
15000US060374027063,289,66,52,37,12,19,40,30,237,59,36,26,201,57,6437
15000US060374028011,564,92,250,95,105,80,145,93,314,102,41,31,273,107,6438
15000US060374028012,293,55,69,42,40,29,29,28,224,59,45,33,179,65,6439
15000US060374028013,278,78,88,60,53,50,35,34,190,65,30,25,160,64,6440
15000US060374028031,298,44,77,33,18,19,59,31,221,45,50,29,171,46,6441
15000US060374028032,416,45,90,43,0,12,90,43,326,51,86,35,240,50,6442
15000US060374028041,368,55,142,52,28,23,114,46,226,57,98,48,128,48,6443
15000US060374028042,569,51,97,39,36,24,61,34,472,55,66,31,406,58,6444
15000US060374029021,666,84,108,55,25,31,83,51,558,86,124,50,434,88,6445
15000US060374029022,768,90,215,77,75,56,140,65,553,91,176,66,377,87,6446
15000US060374029031,993,28,216,64,71,46,145,61,777,69,231,72,546,91,6447
15000US060374029041,298,49,47,39,5,9,42,37,251,53,91,35,160,43,6448
15000US060374029042,504,48,68,30,46,24,22,20,436,52,99,50,337,66,6449
15000US060374030001,684,115,105,54,57,43,48,44,579,122,99,52,480,117,6450
15000US060374030002,295,87,63,52,40,36,23,35,232,80,148,77,84,51,6451
15000US060374030003,527,101,78,81,36,51,42,62,449,89,99,54,350,81,6452
15000US060374032001,0,12,0,12,0,12,0,12,0,12,0,12,0,12,6453
15000US060374033031,773,37,14,15,6,9,8,12,759,39,140,44,619,47,6454
15000US060374033041,752,92,20,24,0,12,20,24,732,93,185,63,547,97,6455
15000US060374033042,897,76,0,12,0,12,0,12,897,76,162,59,735,102,6456
15000US060374033051,708,31,14,12,7,11,7,10,694,34,99,37,595,50,6457
15000US060374033121,649,88,30,22,17,15,13,17,619,90,124,53,495,99,6458
15000US060374033122,562,101,11,16,11,16,0,12,551,102,166,64,385,91,6459
15000US060374033123,358,71,0,12,0,12,0,12,358,71,75,37,283,76,6460
15000US060374033161,815,133,86,60,33,36,53,45,729,136,258,104,471,134,6461
15000US060374033162,953,131,33,46,0,12,33,46,920,131,235,116,685,137,6462
15000US060374033163,588,119,5,15,5,15,0,12,583,121,130,63,453,132,6463
15000US060374033171,867,113,25,36,6,10,19,33,842,112,163,66,679,122,6464
15000US060374033172,343,105,8,13,0,12,8,13,335,106,61,50,274,100,6465
15000US060374033173,202,70,0,12,0,12,0,12,202,70,66,58,136,48,6466
15000US060374033181,360,67,0,12,0,12,0,12,360,67,50,33,310,75,6467
15000US060374033182,709,85,35,33,0,12,35,33,674,87,107,58,567,85,6468
15000US060374033183,575,68,7,12,0,12,7,12,568,67,85,35,483,79,6469
15000US060374033184,330,69,0,12,0,12,0,12,330,69,37,25,293,74,6470
15000US060374033191,603,82,6,10,0,12,6,10,597,82,74,40,523,91,6471
15000US060374033192,953,97,42,32,10,16,32,28,911,100,129,58,782,110,6472
15000US060374033201,798,81,78,60,8,13,70,58,720,89,115,43,605,95,6473
15000US060374033202,856,92,24,30,0,12,24,30,832,90,167,68,665,96,6474
15000US060374033211,948,87,10,15,0,12,10,15,938,87,245,88,693,107,6475
15000US060374033212,603,85,51,45,6,13,45,43,552,83,100,42,452,87,6476
15000US060374033213,336,65,4,9,0,12,4,9,332,66,9,14,323,66,6477
15000US060374033221,634,96,0,12,0,12,0,12,634,96,126,58,508,102,6478
15000US060374033222,607,94,0,12,0,12,0,12,607,94,55,33,552,93,6479
15000US060374033231,605,79,0,12,0,12,0,12,605,79,52,31,553,78,6480
15000US060374033232,604,73,0,12,0,12,0,12,604,73,122,59,482,81,6481
15000US060374033233,550,71,0,12,0,12,0,12,550,71,71,42,479,83,6482
15000US060374033241,314,72,0,12,0,12,0,12,314,72,43,33,271,76,6483
15000US060374033242,649,122,0,12,0,12,0,12,649,122,66,57,583,121,6484
15000US060374033243,737,143,109,92,40,42,69,74,628,111,144,83,484,115,6485
15000US060374033244,297,85,0,12,0,12,0,12,297,85,47,48,250,86,6486
15000US060374033251,941,95,0,12,0,12,0,12,941,95,122,62,819,99,6487
15000US060374033252,376,75,0,12,0,12,0,12,376,75,65,48,311,74,6488
15000US060374033253,221,70,7,11,7,11,0,12,214,71,8,12,206,70,6489
15000US060374034011,412,76,26,22,0,12,26,22,386,78,87,54,299,81,6490
15000US060374034012,398,77,39,34,23,25,16,23,359,75,43,34,316,80,6491
15000US060374034013,804,94,19,21,8,13,11,16,785,96,98,45,687,101,6492
15000US060374034021,673,56,14,12,4,7,10,13,659,58,117,35,542,65,6493
15000US060374034022,334,50,7,11,0,12,7,11,327,51,71,34,256,60,6494
15000US060374034031,590,71,0,12,0,12,0,12,590,71,67,38,523,73,6495
15000US060374034032,482,73,0,12,0,12,0,12,482,73,79,57,403,61,6496
15000US060374034033,434,92,0,12,0,12,0,12,434,92,49,31,385,95,6497
15000US060374034041,310,40,0,12,0,12,0,12,310,40,51,25,259,40,6498
15000US060374034042,466,39,0,12,0,12,0,12,466,39,95,39,371,53,6499
15000US060374034051,530,22,0,12,0,12,0,12,530,22,102,32,428,38,6500
15000US060374034061,903,53,11,12,0,12,11,12,892,54,144,54,748,69,6501
15000US060374034071,281,52,0,12,0,12,0,12,281,52,60,35,221,52,6502
15000US060374034072,406,47,0,12,0,12,0,12,406,47,24,33,382,59,6503
15000US060374034081,250,59,0,12,0,12,0,12,250,59,32,30,218,64,6504
15000US060374034082,324,71,0,12,0,12,0,12,324,71,45,33,279,79,6505
15000US060374034083,712,76,7,13,0,12,7,13,705,77,289,86,416,91,6506
15000US060374034084,371,63,56,52,12,22,44,62,315,75,41,34,274,76,6507
15000US060374034085,320,66,0,12,0,12,0,12,320,66,86,53,234,70,6508
15000US060374035001,586,29,5,9,0,12,5,9,581,29,231,51,350,54,6509
15000US060374036001,849,142,83,85,25,40,58,82,766,146,223,130,543,122,6510
15000US060374036002,186,89,0,12,0,12,0,12,186,89,35,33,151,87,6511
15000US060374036003,466,101,12,22,12,22,0,12,454,104,111,53,343,110,6512
15000US060374036004,730,157,54,56,0,12,54,56,676,164,151,85,525,137,6513
15000US060374037021,436,72,0,12,0,12,0,12,436,72,139,56,297,70,6514
15000US060374037022,647,68,11,17,11,17,0,12,636,67,184,54,452,66,6515
15000US060374037031,604,90,29,36,22,34,7,11,575,96,147,62,428,93,6516
15000US060374037032,707,95,0,12,0,12,0,12,707,95,159,56,548,92,6517
15000US060374037033,206,46,0,12,0,12,0,12,206,46,28,22,178,52,6518
15000US060374037211,408,87,55,47,14,24,41,42,353,79,55,39,298,90,6519
15000US060374037212,653,100,0,12,0,12,0,12,653,100,147,67,506,110,6520
15000US060374037213,312,91,16,23,16,23,0,12,296,92,53,40,243,91,6521
15000US060374037214,222,70,8,13,0,12,8,13,214,69,6,11,208,69,6522
15000US060374037221,705,93,196,70,44,32,152,67,509,104,75,46,434,95,6523
15000US060374037222,197,55,9,15,9,15,0,12,188,56,33,32,155,54,6524
15000US060374037223,773,107,89,51,18,19,71,48,684,103,222,85,462,98,6525
15000US060374038011,917,103,117,68,44,47,73,55,800,102,178,82,622,116,6526
15000US060374038012,495,93,58,43,0,12,58,43,437,88,109,46,328,97,6527
15000US060374038013,203,62,8,13,8,13,0,12,195,62,57,52,138,63,6528
15000US060374038014,333,68,32,38,0,12,32,38,301,75,97,57,204,80,6529
15000US060374038021,556,107,90,58,11,13,79,57,466,97,85,34,381,96,6530
15000US060374038022,318,70,40,41,10,16,30,37,278,62,113,50,165,52,6531
15000US060374038023,1019,121,41,28,23,22,18,23,978,119,155,65,823,133,6532
15000US060374039011,272,46,0,12,0,12,0,12,272,46,85,38,187,52,6533
15000US060374039012,358,57,27,32,27,32,0,12,331,62,90,52,241,58,6534
15000US060374039013,307,50,6,9,6,9,0,12,301,50,113,45,188,52,6535
15000US060374039021,700,125,18,26,18,26,0,12,682,124,151,58,531,117,6536
15000US060374039022,194,61,11,16,11,16,0,12,183,63,31,29,152,59,6537
15000US060374039023,557,110,25,33,16,22,9,24,532,116,147,71,385,110,6538
15000US060374040001,174,43,14,21,0,12,14,21,160,44,55,31,105,43,6539
15000US060374040002,342,63,0,12,0,12,0,12,342,63,114,42,228,77,6540
15000US060374040003,229,68,26,33,0,12,26,33,203,67,60,31,143,68,6541
15000US060374040004,595,87,54,34,25,30,29,27,541,87,140,69,401,89,6542
15000US060374041001,210,65,21,23,21,23,0,12,189,63,36,27,153,69,6543
15000US060374041002,367,82,97,66,29,34,68,49,270,83,52,40,218,79,6544
15000US060374041003,608,100,86,60,0,12,86,60,522,112,118,60,404,107,6545
15000US060374041004,250,85,20,28,0,12,20,28,230,80,25,28,205,79,6546
15000US060374042011,590,81,203,81,26,30,177,79,387,91,84,43,303,92,6547
15000US060374042012,402,73,14,16,7,11,7,12,388,73,73,37,315,77,6548
15000US060374042021,367,43,30,23,0,12,30,23,337,41,43,24,294,43,6549
15000US060374042022,362,46,13,13,0,12,13,13,349,49,46,21,303,50,6550
15000US060374043011,429,82,55,43,31,28,24,33,374,91,83,42,291,93,6551
15000US060374043012,302,65,23,14,14,13,9,13,279,66,82,38,197,68,6552
15000US060374043013,372,91,53,50,0,12,53,50,319,87,49,29,270,87,6553
15000US060374043014,338,73,30,29,22,24,8,15,308,76,49,42,259,72,6554
15000US060374043021,396,49,16,15,0,12,16,15,380,49,47,24,333,52,6555
15000US060374043022,197,42,11,12,6,9,5,7,186,40,48,27,138,43,6556
15000US060374044011,285,63,18,24,0,12,18,24,267,69,44,22,223,67,6557
15000US060374044012,377,62,49,31,7,8,42,30,328,63,43,23,285,66,6558
15000US060374044013,302,53,14,13,8,9,6,10,288,51,90,28,198,56,6559
15000US060374044021,416,83,0,12,0,12,0,12,416,83,68,40,348,85,6560
15000US060374044022,314,68,6,9,6,9,0,12,308,69,62,48,246,78,6561
15000US060374044023,176,71,0,12,0,12,0,12,176,71,36,25,140,70,6562
15000US060374044024,195,60,17,26,0,12,17,26,178,54,8,10,170,55,6563
15000US060374045011,620,36,58,34,12,12,46,30,562,46,98,34,464,55,6564
15000US060374045031,698,51,20,18,15,16,5,8,678,53,117,38,561,56,6565
15000US060374045041,754,90,99,58,9,14,90,58,655,96,80,41,575,104,6566
15000US060374045042,583,88,58,46,9,13,49,44,525,96,166,72,359,89,6567
15000US060374046001,305,32,23,12,14,11,9,6,282,32,82,21,200,31,6568
15000US060374046002,65,20,0,12,0,12,0,12,65,20,29,18,36,19,6569
15000US060374047011,673,97,59,51,23,35,36,33,614,109,110,65,504,112,6570
15000US060374047012,300,70,62,34,25,19,37,33,238,75,61,46,177,63,6571
15000US060374047013,187,71,11,17,0,12,11,17,176,72,73,51,103,62,6572
15000US060374047014,160,55,23,30,23,30,0,12,137,56,27,22,110,55,6573
15000US060374047021,573,83,152,64,85,46,67,51,421,103,52,45,369,100,6574
15000US060374047022,465,75,88,51,44,39,44,43,377,81,62,35,315,89,6575
15000US060374047023,240,70,9,15,9,15,0,12,231,70,62,38,169,62,6576
15000US060374047031,124,39,48,30,11,17,37,26,76,36,32,30,44,34,6577
15000US060374047032,643,57,110,40,19,15,91,38,533,62,94,34,439,64,6578
15000US060374048011,461,88,58,47,33,35,25,30,403,97,24,21,379,97,6579
15000US060374048012,402,93,43,29,12,19,31,29,359,92,76,48,283,95,6580
15000US060374048013,507,82,38,41,21,31,17,27,469,82,89,51,380,97,6581
15000US060374048014,482,75,40,31,21,23,19,21,442,80,123,67,319,81,6582
15000US060374048021,623,120,45,48,6,14,39,50,578,118,178,74,400,134,6583
15000US060374048022,412,96,118,90,6,13,112,92,294,101,83,78,211,95,6584
15000US060374048031,445,28,50,26,39,26,11,13,395,36,78,38,317,42,6585
15000US060374049011,314,75,23,24,11,17,12,19,291,80,72,56,219,83,6586
15000US060374049012,530,103,35,31,26,28,9,14,495,107,90,58,405,104,6587
15000US060374049013,459,86,41,31,20,23,21,23,418,88,83,53,335,96,6588
15000US060374049021,390,53,50,36,25,23,25,27,340,56,68,29,272,56,6589
15000US060374049022,547,61,16,12,5,7,11,13,531,60,140,48,391,65,6590
15000US060374049031,237,49,15,16,0,12,15,16,222,50,39,25,183,52,6591
15000US060374049032,437,60,20,18,0,12,20,18,417,61,127,46,290,58,6592
15000US060374050011,768,83,39,40,0,12,39,40,729,92,220,82,509,95,6593
15000US060374050012,293,62,24,26,0,12,24,26,269,59,99,44,170,60,6594
15000US060374050013,282,69,19,20,0,12,19,20,263,67,70,52,193,59,6595
15000US060374050021,457,41,51,31,16,15,35,26,406,50,69,33,337,60,6596
15000US060374050022,214,42,14,12,10,11,4,6,200,43,58,29,142,43,6597
15000US060374051011,601,97,53,45,41,40,12,19,548,102,118,75,430,107,6598
15000US060374051012,428,87,104,67,43,46,61,56,324,92,35,29,289,90,6599
15000US060374051013,135,52,15,13,0,12,15,13,120,52,36,30,84,46,6600
15000US060374051021,719,83,64,45,8,13,56,43,655,88,177,74,478,96,6601
15000US060374051022,535,89,103,65,22,35,81,57,432,97,71,38,361,93,6602
15000US060374052011,392,88,35,44,7,11,28,43,357,92,133,66,224,77,6603
15000US060374052012,475,92,13,15,6,10,7,11,462,92,122,65,340,82,6604
15000US060374052013,419,99,127,72,12,17,115,72,292,88,45,34,247,85,6605
15000US060374052021,342,91,95,67,21,34,74,57,247,88,18,29,229,85,6606
15000US060374052022,883,94,88,57,6,8,82,57,795,94,191,70,604,104,6607
15000US060374052031,812,44,55,30,32,22,23,19,757,49,128,48,629,72,6608
15000US060374053011,524,85,37,35,8,13,29,33,487,88,127,71,360,85,6609
15000US060374053012,477,80,27,43,27,43,0,12,450,79,40,27,410,82,6610
15000US060374053021,380,85,0,12,0,12,0,12,380,85,63,37,317,83,6611
15000US060374053022,365,94,77,63,0,12,77,63,288,86,100,72,188,77,6612
15000US060374053023,195,72,0,12,0,12,0,12,195,72,66,42,129,72,6613
15000US060374053024,460,89,76,65,9,15,67,63,384,98,84,59,300,97,6614
15000US060374053025,143,40,5,8,0,12,5,8,138,41,33,34,105,39,6615
15000US060374054001,341,92,3,7,0,12,3,7,338,93,101,64,237,92,6616
15000US060374054002,399,91,40,45,0,12,40,45,359,82,61,58,298,83,6617
15000US060374054003,225,60,20,23,20,23,0,12,205,59,42,31,163,59,6618
15000US060374054004,340,89,14,20,11,18,3,8,326,96,70,56,256,84,6619
15000US060374055001,149,66,0,12,0,12,0,12,149,66,73,48,76,56,6620
15000US060374055002,444,94,61,55,20,30,41,45,383,84,103,51,280,89,6621
15000US060374055003,390,80,33,25,0,12,33,25,357,80,108,64,249,80,6622
15000US060374055004,267,69,10,15,10,15,0,12,257,70,100,42,157,71,6623
15000US060374055005,357,70,9,13,0,12,9,13,348,72,96,44,252,74,6624
15000US060374055006,316,80,19,31,0,12,19,31,297,74,72,40,225,75,6625
15000US060374056001,489,92,21,23,13,20,8,13,468,94,159,66,309,82,6626
15000US060374056002,291,64,0,12,0,12,0,12,291,64,55,35,236,67,6627
15000US060374056003,301,80,0,12,0,12,0,12,301,80,48,33,253,85,6628
15000US060374056004,207,62,10,15,10,15,0,12,197,62,61,58,136,52,6629
15000US060374056005,329,71,4,8,4,8,0,12,325,71,66,44,259,68,6630
15000US060374057011,356,72,9,15,0,12,9,15,347,72,97,36,250,70,6631
15000US060374057012,355,73,15,18,0,12,15,18,340,72,31,31,309,77,6632
15000US060374057013,341,66,11,19,11,19,0,12,330,61,95,60,235,67,6633
15000US060374057021,515,107,44,51,0,12,44,51,471,112,75,40,396,107,6634
15000US060374057022,949,106,89,72,39,49,50,53,860,116,155,65,705,111,6635
15000US060374058001,495,103,49,37,3,8,46,36,446,108,39,26,407,108,6636
15000US060374058002,508,91,27,25,18,20,9,13,481,94,131,65,350,106,6637
15000US060374058003,599,101,39,30,8,12,31,27,560,107,188,79,372,109,6638
15000US060374059001,563,79,56,35,28,23,28,25,507,83,81,44,426,87,6639
15000US060374059002,590,76,63,45,0,12,63,45,527,70,87,51,440,85,6640
15000US060374060001,467,75,53,36,31,34,22,27,414,81,92,50,322,82,6641
15000US060374060002,471,68,27,26,9,14,18,22,444,70,70,35,374,67,6642
15000US060374060003,276,59,0,12,0,12,0,12,276,59,71,50,205,43,6643
15000US060374060004,309,53,15,16,15,16,0,12,294,54,90,42,204,57,6644
15000US060374061011,326,73,11,17,0,12,11,17,315,76,77,36,238,76,6645
15000US060374061012,518,87,60,57,15,18,45,56,458,89,65,43,393,90,6646
15000US060374061013,310,73,21,22,0,12,21,22,289,71,96,55,193,61,6647
15000US060374061021,834,133,24,27,12,18,12,19,810,136,192,92,618,132,6648
15000US060374061022,227,75,32,37,32,37,0,12,195,72,36,36,159,67,6649
15000US060374061023,457,103,20,32,0,12,20,32,437,107,118,73,319,97,6650
15000US060374061024,584,125,58,48,13,21,45,43,526,112,120,58,406,110,6651
15000US060374062001,391,69,0,12,0,12,0,12,391,69,148,65,243,68,6652
15000US060374062002,661,106,154,85,18,21,136,82,507,96,147,51,360,99,6653
15000US060374062003,782,107,49,29,24,22,25,17,733,101,273,70,460,89,6654
15000US060374063001,632,91,9,16,9,16,0,12,623,96,123,47,500,107,6655
15000US060374063002,1048,101,20,20,6,9,14,17,1028,104,126,49,902,113,6656
15000US060374064021,220,36,0,12,0,12,0,12,220,36,63,27,157,43,6657
15000US060374064022,206,36,0,12,0,12,0,12,206,36,44,25,162,37,6658
15000US060374064023,171,33,12,16,0,12,12,16,159,35,29,23,130,37,6659
15000US060374064111,227,39,13,19,13,19,0,12,214,37,53,26,161,40,6660
15000US060374064112,292,41,23,18,13,10,10,15,269,44,119,44,150,45,6661
15000US060374064121,324,41,11,12,0,12,11,12,313,41,114,40,199,46,6662
15000US060374064122,444,48,0,12,0,12,0,12,444,48,152,44,292,42,6663
15000US060374065001,350,81,8,15,8,15,0,12,342,81,40,23,302,84,6664
15000US060374065002,535,98,56,57,0,12,56,57,479,90,157,70,322,92,6665
15000US060374065003,478,75,21,21,11,13,10,15,457,77,86,48,371,81,6666
15000US060374065004,197,53,10,15,0,12,10,15,187,52,0,12,187,52,6667
15000US060374065005,334,83,18,24,7,14,11,18,316,81,100,65,216,67,6668
15000US060374066011,537,55,24,21,7,12,17,18,513,60,158,62,355,70,6669
15000US060374066012,471,84,15,18,7,11,8,14,456,83,117,52,339,81,6670
15000US060374066013,440,71,0,12,0,12,0,12,440,71,152,59,288,71,6671
15000US060374066021,269,55,15,19,5,7,10,18,254,55,101,35,153,51,6672
15000US060374066022,198,64,6,10,6,10,0,12,192,66,66,37,126,62,6673
15000US060374066023,291,59,36,43,0,12,36,43,255,62,56,40,199,72,6674
15000US060374066024,527,95,112,72,60,58,52,46,415,83,168,72,247,66,6675
15000US060374067011,459,51,4,7,0,12,4,7,455,52,106,41,349,53,6676
15000US060374067012,262,39,52,45,7,10,45,43,210,37,35,22,175,38,6677
15000US060374067013,203,38,0,12,0,12,0,12,203,38,82,40,121,41,6678
15000US060374067021,322,68,18,26,18,26,0,12,304,75,34,38,270,79,6679
15000US060374067022,645,82,71,50,47,53,24,22,574,77,152,55,422,88,6680
15000US060374067023,470,77,35,29,6,10,29,26,435,78,88,47,347,75,6681
15000US060374067024,206,43,20,21,0,12,20,21,186,41,70,30,116,38,6682
15000US060374068001,293,66,5,8,5,8,0,12,288,67,63,43,225,65,6683
15000US060374068002,505,74,16,19,9,14,7,13,489,77,149,51,340,71,6684
15000US060374068003,517,75,93,54,7,13,86,55,424,72,129,67,295,72,6685
15000US060374069011,218,55,20,17,8,13,12,16,198,61,74,45,124,58,6686
15000US060374069012,497,91,49,46,19,23,30,47,448,90,119,58,329,93,6687
15000US060374069013,490,89,37,37,10,15,27,34,453,87,97,43,356,94,6688
15000US060374069021,470,62,27,18,6,9,21,16,443,68,213,60,230,71,6689
15000US060374069022,204,53,22,24,2,5,20,23,182,57,69,28,113,57,6690
15000US060374069023,170,39,9,10,0,12,9,10,161,39,57,30,104,41,6691
15000US060374070011,266,64,20,20,11,15,9,13,246,66,106,59,140,65,6692
15000US060374070012,425,78,80,51,17,23,63,44,345,77,115,57,230,67,6693
15000US060374070013,501,76,63,50,23,32,40,44,438,85,183,67,255,84,6694
15000US060374070021,447,47,26,27,5,8,21,24,421,47,131,46,290,58,6695
15000US060374070022,306,50,36,26,21,23,15,14,270,50,118,38,152,40,6696
15000US060374071011,230,82,88,80,35,47,53,61,142,69,54,52,88,53,6697
15000US060374071012,134,44,29,28,0,12,29,28,105,39,43,24,62,38,6698
15000US060374071013,256,60,50,42,33,36,17,19,206,59,68,40,138,62,6699
15000US060374071014,480,80,24,27,12,19,12,18,456,80,104,67,352,90,6700
15000US060374071021,338,80,7,11,0,12,7,11,331,81,63,43,268,94,6701
15000US060374071022,518,66,72,49,17,21,55,46,446,71,138,56,308,73,6702
15000US060374071023,334,67,0,12,0,12,0,12,334,67,101,54,233,72,6703
15000US060374072001,318,78,0,12,0,12,0,12,318,78,72,35,246,84,6704
15000US060374072002,366,97,78,64,45,52,33,41,288,82,59,36,229,79,6705
15000US060374072003,349,72,41,42,31,39,10,16,308,80,108,52,200,72,6706
15000US060374072004,207,60,22,34,22,34,0,12,185,65,40,30,145,61,6707
15000US060374072005,262,64,38,26,8,12,30,23,224,65,91,62,133,59,6708
15000US060374073011,329,79,30,31,30,31,0,12,299,79,139,59,160,78,6709
15000US060374073012,295,63,25,30,25,30,0,12,270,69,46,36,224,72,6710
15000US060374073013,216,52,0,12,0,12,0,12,216,52,94,43,122,60,6711
15000US060374073014,255,64,39,39,13,20,26,32,216,61,76,68,140,67,6712
15000US060374073021,334,58,52,32,31,34,21,28,282,56,99,42,183,59,6713
15000US060374073022,166,41,21,22,0,12,21,22,145,43,43,25,102,35,6714
15000US060374073023,254,48,33,29,30,28,3,5,221,51,94,40,127,43,6715
15000US060374074001,553,17,14,13,3,4,11,12,539,21,164,47,375,48,6716
15000US060374075011,507,62,54,31,29,26,25,19,453,66,134,48,319,70,6717
15000US060374075012,262,48,26,26,21,26,5,8,236,47,60,35,176,43,6718
15000US060374075013,227,48,49,34,12,14,37,31,178,43,45,25,133,39,6719
15000US060374075021,280,53,32,24,0,12,32,24,248,53,72,40,176,46,6720
15000US060374075022,323,47,52,29,0,12,52,29,271,52,49,31,222,51,6721
15000US060374075023,251,46,13,21,13,21,0,12,238,46,51,27,187,52,6722
15000US060374076011,404,71,57,45,40,42,17,21,347,71,134,60,213,68,6723
15000US060374076012,404,76,76,49,12,21,64,45,328,73,68,41,260,81,6724
15000US060374076013,240,57,22,24,0,12,22,24,218,56,58,41,160,72,6725
15000US060374076021,267,54,36,28,3,5,33,29,231,54,85,36,146,50,6726
15000US060374076022,221,51,43,29,4,6,39,27,178,56,70,34,108,49,6727
15000US060374076023,179,51,11,12,11,12,0,12,168,51,32,20,136,49,6728
15000US060374076024,222,51,38,25,5,8,33,23,184,58,65,38,119,51,6729
15000US060374077011,476,87,123,66,8,14,115,66,353,83,166,70,187,71,6730
15000US060374077012,392,72,46,45,20,24,26,38,346,71,123,44,223,73,6731
15000US060374077013,252,71,43,46,21,32,22,31,209,73,110,58,99,54,6732
15000US060374077021,792,101,49,32,41,29,8,12,743,102,73,48,670,96,6733
15000US060374077022,404,81,80,45,16,19,64,43,324,79,134,56,190,74,6734
15000US060374077023,354,75,45,34,15,18,30,33,309,68,77,35,232,68,6735
15000US060374078011,279,56,27,24,16,18,11,17,252,52,80,36,172,59,6736
15000US060374078012,459,68,69,50,33,35,36,35,390,69,144,58,246,75,6737
15000US060374078013,371,58,49,44,31,35,18,27,322,60,153,54,169,56,6738
15000US060374078021,452,58,6,8,1,3,5,7,446,57,174,49,272,57,6739
15000US060374078022,362,55,11,11,5,7,6,8,351,56,87,33,264,59,6740
15000US060374079001,1226,83,79,54,15,19,64,52,1147,96,333,96,814,117,6741
15000US060374079002,259,65,32,36,9,14,23,33,227,61,60,40,167,54,6742
15000US060374080031,473,87,33,30,9,14,24,26,440,80,199,92,241,91,6743
15000US060374080032,713,81,23,26,23,26,0,12,690,86,125,57,565,96,6744
15000US060374080041,862,43,45,35,28,24,17,23,817,49,117,44,700,60,6745
15000US060374080051,434,75,0,12,0,12,0,12,434,75,97,43,337,84,6746
15000US060374080052,514,76,11,16,0,12,11,16,503,79,143,57,360,88,6747
15000US060374080053,552,87,35,30,0,12,35,30,517,88,62,41,455,89,6748
15000US060374080061,1027,73,96,69,17,20,79,64,931,92,156,78,775,115,6749
15000US060374081331,367,76,8,14,8,14,0,12,359,74,94,54,265,72,6750
15000US060374081332,874,82,136,77,42,46,94,58,738,97,141,58,597,99,6751
15000US060374081333,360,61,12,17,0,12,12,17,348,67,87,38,261,67,6752
15000US060374081341,767,52,49,34,11,13,38,32,718,60,179,48,539,65,6753
15000US060374081351,861,77,21,30,2,9,19,29,840,79,167,66,673,107,6754
15000US060374081352,342,81,16,19,7,13,9,13,326,79,83,43,243,84,6755
15000US060374081361,492,72,25,22,7,10,18,20,467,75,111,60,356,75,6756
15000US060374081362,567,70,15,15,6,9,9,13,552,73,145,61,407,77,6757
15000US060374081371,754,93,27,28,2,4,25,28,727,94,179,64,548,92,6758
15000US060374081372,471,74,51,34,25,21,26,27,420,82,105,49,315,73,6759
15000US060374081381,317,73,101,66,67,61,34,39,216,65,80,51,136,50,6760
15000US060374081382,876,84,225,76,43,33,182,81,651,85,251,84,400,93,6761
15000US060374081391,423,54,129,47,41,33,88,44,294,60,137,47,157,57,6762
15000US060374081392,380,42,8,10,4,7,4,7,372,42,77,33,295,49,6763
15000US060374081401,497,60,99,47,60,34,39,36,398,74,82,31,316,78,6764
15000US060374081402,227,54,21,18,0,12,21,18,206,54,30,25,176,56,6765
15000US060374081411,924,75,172,79,27,28,145,74,752,104,284,90,468,107,6766
15000US060374081412,161,58,18,30,0,12,18,30,143,57,27,23,116,58,6767
15000US060374082021,248,43,19,15,11,12,8,9,229,44,90,34,139,43,6768
15000US060374082022,191,45,0,12,0,12,0,12,191,45,39,21,152,43,6769
15000US060374082111,324,87,0,12,0,12,0,12,324,87,69,43,255,86,6770
15000US060374082112,873,113,120,58,4,8,116,59,753,120,145,75,608,136,6771
15000US060374082113,535,103,27,40,0,12,27,40,508,100,72,37,436,104,6772
15000US060374082121,755,83,18,28,0,12,18,28,737,86,140,54,597,89,6773
15000US060374082122,608,77,92,45,32,27,60,44,516,74,92,61,424,70,6774
15000US060374083011,1029,81,109,51,78,43,31,25,920,95,255,82,665,114,6775
15000US060374083012,172,62,24,37,24,37,0,12,148,53,84,47,64,34,6776
15000US060374083021,1109,53,11,18,0,12,11,18,1098,53,257,82,841,88,6777
15000US060374083031,1184,42,46,36,9,14,37,32,1138,50,313,83,825,90,6778
15000US060374084011,601,89,67,48,49,42,18,21,534,88,177,65,357,89,6779
15000US060374084012,632,101,34,51,0,12,34,51,598,107,144,77,454,104,6780
15000US060374084021,501,81,13,20,13,20,0,12,488,82,80,48,408,84,6781
15000US060374084022,396,80,1,6,0,12,1,6,395,79,101,49,294,81,6782
15000US060374084023,837,110,42,37,42,37,0,12,795,116,281,96,514,105,6783
15000US060374085011,821,26,69,39,5,8,64,38,752,49,184,52,568,64,6784
15000US060374085031,424,87,0,12,0,12,0,12,424,87,146,59,278,95,6785
15000US060374085032,352,77,13,21,0,12,13,21,339,77,101,54,238,80,6786
15000US060374085033,1152,106,14,22,0,12,14,22,1138,106,283,89,855,112,6787
15000US060374085041,396,80,7,14,7,14,0,12,389,81,128,61,261,67,6788
15000US060374085042,846,91,58,43,0,12,58,43,788,86,127,61,661,92,6789
15000US060374085043,334,66,48,35,25,24,23,24,286,67,99,59,187,64,6790
15000US060374085051,356,41,0,12,0,12,0,12,356,41,129,48,227,46,6791
15000US060374085052,420,42,0,12,0,12,0,12,420,42,82,32,338,41,6792
15000US060374086231,1017,39,40,39,32,38,8,11,977,54,235,63,742,78,6793
15000US060374086241,678,61,21,22,3,7,18,21,657,65,121,57,536,75,6794
15000US060374086242,353,58,16,22,5,12,11,18,337,61,38,31,299,63,6795
15000US060374086251,394,67,13,22,0,12,13,22,381,73,97,47,284,71,6796
15000US060374086252,332,70,14,21,0,12,14,21,318,73,70,38,248,71,6797
15000US060374086253,508,81,6,11,6,11,0,12,502,82,104,48,398,89,6798
15000US060374086261,426,83,13,20,0,12,13,20,413,85,52,34,361,90,6799
15000US060374086262,453,102,0,12,0,12,0,12,453,102,72,46,381,101,6800
15000US060374086263,567,90,10,15,0,12,10,15,557,91,63,37,494,92,6801
15000US060374086271,635,50,12,14,6,9,6,10,623,53,104,37,519,67,6802
15000US060374086272,309,42,18,15,5,8,13,14,291,44,75,34,216,45,6803
15000US060374086281,482,65,0,12,0,12,0,12,482,65,80,39,402,66,6804
15000US060374086282,584,93,34,36,0,12,34,36,550,90,97,53,453,95,6805
15000US060374086283,726,90,46,28,16,17,30,27,680,92,121,46,559,86,6806
15000US060374086291,482,50,0,12,0,12,0,12,482,50,173,47,309,55,6807
15000US060374086292,417,51,0,12,0,12,0,12,417,51,86,40,331,50,6808
15000US060374086301,207,42,9,14,9,14,0,12,198,43,31,22,167,44,6809
15000US060374086302,324,47,51,34,10,16,41,33,273,47,58,29,215,49,6810
15000US060374086311,833,79,22,24,0,12,22,24,811,77,183,62,628,82,6811
15000US060374086312,346,65,26,28,10,17,16,22,320,62,46,32,274,71,6812
15000US060374086313,189,63,0,12,0,12,0,12,189,63,58,45,131,53,6813
15000US060374087031,649,76,25,38,0,12,25,38,624,76,130,69,494,79,6814
15000US060374087032,1204,112,0,12,0,12,0,12,1204,112,234,70,970,117,6815
15000US060374087041,992,59,44,41,19,28,25,25,948,74,289,84,659,96,6816
15000US060374087051,367,60,9,14,0,12,9,14,358,59,84,34,274,72,6817
15000US060374087052,719,80,8,13,0,12,8,13,711,79,107,45,604,91,6818
15000US060374087053,515,82,27,23,27,23,0,12,488,82,176,55,312,76,6819
15000US060374087061,479,33,8,13,0,12,8,13,471,36,98,36,373,48,6820
15000US060374087221,595,86,48,43,8,13,40,43,547,84,116,59,431,89,6821
15000US060374087222,663,75,15,22,0,12,15,22,648,75,110,53,538,72,6822
15000US060374087231,807,24,47,23,24,16,23,16,760,31,148,39,612,46,6823
15000US060374087241,498,88,47,29,7,12,40,26,451,88,43,32,408,95,6824
15000US060374087242,1057,88,129,61,0,12,129,61,928,96,187,66,741,105,6825
15000US060374088001,287,60,64,48,18,20,46,44,223,56,107,43,116,50,6826
15000US060374088002,472,88,123,72,38,36,85,62,349,83,59,42,290,84,6827
15000US060374088003,559,88,17,28,17,28,0,12,542,91,60,42,482,90,6828
15000US060374300021,341,86,19,30,19,30,0,12,322,85,59,48,263,98,6829
15000US060374300022,329,67,28,38,3,8,25,37,301,62,153,55,148,61,6830
15000US060374300023,487,108,44,50,0,12,44,50,443,105,16,21,427,108,6831
15000US060374300024,451,103,24,27,24,27,0,12,427,110,207,98,220,88,6832
15000US060374300025,801,130,32,49,0,12,32,49,769,133,145,83,624,140,6833
15000US060374300031,280,50,23,36,0,12,23,36,257,48,48,36,209,50,6834
15000US060374300032,991,79,0,12,0,12,0,12,991,79,224,62,767,85,6835
15000US060374300033,0,12,0,12,0,12,0,12,0,12,0,12,0,12,6836
15000US060374300034,239,43,7,11,0,12,7,11,232,44,60,34,172,51,6837
15000US060374301011,818,105,27,32,0,12,27,32,791,113,327,96,464,92,6838
15000US060374301012,374,91,36,42,0,12,36,42,338,87,92,54,246,81,6839
15000US060374301013,154,50,7,12,0,12,7,12,147,50,37,27,110,49,6840
15000US060374301014,385,94,44,41,7,13,37,41,341,89,69,43,272,82,6841
15000US060374301021,506,91,56,47,42,44,14,21,450,97,162,64,288,95,6842
15000US060374301022,288,70,63,52,11,16,52,50,225,62,59,29,166,62,6843
15000US060374301023,371,74,80,52,28,34,52,39,291,69,40,28,251,66,6844
15000US060374302001,420,51,2,3,0,12,2,3,418,51,119,33,299,41,6845
15000US060374303011,374,67,0,12,0,12,0,12,374,67,46,28,328,71,6846
15000US060374303012,0,12,0,12,0,12,0,12,0,12,0,12,0,12,6847
15000US060374303013,471,66,0,12,0,12,0,12,471,66,80,44,391,69,6848
15000US060374303014,762,93,7,12,7,12,0,12,755,94,113,40,642,95,6849
15000US060374303021,387,91,32,52,0,12,32,52,355,87,28,34,327,90,6850
15000US060374303022,518,125,0,12,0,12,0,12,518,125,75,54,443,123,6851
15000US060374303023,422,97,0,12,0,12,0,12,422,97,54,66,368,99,6852
15000US060374303024,501,143,0,12,0,12,0,12,501,143,60,50,441,142,6853
15000US060374303025,520,147,0,12,0,12,0,12,520,147,145,117,375,133,6854
15000US060374304001,522,103,0,12,0,12,0,12,522,103,69,31,453,100,6855
15000US060374304002,249,59,0,12,0,12,0,12,249,59,25,22,224,61,6856
15000US060374304003,287,79,0,12,0,12,0,12,287,79,32,32,255,80,6857
15000US060374304004,391,75,0,12,0,12,0,12,391,75,50,33,341,81,6858
15000US060374305011,322,69,0,12,0,12,0,12,322,69,46,28,276,76,6859
15000US060374305012,408,80,0,12,0,12,0,12,408,80,62,46,346,70,6860
15000US060374305013,275,62,7,12,7,12,0,12,268,61,36,26,232,60,6861
15000US060374305014,497,85,7,12,7,12,0,12,490,86,64,44,426,84,6862
15000US060374305021,210,66,0,12,0,12,0,12,210,66,33,40,177,68,6863
15000US060374305022,745,142,0,12,0,12,0,12,745,142,144,85,601,135,6864
15000US060374305023,631,126,0,12,0,12,0,12,631,126,110,72,521,124,6865
15000US060374305024,307,98,11,16,11,16,0,12,296,95,28,31,268,96,6866
15000US060374305025,328,92,10,16,10,16,0,12,318,91,32,26,286,94,6867
15000US060374305026,680,117,10,16,0,12,10,16,670,119,161,74,509,130,6868
15000US060374306001,259,66,0,12,0,12,0,12,259,66,44,41,215,68,6869
15000US060374306002,315,60,20,23,8,13,12,18,295,67,67,41,228,69,6870
15000US060374306003,221,58,0,12,0,12,0,12,221,58,35,21,186,62,6871
15000US060374306004,592,81,7,11,7,11,0,12,585,81,80,41,505,80,6872
15000US060374307011,295,60,0,12,0,12,0,12,295,60,45,30,250,61,6873
15000US060374307012,912,106,0,12,0,12,0,12,912,106,192,73,720,111,6874
15000US060374307013,407,57,0,12,0,12,0,12,407,57,32,39,375,61,6875
15000US060374307014,342,62,0,12,0,12,0,12,342,62,98,48,244,67,6876
15000US060374307211,282,76,0,12,0,12,0,12,282,76,91,53,191,62,6877
15000US060374307212,606,89,7,11,0,12,7,11,599,90,59,31,540,99,6878
15000US060374307213,408,89,0,12,0,12,0,12,408,89,43,33,365,91,6879
15000US060374307231,719,103,38,26,18,21,20,22,681,105,78,45,603,106,6880
15000US060374307232,917,96,43,55,0,12,43,55,874,102,103,49,771,103,6881
15000US060374307241,934,110,29,25,20,21,9,14,905,111,127,44,778,109,6882
15000US060374307242,930,118,11,12,8,13,3,6,919,118,161,85,758,125,6883
15000US060374308011,264,124,15,24,0,12,15,24,249,124,16,26,233,130,6884
15000US060374308012,872,146,35,46,10,16,25,41,837,154,123,61,714,164,6885
15000US060374308013,525,117,21,28,21,28,0,12,504,119,19,31,485,121,6886
15000US060374308014,692,132,23,28,0,12,23,28,669,132,95,67,574,128,6887
15000US060374308021,279,63,0,12,0,12,0,12,279,63,42,37,237,60,6888
15000US060374308022,417,85,0,12,0,12,0,12,417,85,66,46,351,85,6889
15000US060374308023,287,58,0,12,0,12,0,12,287,58,65,36,222,71,6890
15000US060374308024,312,69,0,12,0,12,0,12,312,69,55,31,257,73,6891
15000US060374308031,300,64,6,10,0,12,6,10,294,63,79,52,215,73,6892
15000US060374308032,445,82,0,12,0,12,0,12,445,82,81,38,364,85,6893
15000US060374308033,484,83,0,12,0,12,0,12,484,83,95,61,389,84,6894
15000US060374308034,358,76,0,12,0,12,0,12,358,76,28,26,330,73,6895
15000US060374308035,221,56,0,12,0,12,0,12,221,56,58,29,163,59,6896
15000US060374309011,593,99,25,24,8,14,17,19,568,103,46,31,522,106,6897
15000US060374309012,323,73,7,12,0,12,7,12,316,74,67,44,249,71,6898
15000US060374309013,694,105,55,30,23,20,32,25,639,111,181,68,458,123,6899
15000US060374309021,880,111,73,48,36,25,37,42,807,110,125,51,682,114,6900
15000US060374309022,463,84,22,35,22,35,0,12,441,85,97,50,344,81,6901
15000US060374309023,270,70,20,28,20,28,0,12,250,64,41,35,209,68,6902
15000US060374310011,194,73,0,12,0,12,0,12,194,73,22,19,172,73,6903
15000US060374310012,751,173,95,84,46,59,49,67,656,163,74,43,582,165,6904
15000US060374310013,752,146,12,19,0,12,12,19,740,149,67,42,673,153,6905
15000US060374310014,944,161,67,65,15,24,52,63,877,162,98,65,779,157,6906
15000US060374310021,816,86,54,44,17,18,37,42,762,90,287,82,475,96,6907
15000US060374310022,461,64,0,12,0,12,0,12,461,64,123,53,338,75,6908
15000US060374311001,609,114,64,80,0,12,64,80,545,116,28,30,517,117,6909
15000US060374311002,482,111,9,14,9,14,0,12,473,110,104,77,369,121,6910
15000US060374311003,445,90,10,16,10,16,0,12,435,92,113,76,322,89,6911
15000US060374311004,270,90,0,12,0,12,0,12,270,90,15,24,255,92,6912
15000US060374311005,277,69,24,39,24,39,0,12,253,62,101,61,152,76,6913
15000US060374312001,357,81,51,45,19,34,32,32,306,82,67,49,239,82,6914
15000US060374312002,317,56,62,49,35,37,27,30,255,68,71,45,184,56,6915
15000US060374312003,213,70,6,11,6,11,0,12,207,70,39,33,168,67,6916
15000US060374312004,571,84,44,39,0,12,44,39,527,88,94,45,433,89,6917
15000US060374313001,319,49,0,12,0,12,0,12,319,49,58,26,261,49,6918
15000US060374313002,528,55,33,25,26,24,7,9,495,57,90,37,405,57,6919
15000US060374314001,307,93,0,12,0,12,0,12,307,93,48,25,259,93,6920
15000US060374314002,321,68,0,12,0,12,0,12,321,68,62,35,259,72,6921
15000US060374314003,384,67,8,13,0,12,8,13,376,66,80,51,296,61,6922
15000US060374314004,319,67,0,12,0,12,0,12,319,67,61,41,258,63,6923
15000US060374315011,505,87,31,26,9,15,22,22,474,90,158,72,316,95,6924
15000US060374315012,534,79,0,12,0,12,0,12,534,79,110,37,424,87,6925
15000US060374315013,626,78,66,50,9,13,57,47,560,88,78,46,482,95,6926
15000US060374315021,413,73,0,12,0,12,0,12,413,73,61,37,352,77,6927
15000US060374315022,415,75,0,12,0,12,0,12,415,75,60,41,355,73,6928
15000US060374315023,274,79,51,51,9,14,42,50,223,68,50,51,173,62,6929
15000US060374315024,276,48,9,14,9,14,0,12,267,54,68,40,199,57,6930
15000US060374316001,364,54,0,12,0,12,0,12,364,54,137,47,227,58,6931
15000US060374316002,546,77,0,12,0,12,0,12,546,77,111,43,435,84,6932
15000US060374316003,317,52,8,12,0,12,8,12,309,53,47,29,262,51,6933
15000US060374317001,174,78,0,12,0,12,0,12,174,78,52,50,122,68,6934
15000US060374317002,352,75,0,12,0,12,0,12,352,75,36,31,316,72,6935
15000US060374317003,377,128,18,28,18,28,0,12,359,135,29,32,330,138,6936
15000US060374317004,278,83,0,12,0,12,0,12,278,83,71,54,207,88,6937
15000US060374317005,750,138,0,12,0,12,0,12,750,138,188,96,562,140,6938
15000US060374318001,685,108,14,16,0,12,14,16,671,109,137,54,534,105,6939
15000US060374318002,662,86,0,12,0,12,0,12,662,86,156,76,506,92,6940
15000US060374318003,549,62,7,13,0,12,7,13,542,61,121,48,421,57,6941
15000US060374319001,618,98,8,13,0,12,8,13,610,100,63,44,547,113,6942
15000US060374319002,326,79,0,12,0,12,0,12,326,79,71,36,255,81,6943
15000US060374319003,494,95,35,30,6,10,29,28,459,96,106,53,353,99,6944
15000US060374320001,554,136,15,24,15,24,0,12,539,138,137,90,402,123,6945
15000US060374320002,309,68,0,12,0,12,0,12,309,68,60,46,249,72,6946
15000US060374320003,598,110,50,58,0,12,50,58,548,110,123,91,425,108,6947
15000US060374320004,285,96,7,13,0,12,7,13,278,99,40,32,238,102,6948
15000US060374320005,393,118,26,30,0,12,26,30,367,117,40,57,327,102,6949
15000US060374320006,390,115,0,12,0,12,0,12,390,115,90,61,300,112,6950
15000US060374321011,412,68,0,12,0,12,0,12,412,68,77,35,335,71,6951
15000US060374321012,519,68,11,13,5,9,6,9,508,72,90,48,418,81,6952
15000US060374321013,400,54,9,13,9,13,0,12,391,55,91,37,300,55,6953
15000US060374321021,350,64,8,12,8,12,0,12,342,64,103,44,239,64,6954
15000US060374321022,348,68,18,23,0,12,18,23,330,68,79,36,251,71,6955
15000US060374321023,359,70,8,12,0,12,8,12,351,72,62,43,289,69,6956
15000US060374321024,253,61,13,15,6,10,7,11,240,64,34,29,206,64,6957
15000US060374321025,362,82,0,12,0,12,0,12,362,82,49,21,313,84,6958
15000US060374322011,385,83,0,12,0,12,0,12,385,83,110,47,275,73,6959
15000US060374322012,904,90,59,44,0,12,59,44,845,93,150,56,695,105,6960
15000US060374322021,386,68,26,24,10,15,16,19,360,72,155,61,205,72,6961
15000US060374322022,210,54,9,13,0,12,9,13,201,57,48,34,153,51,6962
15000US060374322023,617,92,127,69,30,28,97,72,490,101,87,41,403,100,6963
15000US060374323001,421,67,39,29,22,22,17,17,382,69,67,40,315,71,6964
15000US060374323002,258,63,34,39,12,18,22,35,224,63,48,36,176,58,6965
15000US060374323003,514,88,20,17,9,14,11,18,494,89,100,60,394,86,6966
15000US060374324011,536,70,74,45,19,20,55,35,462,80,107,47,355,76,6967
15000US060374324012,451,62,15,14,10,11,5,8,436,63,140,42,296,70,6968
15000US060374324021,810,124,102,52,41,34,61,47,708,139,178,85,530,128,6969
15000US060374324022,592,105,38,36,11,17,27,31,554,110,201,93,353,96,6970
15000US060374324023,420,93,88,61,15,18,73,57,332,100,123,63,209,81,6971
15000US060374325001,439,114,48,46,27,42,21,30,391,106,103,65,288,105,6972
15000US060374325002,940,168,71,68,0,12,71,68,869,168,258,127,611,162,6973
15000US060374325003,526,108,66,69,6,16,60,67,460,106,173,73,287,103,6974
15000US060374325004,572,120,51,42,51,42,0,12,521,126,94,62,427,119,6975
15000US060374326011,258,56,12,12,0,12,12,12,246,57,41,34,205,61,6976
15000US060374326012,539,88,90,58,8,13,82,57,449,91,105,61,344,86,6977
15000US060374326013,362,70,26,29,9,15,17,25,336,65,80,42,256,74,6978
15000US060374326014,566,100,56,53,33,41,23,36,510,97,104,60,406,104,6979
15000US060374326021,457,79,45,33,19,20,26,25,412,83,79,47,333,85,6980
15000US060374326022,358,87,66,55,0,12,66,55,292,75,104,53,188,83,6981
15000US060374326023,329,75,9,15,9,15,0,12,320,75,111,46,209,74,6982
15000US060374327001,730,117,117,79,36,43,81,63,613,128,206,71,407,122,6983
15000US060374327002,274,75,7,12,0,12,7,12,267,74,50,29,217,69,6984
15000US060374327003,342,91,28,41,28,41,0,12,314,85,65,62,249,82,6985
15000US060374328011,261,58,46,36,8,11,38,34,215,52,65,39,150,48,6986
15000US060374328012,668,71,53,27,24,19,29,18,615,69,315,57,300,66,6987
15000US060374328021,590,114,143,80,35,36,108,73,447,110,42,29,405,113,6988
15000US060374328022,474,105,104,69,7,11,97,66,370,97,143,68,227,91,6989
15000US060374328023,367,94,59,54,12,18,47,53,308,90,33,26,275,93,6990
15000US060374329011,629,90,6,9,0,12,6,9,623,91,143,63,480,107,6991
15000US060374329012,394,83,61,37,0,12,61,37,333,84,49,42,284,83,6992
15000US060374329013,229,69,39,32,9,14,30,36,190,70,20,21,170,69,6993
15000US060374329021,212,61,25,23,5,7,20,22,187,58,21,17,166,57,6994
15000US060374329022,331,68,4,7,4,7,0,12,327,69,104,40,223,76,6995
15000US060374329023,348,65,25,24,0,12,25,24,323,67,75,29,248,66,6996
15000US060374331011,281,54,54,33,45,30,9,12,227,45,48,29,179,53,6997
15000US060374331012,364,50,13,12,5,8,8,9,351,49,110,39,241,58,6998
15000US060374331021,630,98,251,88,25,40,226,87,379,91,85,46,294,87,6999
15000US060374331022,654,104,35,32,26,25,9,18,619,102,233,94,386,100,7000
15000US060374332001,413,62,82,46,48,38,34,39,331,63,135,52,196,72,7001
15000US060374332002,211,68,31,36,10,15,21,33,180,63,94,58,86,55,7002
15000US060374332003,352,83,60,52,11,17,49,48,292,83,69,53,223,89,7003
15000US060374332004,634,106,113,64,11,19,102,62,521,109,192,92,329,96,7004
15000US060374333021,456,27,90,36,7,10,83,32,366,40,125,44,241,47,7005
15000US060374333041,526,104,67,53,31,37,36,43,459,98,197,69,262,90,7006
15000US060374333042,774,104,159,73,50,44,109,57,615,115,107,69,508,110,7007
15000US060374333051,837,108,276,110,91,58,185,100,561,122,44,31,517,127,7008
15000US060374333052,476,106,49,41,9,14,40,39,427,107,93,57,334,110,7009
15000US060374333061,159,54,52,39,11,13,41,37,107,42,32,24,75,39,7010
15000US060374333062,484,68,69,38,25,24,44,32,415,68,81,44,334,63,7011
15000US060374333063,146,57,24,26,4,6,20,25,122,56,12,13,110,56,7012
15000US060374333071,455,54,35,25,9,11,26,22,420,61,67,32,353,63,7013
15000US060374333072,199,50,54,34,0,12,54,34,145,46,23,22,122,45,7014
15000US060374333073,226,53,86,43,17,18,69,41,140,50,6,9,134,49,7015
15000US060374334011,526,61,127,46,11,13,116,43,399,65,90,36,309,67,7016
15000US060374334012,195,42,32,22,4,7,28,21,163,40,41,28,122,38,7017
15000US060374334021,558,115,209,80,20,25,189,80,349,91,85,47,264,87,7018
15000US060374334022,659,113,126,88,32,32,94,79,533,135,130,75,403,133,7019
15000US060374334031,313,76,27,31,0,12,27,31,286,80,53,39,233,75,7020
15000US060374334032,608,80,132,68,17,27,115,64,476,99,23,21,453,102,7021
15000US060374334033,352,87,81,68,0,12,81,68,271,78,134,68,137,59,7022
15000US060374335011,569,59,154,57,11,13,143,55,415,85,130,55,285,74,7023
15000US060374335031,554,62,82,44,14,23,68,41,472,71,141,44,331,70,7024
15000US060374335032,192,46,31,30,0,12,31,30,161,47,84,38,77,40,7025
15000US060374335041,468,91,134,75,36,43,98,71,334,95,55,47,279,98,7026
15000US060374335042,252,81,111,61,20,30,91,56,141,75,28,38,113,72,7027
15000US060374335043,349,71,88,54,34,31,54,47,261,79,75,57,186,78,7028
15000US060374336011,295,66,18,21,0,12,18,21,277,68,73,44,204,72,7029
15000US060374336012,1053,95,165,74,61,49,104,65,888,111,180,50,708,115,7030
15000US060374336021,781,44,68,37,12,11,56,35,713,51,166,45,547,63,7031
15000US060374337001,291,65,37,32,0,12,37,32,254,69,87,40,167,65,7032
15000US060374337002,249,54,13,14,6,9,7,11,236,57,105,47,131,60,7033
15000US060374337003,436,66,70,48,17,16,53,43,366,61,163,52,203,57,7034
15000US060374338011,319,86,136,68,0,12,136,68,183,72,55,39,128,66,7035
15000US060374338012,264,63,37,33,27,31,10,16,227,58,85,47,142,60,7036
15000US060374338013,472,78,28,32,0,12,28,32,444,84,172,76,272,81,7037
15000US060374338014,427,109,209,94,49,39,160,85,218,90,74,53,144,78,7038
15000US060374338021,355,62,25,23,4,8,21,20,330,62,137,61,193,68,7039
15000US060374338022,577,72,41,31,23,22,18,18,536,75,172,61,364,74,7040
15000US060374339011,776,94,231,84,62,47,169,73,545,101,163,76,382,96,7041
15000US060374339012,256,77,71,47,24,29,47,38,185,71,41,40,144,64,7042
15000US060374339013,319,67,98,53,30,33,68,48,221,65,7,11,214,65,7043
15000US060374339021,201,51,60,38,4,5,56,38,141,51,24,17,117,54,7044
15000US060374339022,434,64,30,27,15,22,15,16,404,68,125,36,279,64,7045
15000US060374339023,270,63,34,31,6,10,28,30,236,60,71,41,165,56,7046
15000US060374340011,428,76,46,30,9,12,37,27,382,77,49,27,333,72,7047
15000US060374340012,584,77,54,30,22,19,32,25,530,78,59,38,471,78,7048
15000US060374340031,429,56,83,54,6,10,77,51,346,68,83,46,263,70,7049
15000US060374340032,290,63,41,35,0,12,41,35,249,64,85,56,164,59,7050
15000US060374340033,374,67,91,46,30,31,61,36,283,69,46,29,237,71,7051
15000US060374340041,394,66,56,35,12,15,44,31,338,63,99,43,239,54,7052
15000US060374340042,292,46,78,36,40,31,38,31,214,44,49,29,165,48,7053
15000US060374600001,374,73,0,12,0,12,0,12,374,73,69,43,305,73,7054
15000US060374600002,344,55,0,12,0,12,0,12,344,55,85,40,259,58,7055
15000US060374600003,581,91,0,12,0,12,0,12,581,91,117,71,464,93,7056
15000US060374600004,339,64,0,12,0,12,0,12,339,64,81,40,258,75,7057
15000US060374601001,366,86,0,12,0,12,0,12,366,86,62,74,304,83,7058
15000US060374601002,671,108,25,32,0,12,25,32,646,105,133,68,513,111,7059
15000US060374601003,293,73,0,12,0,12,0,12,293,73,59,52,234,74,7060
15000US060374601004,411,82,0,12,0,12,0,12,411,82,47,44,364,88,7061
15000US060374601005,629,110,0,12,0,12,0,12,629,110,142,74,487,117,7062
15000US060374602001,400,112,19,31,0,12,19,31,381,108,100,52,281,119,7063
15000US060374602002,408,95,0,12,0,12,0,12,408,95,131,74,277,107,7064
15000US060374602003,352,111,61,56,26,37,35,45,291,98,17,27,274,95,7065
15000US060374602004,333,81,17,27,0,12,17,27,316,82,21,28,295,89,7066
15000US060374602005,637,124,32,40,12,19,20,36,605,133,147,81,458,132,7067
15000US060374603011,388,85,5,10,5,10,0,12,383,85,78,42,305,90,7068
15000US060374603012,314,74,18,19,9,14,9,13,296,75,134,66,162,51,7069
15000US060374603013,312,60,31,28,19,29,12,16,281,66,40,28,241,71,7070
15000US060374603014,613,82,23,24,23,24,0,12,590,86,48,31,542,90,7071
15000US060374603021,304,65,10,15,0,12,10,15,294,62,102,52,192,54,7072
15000US060374603022,249,70,23,19,7,11,16,16,226,70,57,35,169,71,7073
15000US060374603023,523,87,19,22,10,16,9,16,504,91,124,75,380,95,7074
15000US060374603024,310,69,21,34,21,34,0,12,289,66,97,47,192,62,7075
15000US060374604011,324,26,31,22,3,6,28,22,293,33,56,26,237,36,7076
15000US060374604012,0,12,0,12,0,12,0,12,0,12,0,12,0,12,7077
15000US060374605011,600,78,0,12,0,12,0,12,600,78,141,66,459,87,7078
15000US060374605012,320,74,0,12,0,12,0,12,320,74,15,18,305,75,7079
15000US060374605013,909,96,0,12,0,12,0,12,909,96,218,68,691,98,7080
15000US060374605021,197,54,0,12,0,12,0,12,197,54,51,36,146,59,7081
15000US060374605022,192,51,0,12,0,12,0,12,192,51,24,26,168,55,7082
15000US060374605023,177,55,0,12,0,12,0,12,177,55,9,17,168,51,7083
15000US060374605024,320,63,0,12,0,12,0,12,320,63,44,32,276,68,7084
15000US060374605025,229,59,10,16,0,12,10,16,219,60,0,12,219,60,7085
15000US060374605026,307,54,0,12,0,12,0,12,307,54,58,36,249,56,7086
15000US060374606001,409,72,0,12,0,12,0,12,409,72,76,38,333,79,7087
15000US060374606002,399,73,0,12,0,12,0,12,399,73,64,35,335,82,7088
15000US060374606003,458,77,0,12,0,12,0,12,458,77,69,42,389,84,7089
15000US060374606004,218,67,0,12,0,12,0,12,218,67,25,23,193,69,7090
15000US060374607001,256,54,0,12,0,12,0,12,256,54,20,22,236,56,7091
15000US060374607002,229,49,0,12,0,12,0,12,229,49,18,21,211,44,7092
15000US060374607003,215,42,10,15,10,15,0,12,205,45,58,38,147,44,7093
15000US060374607004,387,56,0,12,0,12,0,12,387,56,40,30,347,59,7094
15000US060374607005,513,72,10,16,0,12,10,16,503,73,139,63,364,74,7095
15000US060374608001,733,62,0,12,0,12,0,12,733,62,126,49,607,72,7096
15000US060374608002,483,68,0,12,0,12,0,12,483,68,78,39,405,60,7097
15000US060374609001,611,123,70,71,0,12,70,71,541,109,105,69,436,106,7098
15000US060374609002,527,111,64,61,10,14,54,59,463,105,97,59,366,120,7099
15000US060374609003,317,80,18,17,13,14,5,8,299,81,124,60,175,75,7100
15000US060374609004,349,85,15,13,6,11,9,13,334,84,67,34,267,87,7101
15000US060374609005,215,68,0,12,0,12,0,12,215,68,56,47,159,64,7102
15000US060374610001,232,75,7,11,0,12,7,11,225,76,66,49,159,64,7103
15000US060374610002,542,84,112,60,0,12,112,60,430,93,101,57,329,85,7104
15000US060374610003,426,80,22,20,15,17,7,11,404,83,138,62,266,76,7105
15000US060374610004,514,91,45,43,10,14,35,40,469,89,164,68,305,81,7106
15000US060374611001,326,72,0,12,0,12,0,12,326,72,77,40,249,69,7107
15000US060374611002,582,90,58,64,27,45,31,49,524,87,84,49,440,76,7108
15000US060374611003,333,75,0,12,0,12,0,12,333,75,94,46,239,74,7109
15000US060374611004,432,83,59,35,14,16,45,30,373,93,14,18,359,94,7110
15000US060374612001,351,63,0,12,0,12,0,12,351,63,91,37,260,63,7111
15000US060374612002,538,76,19,19,8,11,11,16,519,82,54,40,465,84,7112
15000US060374612003,329,58,0,12,0,12,0,12,329,58,56,33,273,68,7113
15000US060374612004,522,80,0,12,0,12,0,12,522,80,92,49,430,84,7114
15000US060374613001,269,86,0,12,0,12,0,12,269,86,26,33,243,78,7115
15000US060374613002,604,141,0,12,0,12,0,12,604,141,139,105,465,142,7116
15000US060374613003,574,117,19,25,0,12,19,25,555,116,156,111,399,95,7117
15000US060374613004,598,143,77,72,0,12,77,72,521,141,248,101,273,120,7118
15000US060374613005,530,142,64,54,12,20,52,49,466,154,132,101,334,120,7119
15000US060374614001,609,94,25,22,5,9,20,21,584,101,220,76,364,82,7120
15000US060374614002,296,70,0,12,0,12,0,12,296,70,19,21,277,71,7121
15000US060374614003,346,72,9,13,9,13,0,12,337,72,75,45,262,69,7122
15000US060374615011,311,70,46,51,6,10,40,49,265,64,43,33,222,64,7123
15000US060374615012,448,66,89,48,0,12,89,48,359,62,90,53,269,63,7124
15000US060374615013,529,72,24,21,5,9,19,20,505,77,104,55,401,71,7125
15000US060374615021,370,81,46,37,0,12,46,37,324,88,117,66,207,63,7126
15000US060374615022,646,85,173,80,32,39,141,67,473,99,180,87,293,78,7127
15000US060374615023,350,91,86,61,17,19,69,59,264,83,116,61,148,67,7128
15000US060374615024,293,73,35,42,12,18,23,37,258,76,21,22,237,78,7129
15000US060374616001,478,82,102,68,17,20,85,63,376,85,133,62,243,80,7130
15000US060374616002,458,71,8,11,3,6,5,9,450,70,143,59,307,78,7131
15000US060374616003,520,84,72,49,28,40,44,32,448,77,74,51,374,82,7132
15000US060374616004,313,69,40,38,7,11,33,36,273,64,61,38,212,64,7133
15000US060374617001,249,43,5,7,5,7,0,12,244,43,26,14,218,44,7134
15000US060374617002,411,41,0,12,0,12,0,12,411,41,78,24,333,44,7135
15000US060374619011,776,106,107,65,20,24,87,62,669,106,92,55,577,102,7136
15000US060374619012,131,71,35,36,0,12,35,36,96,59,46,50,50,42,7137
15000US060374619013,641,102,73,57,44,42,29,37,568,98,104,61,464,93,7138
15000US060374619021,298,85,35,32,9,14,26,29,263,85,76,60,187,72,7139
15000US060374619022,770,105,55,27,20,18,35,21,715,116,155,61,560,106,7140
15000US060374620011,541,102,47,47,3,6,44,47,494,109,146,72,348,105,7141
15000US060374620012,552,94,63,44,6,10,57,44,489,95,159,68,330,92,7142
15000US060374620021,656,92,157,71,13,17,144,70,499,111,97,57,402,117,7143
15000US060374620022,122,56,24,29,0,12,24,29,98,51,21,23,77,46,7144
15000US060374620023,358,90,75,63,0,12,75,63,283,85,97,58,186,82,7145
15000US060374621001,406,74,22,21,13,16,9,14,384,76,76,43,308,73,7146
15000US060374621002,815,109,174,76,59,52,115,68,641,110,131,61,510,105,7147
15000US060374621003,566,91,38,43,38,43,0,12,528,92,89,50,439,98,7148
15000US060374622011,661,119,35,27,11,13,24,26,626,121,292,94,334,91,7149
15000US060374622012,751,106,83,53,40,39,43,40,668,108,327,102,341,107,7150
15000US060374622013,472,95,76,59,10,15,66,58,396,92,92,56,304,78,7151
15000US060374622021,648,96,15,16,15,16,0,12,633,97,79,46,554,100,7152
15000US060374622022,688,97,24,38,0,12,24,38,664,91,59,35,605,94,7153
15000US060374623011,871,100,82,52,16,17,66,49,789,110,263,89,526,110,7154
15000US060374623012,332,82,60,49,21,26,39,42,272,75,7,14,265,72,7155
15000US060374623013,163,69,8,13,0,12,8,13,155,73,0,12,155,73,7156
15000US060374623014,429,93,0,12,0,12,0,12,429,93,155,65,274,83,7157
15000US060374623021,544,80,14,18,0,12,14,18,530,81,43,37,487,86,7158
15000US060374623022,452,99,8,12,8,12,0,12,444,100,40,25,404,99,7159
15000US060374623023,433,94,8,14,0,12,8,14,425,96,37,29,388,101,7160
15000US060374624001,619,91,0,12,0,12,0,12,619,91,131,49,488,99,7161
15000US060374624002,312,80,8,13,0,12,8,13,304,81,76,44,228,84,7162
15000US060374624003,244,51,8,14,0,12,8,14,236,49,15,17,221,49,7163
15000US060374624004,457,74,7,12,0,12,7,12,450,72,150,57,300,72,7164
15000US060374625001,545,127,29,36,0,12,29,36,516,133,17,27,499,133,7165
15000US060374625002,465,105,0,12,0,12,0,12,465,105,43,50,422,105,7166
15000US060374625003,955,138,0,12,0,12,0,12,955,138,304,135,651,134,7167
15000US060374625004,412,117,28,42,0,12,28,42,384,119,94,55,290,116,7168
15000US060374626001,453,46,4,7,4,7,0,12,449,47,97,38,352,60,7169
15000US060374626002,373,43,4,6,0,12,4,6,369,44,87,29,282,43,7170
15000US060374627001,356,100,37,56,37,56,0,12,319,91,101,52,218,82,7171
15000US060374627002,349,96,0,12,0,12,0,12,349,96,95,51,254,98,7172
15000US060374627003,428,95,10,18,0,12,10,18,418,98,55,54,363,110,7173
15000US060374627004,524,111,0,12,0,12,0,12,524,111,45,40,479,115,7174
15000US060374627005,493,107,15,25,0,12,15,25,478,104,40,31,438,104,7175
15000US060374628001,549,95,0,12,0,12,0,12,549,95,80,41,469,100,7176
15000US060374628002,576,85,30,28,0,12,30,28,546,86,159,64,387,92,7177
15000US060374629001,655,71,8,12,0,12,8,12,647,73,147,62,500,90,7178
15000US060374629002,330,46,0,12,0,12,0,12,330,46,105,48,225,53,7179
15000US060374629003,361,65,12,18,12,18,0,12,349,66,82,45,267,65,7180
15000US060374630001,318,35,0,12,0,12,0,12,318,35,71,32,247,35,7181
15000US060374630002,601,57,4,6,4,6,0,12,597,57,99,38,498,56,7182
15000US060374631011,234,47,0,12,0,12,0,12,234,47,35,20,199,46,7183
15000US060374631012,600,59,19,20,13,16,6,11,581,61,115,37,466,62,7184
15000US060374631021,485,72,36,42,36,42,0,12,449,71,116,67,333,90,7185
15000US060374631022,370,72,0,12,0,12,0,12,370,72,43,35,327,70,7186
15000US060374631023,290,81,0,12,0,12,0,12,290,81,68,44,222,78,7187
15000US060374632001,484,72,0,12,0,12,0,12,484,72,115,61,369,82,7188
15000US060374632002,635,82,24,24,24,24,0,12,611,84,180,60,431,82,7189
15000US060374632003,297,56,37,42,0,12,37,42,260,57,65,48,195,57,7190
15000US060374633001,572,59,15,20,0,12,15,20,557,57,78,47,479,66,7191
15000US060374633002,321,47,0,12,0,12,0,12,321,47,41,21,280,47,7192
15000US060374634001,593,110,15,23,15,23,0,12,578,119,143,88,435,125,7193
15000US060374634002,514,132,0,12,0,12,0,12,514,132,114,88,400,115,7194
15000US060374634003,360,96,0,12,0,12,0,12,360,96,37,36,323,102,7195
15000US060374634004,977,165,42,68,0,12,42,68,935,167,139,85,796,158,7196
15000US060374635001,787,127,26,33,10,19,16,26,761,130,36,44,725,138,7197
15000US060374635002,426,124,0,12,0,12,0,12,426,124,49,58,377,114,7198
15000US060374635003,1454,151,14,23,0,12,14,23,1440,150,142,85,1298,163,7199
15000US060374636011,447,105,0,12,0,12,0,12,447,105,38,30,409,107,7200
15000US060374636012,748,130,0,12,0,12,0,12,748,130,163,79,585,124,7201
15000US060374636013,1494,185,0,12,0,12,0,12,1494,185,272,126,1222,189,7202
15000US060374636014,718,129,16,27,0,12,16,27,702,130,166,78,536,135,7203
15000US060374636021,755,142,14,22,0,12,14,22,741,144,62,48,679,144,7204
15000US060374636022,1397,177,0,12,0,12,0,12,1397,177,74,79,1323,173,7205
15000US060374636023,638,98,0,12,0,12,0,12,638,98,51,40,587,101,7206
15000US060374636024,299,101,0,12,0,12,0,12,299,101,12,19,287,104,7207
15000US060374637001,461,90,11,16,11,16,0,12,450,90,63,37,387,99,7208
15000US060374637002,961,108,0,12,0,12,0,12,961,108,98,41,863,114,7209
15000US060374638001,280,64,0,12,0,12,0,12,280,64,21,19,259,68,7210
15000US060374638002,433,76,12,19,0,12,12,19,421,78,76,45,345,68,7211
15000US060374638003,388,65,8,13,0,12,8,13,380,64,42,32,338,63,7212
15000US060374638004,465,74,0,12,0,12,0,12,465,74,34,28,431,78,7213
15000US060374639001,493,82,17,19,0,12,17,19,476,80,42,28,434,83,7214
15000US060374639002,645,105,0,12,0,12,0,12,645,105,220,80,425,103,7215
15000US060374639003,534,74,0,12,0,12,0,12,534,74,114,46,420,81,7216
15000US060374640001,482,120,0,12,0,12,0,12,482,120,68,50,414,116,7217
15000US060374640002,432,81,0,12,0,12,0,12,432,81,24,34,408,90,7218
15000US060374640003,554,107,16,26,0,12,16,26,538,107,39,38,499,110,7219
15000US060374640004,411,106,0,12,0,12,0,12,411,106,87,41,324,116,7220
15000US060374640005,649,123,17,28,0,12,17,28,632,117,148,92,484,119,7221
15000US060374641001,410,100,0,12,0,12,0,12,410,100,96,62,314,109,7222
15000US060374641002,383,126,0,12,0,12,0,12,383,126,13,20,370,124,7223
15000US060374641003,206,89,0,12,0,12,0,12,206,89,66,49,140,83,7224
15000US060374641004,378,115,16,27,16,27,0,12,362,112,55,57,307,109,7225
15000US060374641005,336,109,0,12,0,12,0,12,336,109,32,37,304,106,7226
15000US060374641006,390,110,0,12,0,12,0,12,390,110,16,34,374,126,7227
15000US060374641007,394,134,0,12,0,12,0,12,394,134,75,82,319,147,7228
15000US060374642001,252,61,0,12,0,12,0,12,252,61,37,27,215,62,7229
15000US060374642002,234,61,0,12,0,12,0,12,234,61,34,25,200,65,7230
15000US060374642003,479,99,0,12,0,12,0,12,479,99,93,68,386,100,7231
15000US060374642004,372,71,0,12,0,12,0,12,372,71,66,38,306,77,7232
15000US060374642005,289,63,0,12,0,12,0,12,289,63,27,26,262,66,7233
15000US060374642006,533,84,0,12,0,12,0,12,533,84,70,57,463,77,7234
15000US060374800021,242,50,0,12,0,12,0,12,242,50,28,25,214,49,7235
15000US060374800022,438,56,7,11,0,12,7,11,431,56,70,38,361,65,7236
15000US060374800023,501,67,14,21,0,12,14,21,487,69,93,56,394,70,7237
15000US060374800111,846,91,25,23,10,16,15,18,821,98,89,39,732,104,7238
15000US060374800112,903,94,66,49,25,21,41,43,837,99,141,56,696,110,7239
15000US060374800121,470,68,30,34,8,12,22,32,440,71,78,41,362,80,7240
15000US060374800122,258,60,0,12,0,12,0,12,258,60,37,30,221,69,7241
15000US060374800123,557,91,25,25,17,20,8,15,532,87,55,37,477,91,7242
15000US060374800124,331,61,0,12,0,12,0,12,331,61,44,31,287,64,7243
15000US060374801011,518,89,28,29,0,12,28,29,490,93,73,45,417,99,7244
15000US060374801012,276,70,9,19,9,19,0,12,267,76,53,31,214,75,7245
15000US060374801013,478,84,0,12,0,12,0,12,478,84,108,51,370,87,7246
15000US060374801021,321,65,0,12,0,12,0,12,321,65,103,44,218,70,7247
15000US060374801022,583,90,27,26,14,20,13,19,556,90,63,37,493,97,7248
15000US060374801023,560,84,34,25,0,12,34,25,526,81,78,39,448,85,7249
15000US060374802011,541,66,0,12,0,12,0,12,541,66,100,46,441,69,7250
15000US060374802012,275,64,0,12,0,12,0,12,275,64,61,32,214,66,7251
15000US060374802013,447,71,16,21,16,21,0,12,431,74,75,39,356,79,7252
15000US060374802021,346,49,4,8,0,12,4,8,342,48,27,18,315,52,7253
15000US060374802022,282,41,0,12,0,12,0,12,282,41,62,27,220,42,7254
15000US060374802023,300,50,5,8,0,12,5,8,295,50,55,29,240,49,7255
15000US060374803021,341,79,0,12,0,12,0,12,341,79,85,53,256,69,7256
15000US060374803022,578,88,8,12,0,12,8,12,570,86,62,36,508,97,7257
15000US060374803023,769,110,9,15,0,12,9,15,760,110,92,40,668,104,7258
15000US060374803031,416,81,59,37,9,13,50,36,357,84,7,12,350,86,7259
15000US060374803032,1011,90,42,30,17,18,25,23,969,99,182,66,787,100,7260
15000US060374803041,927,100,40,36,0,12,40,36,887,107,122,57,765,116,7261
15000US060374803042,324,70,23,32,0,12,23,32,301,65,73,37,228,61,7262
15000US060374803043,562,103,0,12,0,12,0,12,562,103,129,64,433,97,7263
15000US060374804001,373,93,17,28,0,12,17,28,356,95,47,44,309,104,7264
15000US060374804002,1094,154,41,42,18,29,23,29,1053,155,100,61,953,152,7265
15000US060374804003,821,122,18,29,0,12,18,29,803,122,105,71,698,127,7266
15000US060374805001,561,99,0,12,0,12,0,12,561,99,56,49,505,108,7267
15000US060374805002,620,113,10,15,10,15,0,12,610,113,156,80,454,110,7268
15000US060374805003,472,104,14,23,14,23,0,12,458,107,66,46,392,116,7269
15000US060374805004,377,81,10,17,0,12,10,17,367,83,59,67,308,74,7270
15000US060374806001,577,93,17,28,0,12,17,28,560,92,131,76,429,87,7271
15000US060374806002,264,88,0,12,0,12,0,12,264,88,99,62,165,68,7272
15000US060374806003,584,113,0,12,0,12,0,12,584,113,195,97,389,107,7273
15000US060374806004,1360,178,39,39,24,29,15,25,1321,180,148,70,1173,196,7274
15000US060374806005,346,74,17,27,17,27,0,12,329,76,70,64,259,70,7275
15000US060374806006,333,90,0,12,0,12,0,12,333,90,74,57,259,99,7276
15000US060374807021,624,75,0,12,0,12,0,12,624,75,130,49,494,78,7277
15000US060374807022,1023,94,25,24,0,12,25,24,998,101,139,67,859,110,7278
15000US060374807031,314,63,0,12,0,12,0,12,314,63,35,32,279,63,7279
15000US060374807032,220,81,0,12,0,12,0,12,220,81,11,19,209,79,7280
15000US060374807033,658,80,0,12,0,12,0,12,658,80,37,30,621,85,7281
15000US060374807041,651,91,8,12,0,12,8,12,643,93,73,49,570,95,7282
15000US060374807042,1182,109,17,20,0,12,17,20,1165,111,144,57,1021,124,7283
15000US060374808021,256,59,10,16,0,12,10,16,246,57,66,45,180,64,7284
15000US060374808022,722,74,24,24,17,21,7,13,698,74,133,49,565,89,7285
15000US060374808031,238,69,22,35,22,35,0,12,216,64,42,32,174,65,7286
15000US060374808032,285,75,17,20,9,14,8,14,268,79,84,53,184,63,7287
15000US060374808033,275,63,13,18,5,12,8,14,262,65,60,34,202,59,7288
15000US060374808034,397,78,26,29,26,29,0,12,371,84,51,29,320,87,7289
15000US060374808041,976,118,40,39,22,26,18,29,936,120,112,55,824,123,7290
15000US060374808042,892,112,53,51,24,25,29,45,839,111,125,60,714,107,7291
15000US060374809011,1116,103,89,61,0,12,89,61,1027,113,171,82,856,130,7292
15000US060374809012,479,86,29,29,8,13,21,26,450,84,131,56,319,85,7293
15000US060374809021,972,108,60,44,40,38,20,20,912,108,141,71,771,106,7294
15000US060374809022,379,91,0,12,0,12,0,12,379,91,19,20,360,94,7295
15000US060374809031,956,53,61,34,11,12,50,32,895,61,131,44,764,67,7296
15000US060374810011,142,61,0,12,0,12,0,12,142,61,26,25,116,55,7297
15000US060374810012,885,96,36,34,9,14,27,32,849,96,205,71,644,127,7298
15000US060374810013,369,83,37,30,11,16,26,25,332,80,82,41,250,73,7299
15000US060374810021,534,114,76,58,35,45,41,42,458,138,50,34,408,139,7300
15000US060374810022,1165,137,148,101,22,25,126,103,1017,147,70,57,947,159,7301
15000US060374810023,275,105,0,12,0,12,0,12,275,105,31,39,244,99,7302
15000US060374811011,768,99,22,18,0,12,22,18,746,98,52,33,694,104,7303
15000US060374811012,662,81,25,23,16,18,9,13,637,85,82,42,555,88,7304
15000US060374811021,479,105,27,24,12,17,15,16,452,105,77,46,375,101,7305
15000US060374811022,255,74,0,12,0,12,0,12,255,74,48,32,207,74,7306
15000US060374811023,616,98,35,27,29,27,6,9,581,98,42,35,539,98,7307
15000US060374811031,411,83,34,32,0,12,34,32,377,82,66,34,311,85,7308
15000US060374811032,170,71,0,12,0,12,0,12,170,71,43,25,127,67,7309
15000US060374811033,467,102,30,24,9,15,21,20,437,102,20,18,417,103,7310
15000US060374811034,158,51,12,18,0,12,12,18,146,52,24,21,122,50,7311
15000US060374811035,224,48,16,19,0,12,16,19,208,48,63,31,145,48,7312
15000US060374812011,290,66,10,16,0,12,10,16,280,65,82,36,198,72,7313
15000US060374812012,461,79,23,22,13,14,10,17,438,81,75,39,363,74,7314
15000US060374812013,460,79,51,43,23,23,28,36,409,84,39,32,370,85,7315
15000US060374812021,870,133,80,41,26,23,54,32,790,131,102,60,688,134,7316
15000US060374812022,475,80,7,11,0,12,7,11,468,83,135,55,333,86,7317
15000US060374812023,442,96,15,21,15,21,0,12,427,94,78,37,349,96,7318
15000US060374813001,359,46,19,14,14,12,5,8,340,48,141,42,199,45,7319
15000US060374813002,490,51,27,18,8,12,19,15,463,55,92,32,371,63,7320
15000US060374814011,1082,110,43,31,9,13,34,27,1039,107,89,37,950,108,7321
15000US060374814012,562,82,8,12,0,12,8,12,554,81,146,50,408,88,7322
15000US060374814013,226,63,15,17,9,15,6,9,211,60,29,36,182,53,7323
15000US060374814021,222,61,21,27,6,14,15,23,201,64,130,65,71,46,7324
15000US060374814022,709,139,29,34,0,12,29,34,680,141,197,72,483,137,7325
15000US060374814023,360,94,37,42,37,42,0,12,323,99,48,51,275,96,7326
15000US060374814024,212,71,0,12,0,12,0,12,212,71,71,45,141,71,7327
15000US060374814025,397,99,18,29,18,29,0,12,379,100,86,63,293,100,7328
15000US060374814026,129,48,13,21,13,21,0,12,116,49,12,20,104,48,7329
15000US060374815001,380,66,6,11,6,11,0,12,374,66,111,48,263,76,7330
15000US060374815002,208,57,0,12,0,12,0,12,208,57,37,26,171,61,7331
15000US060374815003,704,93,10,17,0,12,10,17,694,89,108,42,586,92,7332
15000US060374815004,227,59,0,12,0,12,0,12,227,59,29,28,198,60,7333
15000US060374816031,952,92,36,31,0,12,36,31,916,101,125,50,791,98,7334
15000US060374816032,266,63,9,15,0,12,9,15,257,64,82,39,175,63,7335
15000US060374816041,260,71,11,14,7,12,4,8,249,72,17,18,232,72,7336
15000US060374816042,1111,78,82,46,21,21,61,40,1029,93,135,49,894,99,7337
15000US060374816051,345,79,8,12,0,12,8,12,337,81,61,35,276,84,7338
15000US060374816052,333,69,43,32,5,10,38,33,290,65,144,68,146,49,7339
15000US060374816053,344,79,9,14,0,12,9,14,335,81,68,42,267,85,7340
15000US060374816061,592,80,8,12,8,12,0,12,584,80,129,60,455,78,7341
15000US060374816062,577,83,36,35,7,10,29,34,541,80,93,59,448,94,7342
15000US060374816063,402,74,65,60,7,12,58,58,337,76,36,28,301,78,7343
15000US060374817111,643,94,71,36,28,26,43,37,572,93,133,59,439,100,7344
15000US060374817112,727,89,25,29,14,24,11,18,702,92,104,51,598,106,7345
15000US060374817121,869,91,72,40,35,27,37,29,797,94,164,62,633,113,7346
15000US060374817122,770,98,10,16,0,12,10,16,760,100,172,74,588,101,7347
15000US060374817131,702,74,39,24,18,16,21,17,663,78,149,47,514,86,7348
15000US060374817132,213,56,16,19,5,8,11,18,197,53,21,18,176,54,7349
15000US060374817141,531,65,54,30,10,12,44,27,477,64,183,53,294,62,7350
15000US060374817142,316,49,10,11,0,12,10,11,306,50,34,19,272,52,7351
15000US060374818001,204,31,3,6,3,6,0,12,201,32,65,24,136,32,7352
15000US060374818002,481,43,32,28,6,10,26,26,449,50,147,50,302,49,7353
15000US060374818003,225,31,3,5,0,12,3,5,222,32,43,24,179,37,7354
15000US060374819011,403,88,10,15,0,12,10,15,393,87,82,41,311,88,7355
15000US060374819012,238,53,7,11,0,12,7,11,231,56,73,36,158,60,7356
15000US060374819013,557,78,0,12,0,12,0,12,557,78,120,55,437,74,7357
15000US060374819014,709,106,24,22,10,15,14,16,685,107,71,37,614,107,7358
15000US060374819021,1090,84,65,42,14,19,51,38,1025,89,199,75,826,102,7359
15000US060374820011,801,54,0,12,0,12,0,12,801,54,163,68,638,79,7360
15000US060374820012,245,45,10,16,0,12,10,16,235,46,61,35,174,51,7361
15000US060374820021,373,101,0,12,0,12,0,12,373,101,79,57,294,83,7362
15000US060374820022,916,162,67,52,0,12,67,52,849,170,113,67,736,169,7363
15000US060374820023,588,155,38,46,22,36,16,29,550,152,116,64,434,149,7364
15000US060374820024,411,111,0,12,0,12,0,12,411,111,88,72,323,124,7365
15000US060374821011,298,65,40,44,0,12,40,44,258,66,92,36,166,65,7366
15000US060374821012,479,76,30,22,11,17,19,22,449,82,93,39,356,90,7367
15000US060374821013,698,82,52,51,0,12,52,51,646,75,166,50,480,81,7368
15000US060374821021,533,57,12,13,6,9,6,10,521,58,161,53,360,53,7369
15000US060374821022,387,61,10,12,4,6,6,10,377,63,51,29,326,66,7370
15000US060374822011,346,70,45,38,0,12,45,38,301,74,109,48,192,74,7371
15000US060374822012,483,83,22,31,16,27,6,11,461,78,83,36,378,85,7372
15000US060374822013,425,71,39,30,16,17,23,23,386,76,55,44,331,87,7373
15000US060374822021,362,79,31,31,11,18,20,24,331,77,58,40,273,79,7374
15000US060374822022,614,96,59,35,21,22,38,31,555,97,140,66,415,96,7375
15000US060374822023,604,78,20,23,20,23,0,12,584,80,95,43,489,89,7376
15000US060374823011,116,35,0,12,0,12,0,12,116,35,0,12,116,35,7377
15000US060374823012,271,70,0,12,0,12,0,12,271,70,45,43,226,74,7378
15000US060374823013,340,91,29,25,7,13,22,20,311,96,30,26,281,96,7379
15000US060374823014,317,97,48,36,6,9,42,35,269,89,43,31,226,88,7380
15000US060374823015,336,91,25,30,12,19,13,22,311,94,32,26,279,96,7381
15000US060374823031,390,82,54,44,23,38,31,25,336,79,66,41,270,80,7382
15000US060374823032,633,93,81,60,9,14,72,59,552,93,87,51,465,91,7383
15000US060374823033,497,76,38,35,0,12,38,35,459,83,100,53,359,88,7384
15000US060374823041,495,60,67,36,5,9,62,36,428,69,90,40,338,77,7385
15000US060374823042,494,59,55,31,18,17,37,26,439,64,71,28,368,61,7386
15000US060374824011,207,47,12,9,5,8,7,10,195,48,49,26,146,55,7387
15000US060374824012,196,50,7,12,0,12,7,12,189,50,50,24,139,46,7388
15000US060374824013,562,61,31,21,24,18,7,10,531,64,114,44,417,75,7389
15000US060374824021,837,158,70,59,17,26,53,52,767,163,151,101,616,166,7390
15000US060374824022,1428,157,16,25,0,12,16,25,1412,157,329,141,1083,194,7391
15000US060374825021,406,58,29,21,3,5,26,20,377,58,74,30,303,58,7392
15000US060374825022,420,52,38,24,6,9,32,21,382,56,87,36,295,62,7393
15000US060374825031,422,65,59,39,29,23,30,32,363,67,76,38,287,71,7394
15000US060374825032,651,74,55,46,25,26,30,36,596,87,100,44,496,88,7395
15000US060374825211,458,95,67,55,7,12,60,55,391,97,63,37,328,98,7396
15000US060374825212,390,99,11,16,11,16,0,12,379,99,99,59,280,94,7397
15000US060374825213,691,102,64,41,25,24,39,37,627,99,227,69,400,107,7398
15000US060374825221,657,86,57,53,0,12,57,53,600,88,217,90,383,96,7399
15000US060374825222,276,68,19,28,0,12,19,28,257,65,104,63,153,46,7400
15000US060374825223,579,97,0,12,0,12,0,12,579,97,74,53,505,100,7401
15000US060374826001,499,92,21,33,0,12,21,33,478,92,197,86,281,96,7402
15000US060374826002,817,106,12,19,0,12,12,19,805,108,207,92,598,114,7403
15000US060374826003,522,136,0,12,0,12,0,12,522,136,95,96,427,144,7404
15000US060374826004,470,98,14,22,14,22,0,12,456,100,132,76,324,97,7405
15000US060374827011,198,62,0,12,0,12,0,12,198,62,59,41,139,66,7406
15000US060374827012,282,75,0,12,0,12,0,12,282,75,54,35,228,77,7407
15000US060374827013,142,75,0,12,0,12,0,12,142,75,43,36,99,68,7408
15000US060374827014,669,105,40,45,0,12,40,45,629,114,115,52,514,126,7409
15000US060374827021,477,66,0,12,0,12,0,12,477,66,146,50,331,60,7410
15000US060374827022,319,58,0,12,0,12,0,12,319,58,109,34,210,47,7411
15000US060374828001,269,51,0,12,0,12,0,12,269,51,81,37,188,49,7412
15000US060374828002,324,64,87,46,34,41,53,38,237,58,55,31,182,58,7413
15000US060374828003,739,82,60,53,10,16,50,49,679,86,180,62,499,94,7414
15000US060375001001,505,100,30,45,0,12,30,45,475,100,108,43,367,103,7415
15000US060375001002,450,98,43,63,0,12,43,63,407,101,45,30,362,102,7416
15000US060375001003,203,61,0,12,0,12,0,12,203,61,45,33,158,66,7417
15000US060375002011,803,137,67,71,13,20,54,69,736,140,221,107,515,149,7418
15000US060375002012,549,103,0,12,0,12,0,12,549,103,91,68,458,111,7419
15000US060375002013,657,123,12,24,12,24,0,12,645,125,196,87,449,132,7420
15000US060375002021,257,54,0,12,0,12,0,12,257,54,23,21,234,55,7421
15000US060375002022,219,62,0,12,0,12,0,12,219,62,52,27,167,69,7422
15000US060375002023,273,74,0,12,0,12,0,12,273,74,56,45,217,71,7423
15000US060375002024,286,62,8,13,0,12,8,13,278,62,59,29,219,68,7424
15000US060375002025,467,75,0,12,0,12,0,12,467,75,71,37,396,80,7425
15000US060375003001,1106,35,21,28,15,26,6,9,1085,45,214,81,871,95,7426
15000US060375004021,308,66,17,20,8,13,9,15,291,67,84,52,207,68,7427
15000US060375004022,296,77,53,45,25,38,28,26,243,75,52,43,191,81,7428
15000US060375004023,597,91,101,59,49,47,52,45,496,103,197,83,299,108,7429
15000US060375004031,425,74,10,15,10,15,0,12,415,78,157,70,258,89,7430
15000US060375004032,657,75,84,56,20,31,64,65,573,77,131,66,442,92,7431
15000US060375004041,383,93,66,58,28,28,38,51,317,87,107,73,210,75,7432
15000US060375004042,211,62,27,23,17,18,10,16,184,64,60,34,124,63,7433
15000US060375004043,525,99,66,58,37,36,29,44,459,112,139,60,320,100,7434
15000US060375004044,221,69,27,43,27,43,0,12,194,59,32,28,162,62,7435
15000US060375005001,888,46,104,50,55,37,49,35,784,69,179,52,605,78,7436
15000US060375006001,263,71,14,22,0,12,14,22,249,74,119,61,130,60,7437
15000US060375006002,196,66,46,41,13,16,33,37,150,60,14,16,136,59,7438
15000US060375006003,163,56,34,33,0,12,34,33,129,50,47,33,82,37,7439
15000US060375006004,316,72,21,28,0,12,21,28,295,73,117,56,178,80,7440
15000US060375006005,408,98,81,63,25,29,56,57,327,98,30,26,297,100,7441
15000US060375007001,261,72,34,36,16,20,18,31,227,70,105,61,122,54,7442
15000US060375007002,351,70,27,24,27,24,0,12,324,72,105,44,219,68,7443
15000US060375007003,362,74,15,15,8,14,7,12,347,75,102,53,245,70,7444
15000US060375007004,324,87,26,29,7,10,19,28,298,92,79,61,219,84,7445
15000US060375007005,352,75,35,39,0,12,35,39,317,81,38,30,279,83,7446
15000US060375007006,103,46,0,12,0,12,0,12,103,46,29,26,74,46,7447
15000US060375008001,274,59,19,23,8,17,11,17,255,61,51,32,204,60,7448
15000US060375008002,268,80,23,18,15,18,8,13,245,81,44,29,201,79,7449
15000US060375008003,239,64,16,18,0,12,16,18,223,66,91,42,132,68,7450
15000US060375008004,634,107,11,15,11,15,0,12,623,108,159,67,464,85,7451
15000US060375009001,307,72,6,11,6,11,0,12,301,70,91,39,210,80,7452
15000US060375009002,360,81,16,19,8,14,8,13,344,80,49,28,295,83,7453
15000US060375009003,618,92,138,57,46,33,92,49,480,95,189,67,291,88,7454
15000US060375009004,339,79,70,51,9,13,61,49,269,72,73,33,196,70,7455
15000US060375010011,282,52,32,26,26,25,6,9,250,48,75,36,175,48,7456
15000US060375010012,219,48,10,11,5,8,5,8,209,48,73,33,136,43,7457
15000US060375010013,228,49,17,20,12,18,5,7,211,51,65,44,146,42,7458
15000US060375010021,290,63,0,12,0,12,0,12,290,63,45,34,245,66,7459
15000US060375010022,240,83,0,12,0,12,0,12,240,83,57,35,183,82,7460
15000US060375010023,361,87,8,13,0,12,8,13,353,87,80,54,273,88,7461
15000US060375010024,195,58,0,12,0,12,0,12,195,58,77,48,118,62,7462
15000US060375010025,332,65,25,23,0,12,25,23,307,68,93,57,214,68,7463
15000US060375012001,945,85,41,36,8,13,33,34,904,90,267,63,637,110,7464
15000US060375012002,550,77,13,23,0,12,13,23,537,78,151,62,386,82,7465
15000US060375013001,336,99,12,20,0,12,12,20,324,99,128,83,196,102,7466
15000US060375013002,918,166,112,97,70,83,42,51,806,172,110,69,696,178,7467
15000US060375013003,336,106,11,18,0,12,11,18,325,104,38,36,287,100,7468
15000US060375013004,359,120,0,12,0,12,0,12,359,120,87,54,272,124,7469
15000US060375013005,344,115,0,12,0,12,0,12,344,115,88,48,256,132,7470
15000US060375013006,169,79,0,12,0,12,0,12,169,79,36,36,133,87,7471
15000US060375014001,424,77,6,11,0,12,6,11,418,80,118,55,300,66,7472
15000US060375014002,398,75,38,37,9,13,29,34,360,89,52,35,308,95,7473
15000US060375014003,378,71,40,33,5,8,35,33,338,81,52,37,286,79,7474
15000US060375015011,867,29,15,16,9,13,6,8,852,35,199,63,653,66,7475
15000US060375015031,481,90,37,37,0,12,37,37,444,92,62,34,382,97,7476
15000US060375015032,264,53,7,11,7,11,0,12,257,57,54,42,203,64,7477
15000US060375015033,600,96,12,19,0,12,12,19,588,98,101,41,487,103,7478
15000US060375015034,531,87,49,39,8,12,41,37,482,90,41,36,441,85,7479
15000US060375015041,578,85,27,22,27,22,0,12,551,90,250,73,301,79,7480
15000US060375015042,553,93,94,52,43,42,51,42,459,87,94,57,365,94,7481
15000US060375015043,390,84,87,53,34,36,53,48,303,69,36,31,267,71,7482
15000US060375016001,903,138,13,24,13,24,0,12,890,141,165,76,725,144,7483
15000US060375016002,652,127,85,74,60,80,25,43,567,131,35,41,532,128,7484
15000US060375016003,291,103,16,27,16,27,0,12,275,102,97,70,178,92,7485
15000US060375016004,276,92,0,12,0,12,0,12,276,92,14,22,262,94,7486
15000US060375016005,152,65,0,12,0,12,0,12,152,65,40,45,112,53,7487
15000US060375017001,266,60,0,12,0,12,0,12,266,60,67,32,199,59,7488
15000US060375017002,249,68,10,21,0,12,10,21,239,64,46,51,193,61,7489
15000US060375017003,326,68,10,16,0,12,10,16,316,68,36,28,280,70,7490
15000US060375017004,335,62,0,12,0,12,0,12,335,62,50,28,285,68,7491
15000US060375018021,364,71,4,7,0,12,4,7,360,70,48,31,312,76,7492
15000US060375018022,365,85,20,21,0,12,20,21,345,87,9,11,336,88,7493
15000US060375018023,477,87,38,45,29,40,9,17,439,92,110,53,329,81,7494
15000US060375018031,691,80,184,74,83,52,101,57,507,91,169,61,338,89,7495
15000US060375018032,760,85,162,56,41,34,121,45,598,98,78,50,520,103,7496
15000US060375018041,493,60,23,18,15,12,8,14,470,59,120,39,350,58,7497
15000US060375018042,207,49,36,29,10,15,26,25,171,48,59,38,112,36,7498
15000US060375019001,467,89,0,12,0,12,0,12,467,89,113,53,354,87,7499
15000US060375019002,359,85,0,12,0,12,0,12,359,85,30,27,329,85,7500
15000US060375019003,279,79,26,28,15,21,11,17,253,80,25,26,228,81,7501
15000US060375019004,212,62,0,12,0,12,0,12,212,62,81,38,131,57,7502
15000US060375020031,357,53,16,13,15,13,1,3,341,55,52,26,289,56,7503
15000US060375020032,430,57,68,39,25,21,43,33,362,65,49,25,313,64,7504
15000US060375020041,309,39,13,12,9,10,4,8,296,38,69,32,227,50,7505
15000US060375020042,647,60,79,38,41,25,38,31,568,67,110,39,458,73,7506
15000US060375020051,423,74,28,41,0,12,28,41,395,72,144,76,251,82,7507
15000US060375020052,403,68,35,38,5,8,30,38,368,79,133,68,235,90,7508
15000US060375020053,427,82,7,11,0,12,7,11,420,82,101,55,319,87,7509
15000US060375021001,277,76,16,20,9,14,7,12,261,75,105,44,156,79,7510
15000US060375021002,768,100,3,8,3,8,0,12,765,102,228,96,537,104,7511
15000US060375021003,562,107,55,43,24,24,31,38,507,103,150,64,357,104,7512
15000US060375022001,777,112,63,46,46,41,17,19,714,108,269,81,445,104,7513
15000US060375022002,262,64,19,19,9,13,10,16,243,63,93,42,150,62,7514
15000US060375022003,143,67,44,45,26,41,18,21,99,59,37,50,62,32,7515
15000US060375022004,296,60,10,16,0,12,10,16,286,59,77,48,209,67,7516
15000US060375022005,347,86,46,46,8,13,38,44,301,91,86,56,215,87,7517
15000US060375023011,396,89,17,28,17,28,0,12,379,94,150,79,229,91,7518
15000US060375023012,290,78,15,26,0,12,15,26,275,80,114,79,161,63,7519
15000US060375023013,228,61,36,40,25,36,11,19,192,72,89,60,103,64,7520
15000US060375023014,309,83,25,42,0,12,25,42,284,78,68,38,216,82,7521
15000US060375023015,169,64,20,23,0,12,20,23,149,69,39,43,110,66,7522
15000US060375023021,747,43,132,59,39,40,93,44,615,71,196,53,419,70,7523
15000US060375024011,357,80,17,23,17,23,0,12,340,76,88,53,252,62,7524
15000US060375024012,340,85,39,43,39,43,0,12,301,80,49,33,252,86,7525
15000US060375024013,550,81,48,49,0,12,48,49,502,90,125,61,377,91,7526
15000US060375024021,216,51,11,16,0,12,11,16,205,54,62,31,143,47,7527
15000US060375024022,287,47,17,12,10,11,7,8,270,49,60,31,210,52,7528
15000US060375024023,439,58,19,21,0,12,19,21,420,61,95,31,325,61,7529
15000US060375025001,533,78,33,39,33,39,0,12,500,80,165,78,335,84,7530
15000US060375025002,588,73,58,48,31,36,27,33,530,80,103,48,427,94,7531
15000US060375026011,516,83,26,31,16,26,10,16,490,83,119,57,371,78,7532
15000US060375026012,226,62,0,12,0,12,0,12,226,62,89,55,137,55,7533
15000US060375026013,463,63,51,37,41,33,10,15,412,63,101,52,311,70,7534
15000US060375026014,376,77,23,21,23,21,0,12,353,77,46,33,307,79,7535
15000US060375026015,209,62,50,56,0,12,50,56,159,54,38,21,121,52,7536
15000US060375026021,655,90,119,72,40,45,79,59,536,96,74,50,462,94,7537
15000US060375026022,444,89,0,12,0,12,0,12,444,89,118,47,326,88,7538
15000US060375026023,288,49,0,12,0,12,0,12,288,49,138,58,150,56,7539
15000US060375027001,410,74,26,25,19,22,7,12,384,74,130,63,254,70,7540
15000US060375027002,383,74,50,40,28,46,22,34,333,77,114,49,219,77,7541
15000US060375027003,403,90,9,14,9,14,0,12,394,90,105,57,289,88,7542
15000US060375027004,348,90,0,12,0,12,0,12,348,90,152,69,196,82,7543
15000US060375027005,345,89,45,33,9,13,36,31,300,86,102,50,198,78,7544
15000US060375028011,257,72,22,19,13,14,9,14,235,72,76,57,159,64,7545
15000US060375028012,509,99,44,45,31,41,13,16,465,102,108,58,357,102,7546
15000US060375028013,315,73,0,12,0,12,0,12,315,73,83,47,232,72,7547
15000US060375028014,374,94,28,31,18,28,10,16,346,94,43,43,303,98,7548
15000US060375028015,326,103,0,12,0,12,0,12,326,103,61,41,265,110,7549
15000US060375028021,873,68,146,47,84,41,62,33,727,76,254,54,473,83,7550
15000US060375028022,248,47,0,12,0,12,0,12,248,47,21,29,227,46,7551
15000US060375029011,408,83,20,24,9,16,11,18,388,83,162,60,226,88,7552
15000US060375029012,670,84,38,30,7,11,31,29,632,88,125,53,507,83,7553
15000US060375029013,364,83,45,43,10,15,35,40,319,74,124,65,195,66,7554
15000US060375029021,376,55,49,32,21,21,28,25,327,56,115,39,212,50,7555
15000US060375029022,200,49,19,20,8,12,11,16,181,48,19,14,162,50,7556
15000US060375029023,376,54,131,38,69,25,62,30,245,53,93,45,152,45,7557
15000US060375030001,241,86,96,54,53,53,43,40,145,65,41,38,104,70,7558
15000US060375030002,490,122,63,54,9,16,54,52,427,112,115,58,312,104,7559
15000US060375030003,501,109,104,65,0,12,104,65,397,111,116,56,281,104,7560
15000US060375031031,457,80,37,41,0,12,37,41,420,81,64,36,356,82,7561
15000US060375031032,292,63,0,12,0,12,0,12,292,63,43,39,249,61,7562
15000US060375031033,220,61,17,20,17,20,0,12,203,63,115,54,88,46,7563
15000US060375031034,168,48,11,17,11,17,0,12,157,50,65,40,92,39,7564
15000US060375031041,114,36,18,16,0,12,18,16,96,35,10,12,86,34,7565
15000US060375031042,490,46,70,40,29,21,41,36,420,66,118,42,302,69,7566
15000US060375031051,454,64,48,31,16,20,32,26,406,67,123,51,283,68,7567
15000US060375031052,575,66,82,50,16,26,66,42,493,70,90,34,403,72,7568
15000US060375031061,304,76,35,42,0,12,35,42,269,64,65,32,204,68,7569
15000US060375031062,266,74,7,11,0,12,7,11,259,75,108,75,151,73,7570
15000US060375031063,483,72,9,13,9,13,0,12,474,72,231,70,243,87,7571
15000US060375032011,365,74,5,11,5,11,0,12,360,75,56,35,304,77,7572
15000US060375032012,500,82,35,36,8,13,27,34,465,82,130,61,335,90,7573
15000US060375032013,237,69,18,19,10,16,8,12,219,65,72,38,147,67,7574
15000US060375032021,670,101,50,47,50,47,0,12,620,93,194,75,426,95,7575
15000US060375032022,195,56,0,12,0,12,0,12,195,56,44,35,151,63,7576
15000US060375032023,429,85,126,72,42,45,84,74,303,80,82,45,221,84,7577
15000US060375033011,233,63,0,12,0,12,0,12,233,63,47,40,186,64,7578
15000US060375033012,356,81,13,19,3,8,10,18,343,85,87,50,256,84,7579
15000US060375033013,233,70,9,15,0,12,9,15,224,68,30,27,194,69,7580
15000US060375033014,176,51,0,12,0,12,0,12,176,51,10,16,166,55,7581
15000US060375033021,392,75,43,42,21,32,22,34,349,74,95,47,254,67,7582
15000US060375033022,1004,112,29,33,0,12,29,33,975,116,145,69,830,113,7583
15000US060375033023,432,80,67,61,21,34,46,51,365,75,81,61,284,74,7584
15000US060375034011,329,73,10,21,0,12,10,21,319,72,116,62,203,74,7585
15000US060375034012,621,141,0,12,0,12,0,12,621,141,132,64,489,141,7586
15000US060375034013,390,108,0,12,0,12,0,12,390,108,109,86,281,100,7587
15000US060375034014,424,126,0,12,0,12,0,12,424,126,62,50,362,124,7588
15000US060375034015,490,151,0,12,0,12,0,12,490,151,69,45,421,156,7589
15000US060375034021,625,74,14,20,14,20,0,12,611,70,89,42,522,79,7590
15000US060375034022,493,72,7,11,0,12,7,11,486,70,152,58,334,71,7591
15000US060375034023,241,54,0,12,0,12,0,12,241,54,110,49,131,51,7592
15000US060375035011,163,44,0,12,0,12,0,12,163,44,99,45,64,39,7593
15000US060375035012,756,103,41,33,19,22,22,23,715,101,138,68,577,99,7594
15000US060375035013,1084,128,34,33,0,12,34,33,1050,133,240,84,810,119,7595
15000US060375035021,251,72,19,21,12,18,7,12,232,73,103,58,129,57,7596
15000US060375035022,299,65,0,12,0,12,0,12,299,65,38,29,261,66,7597
15000US060375035023,352,70,47,52,0,12,47,52,305,65,72,40,233,64,7598
15000US060375035024,322,56,24,23,0,12,24,23,298,61,43,34,255,64,7599
15000US060375036011,702,68,34,33,0,12,34,33,668,72,191,64,477,79,7600
15000US060375036012,186,50,0,12,0,12,0,12,186,50,35,26,151,49,7601
15000US060375036013,312,72,0,12,0,12,0,12,312,72,79,48,233,74,7602
15000US060375036021,409,63,6,10,0,12,6,10,403,61,100,37,303,68,7603
15000US060375036022,816,70,30,25,9,13,21,22,786,75,175,67,611,82,7604
15000US060375037011,778,122,0,12,0,12,0,12,778,122,212,80,566,119,7605
15000US060375037012,944,115,59,52,22,23,37,47,885,120,185,75,700,120,7606
15000US060375037021,562,77,0,12,0,12,0,12,562,77,131,58,431,73,7607
15000US060375037022,1082,93,100,70,32,28,68,70,982,106,235,69,747,109,7608
15000US060375037031,667,131,0,12,0,12,0,12,667,131,121,94,546,104,7609
15000US060375037032,1070,132,0,12,0,12,0,12,1070,132,195,74,875,143,7610
15000US060375037033,1179,159,24,28,0,12,24,28,1155,158,282,101,873,148,7611
15000US060375038011,383,68,28,31,12,18,16,25,355,69,91,44,264,72,7612
15000US060375038012,286,61,0,12,0,12,0,12,286,61,68,30,218,62,7613
15000US060375038013,195,52,12,19,0,12,12,19,183,55,23,22,160,60,7614
15000US060375038014,351,57,0,12,0,12,0,12,351,57,66,34,285,65,7615
15000US060375038021,305,65,0,12,0,12,0,12,305,65,82,37,223,68,7616
15000US060375038022,276,56,0,12,0,12,0,12,276,56,61,33,215,52,7617
15000US060375038023,1066,101,6,12,6,12,0,12,1060,104,222,74,838,119,7618
15000US060375039011,322,49,12,13,0,12,12,13,310,52,122,45,188,48,7619
15000US060375039012,494,59,9,11,9,11,0,12,485,57,112,31,373,64,7620
15000US060375039021,159,51,7,12,7,12,0,12,152,51,15,20,137,50,7621
15000US060375039022,229,44,11,16,11,16,0,12,218,48,54,33,164,51,7622
15000US060375039023,507,79,23,26,10,16,13,21,484,80,68,39,416,88,7623
15000US060375039024,488,75,38,41,31,39,7,11,450,75,125,65,325,74,7624
15000US060375040011,403,54,41,27,16,18,25,20,362,56,96,46,266,63,7625
15000US060375040012,511,70,0,12,0,12,0,12,511,70,208,69,303,73,7626
15000US060375040013,228,54,0,12,0,12,0,12,228,54,50,32,178,57,7627
15000US060375040021,385,66,26,25,18,21,8,13,359,71,60,38,299,75,7628
15000US060375040022,360,74,7,11,0,12,7,11,353,75,46,46,307,77,7629
15000US060375040023,136,63,0,12,0,12,0,12,136,63,18,17,118,63,7630
15000US060375040024,248,68,37,46,0,12,37,46,211,54,85,37,126,52,7631
15000US060375040025,373,80,15,18,15,18,0,12,358,79,48,28,310,79,7632
15000US060375041011,732,74,51,47,5,8,46,48,681,76,260,66,421,77,7633
15000US060375041012,427,60,30,29,30,29,0,12,397,58,122,45,275,64,7634
15000US060375041013,245,58,10,13,6,11,4,6,235,59,74,40,161,66,7635
15000US060375041021,0,12,0,12,0,12,0,12,0,12,0,12,0,12,7636
15000US060375300031,460,54,30,27,15,15,15,23,430,56,134,40,296,57,7637
15000US060375300032,554,61,21,26,21,26,0,12,533,57,215,54,318,51,7638
15000US060375300041,169,55,0,12,0,12,0,12,169,55,86,52,83,51,7639
15000US060375300042,1067,95,93,69,72,59,21,34,974,98,273,81,701,119,7640
15000US060375300051,705,113,24,27,24,27,0,12,681,115,283,109,398,90,7641
15000US060375300052,822,108,0,12,0,12,0,12,822,108,275,113,547,101,7642
15000US060375300061,1030,121,48,49,0,12,48,49,982,130,263,106,719,114,7643
15000US060375300062,370,90,35,29,24,21,11,16,335,95,94,49,241,96,7644
15000US060375301011,714,118,199,85,87,53,112,76,515,115,115,66,400,118,7645
15000US060375301012,462,100,54,48,9,15,45,43,408,97,116,55,292,93,7646
15000US060375301013,412,86,75,65,13,16,62,63,337,75,108,60,229,63,7647
15000US060375301014,192,71,7,12,0,12,7,12,185,70,41,32,144,62,7648
15000US060375301021,379,100,11,24,11,24,0,12,368,95,113,70,255,103,7649
15000US060375301022,460,98,47,55,1,6,46,55,413,89,113,64,300,83,7650
15000US060375301023,357,89,27,34,27,34,0,12,330,83,100,55,230,82,7651
15000US060375301024,524,86,26,25,0,12,26,25,498,87,260,74,238,77,7652
15000US060375302021,400,87,0,12,0,12,0,12,400,87,60,32,340,92,7653
15000US060375302022,483,103,43,37,27,29,16,23,440,106,59,33,381,111,7654
15000US060375302023,382,110,29,33,29,33,0,12,353,108,73,40,280,113,7655
15000US060375302031,720,96,153,84,68,59,85,50,567,116,182,78,385,100,7656
15000US060375302032,259,55,7,11,7,11,0,12,252,54,173,60,79,50,7657
15000US060375302041,411,100,118,62,43,39,75,57,293,92,87,62,206,76,7658
15000US060375302042,737,99,91,61,5,13,86,60,646,96,143,76,503,103,7659
15000US060375303011,338,56,32,25,4,6,28,26,306,61,67,32,239,62,7660
15000US060375303012,261,46,60,35,8,9,52,35,201,46,55,31,146,40,7661
15000US060375303021,394,82,20,17,5,10,15,17,374,82,126,59,248,81,7662
15000US060375303022,635,109,70,64,5,8,65,64,565,114,177,66,388,123,7663
15000US060375303023,378,92,38,31,21,22,17,19,340,96,95,57,245,94,7664
15000US060375303024,450,80,49,49,0,12,49,49,401,86,99,45,302,84,7665
15000US060375304001,556,94,150,61,43,35,107,53,406,97,230,96,176,83,7666
15000US060375304002,661,109,58,41,21,26,37,33,603,104,153,71,450,100,7667
15000US060375305001,357,86,54,52,47,51,7,11,303,90,82,48,221,81,7668
15000US060375305002,292,73,46,46,34,42,12,18,246,72,74,45,172,63,7669
15000US060375305003,294,82,31,27,10,14,21,23,263,88,68,57,195,75,7670
15000US060375305004,254,70,27,33,9,14,18,30,227,67,51,36,176,62,7671
15000US060375306011,641,54,94,43,17,21,77,39,547,60,86,37,461,64,7672
15000US060375306012,230,42,14,14,14,14,0,12,216,45,41,19,175,46,7673
15000US060375306021,391,28,14,15,12,14,2,4,377,34,79,32,298,43,7674
15000US060375307001,562,26,83,35,48,27,35,27,479,44,125,39,354,58,7675
15000US060375308011,352,95,83,54,46,47,37,34,269,96,55,42,214,88,7676
15000US060375308012,339,94,41,41,14,21,27,36,298,92,49,41,249,90,7677
15000US060375308013,363,78,109,65,0,12,109,65,254,84,57,30,197,80,7678
15000US060375308014,432,112,15,25,0,12,15,25,417,111,52,41,365,107,7679
15000US060375308021,444,70,74,50,43,36,31,36,370,68,89,40,281,65,7680
15000US060375308022,427,75,38,24,5,8,33,27,389,71,75,36,314,77,7681
15000US060375309011,260,60,18,24,3,5,15,23,242,59,41,28,201,61,7682
15000US060375309012,360,60,74,42,15,18,59,40,286,59,61,30,225,56,7683
15000US060375309013,305,59,12,11,9,9,3,5,293,59,42,22,251,58,7684
15000US060375309021,489,87,105,67,7,14,98,65,384,80,170,66,214,70,7685
15000US060375309022,624,96,21,32,0,12,21,32,603,98,182,72,421,109,7686
15000US060375310001,476,68,40,35,22,21,18,27,436,68,127,59,309,85,7687
15000US060375310002,219,66,19,29,19,29,0,12,200,65,40,35,160,61,7688
15000US060375310003,657,80,75,46,14,16,61,41,582,87,135,57,447,94,7689
15000US060375311011,197,83,29,31,7,12,22,35,168,78,22,20,146,81,7690
15000US060375311012,409,81,59,49,0,12,59,49,350,82,69,45,281,85,7691
15000US060375311013,392,84,58,53,0,12,58,53,334,86,49,30,285,84,7692
15000US060375311014,234,82,40,51,0,12,40,51,194,65,49,46,145,62,7693
15000US060375311021,621,52,72,36,13,12,59,34,549,59,112,40,437,67,7694
15000US060375311022,275,55,9,14,9,14,0,12,266,56,72,35,194,58,7695
15000US060375312011,600,106,68,48,51,42,17,20,532,110,110,61,422,111,7696
15000US060375312012,645,107,68,51,30,28,38,42,577,108,87,56,490,116,7697
15000US060375312021,407,78,62,49,7,14,55,47,345,88,44,32,301,88,7698
15000US060375312022,726,83,97,50,29,24,68,52,629,87,116,65,513,98,7699
15000US060375313011,371,78,23,18,10,16,13,19,348,76,108,62,240,76,7700
15000US060375313012,233,75,52,49,42,46,10,15,181,62,67,36,114,57,7701
15000US060375313013,345,82,36,28,0,12,36,28,309,83,67,36,242,85,7702
15000US060375313014,306,60,69,42,17,19,52,39,237,63,68,42,169,59,7703
15000US060375313021,242,74,82,59,0,12,82,59,160,69,29,26,131,67,7704
15000US060375313022,211,72,55,46,17,20,38,40,156,68,5,11,151,66,7705
15000US060375313023,534,85,78,57,25,23,53,51,456,90,162,66,294,84,7706
15000US060375313024,344,94,36,36,7,12,29,34,308,89,140,68,168,74,7707
15000US060375313025,209,68,16,20,0,12,16,20,193,67,36,36,157,67,7708
15000US060375315021,336,51,21,22,9,10,12,20,315,57,95,44,220,60,7709
15000US060375315022,132,42,13,20,0,12,13,20,119,41,32,27,87,36,7710
15000US060375315023,115,50,5,8,5,8,0,12,110,50,24,25,86,44,7711
15000US060375315024,169,43,26,23,0,12,26,23,143,46,41,29,102,44,7712
15000US060375315031,388,62,26,24,0,12,26,24,362,65,68,41,294,61,7713
15000US060375315032,383,59,62,30,32,28,30,17,321,60,36,28,285,58,7714
15000US060375315041,684,88,172,94,29,37,143,84,512,122,144,69,368,109,7715
15000US060375315042,457,91,89,63,27,35,62,56,368,90,84,58,284,84,7716
15000US060375316021,302,74,30,36,30,36,0,12,272,62,76,44,196,66,7717
15000US060375316022,256,81,24,24,12,12,12,19,232,82,45,35,187,81,7718
15000US060375316023,633,92,190,80,31,39,159,77,443,108,73,51,370,99,7719
15000US060375316031,212,47,12,13,5,8,7,11,200,46,45,26,155,46,7720
15000US060375316032,645,54,87,43,22,24,65,36,558,55,130,39,428,67,7721
15000US060375316041,500,61,83,39,19,22,64,35,417,63,98,38,319,62,7722
15000US060375316042,419,59,70,34,16,15,54,33,349,60,61,28,288,61,7723
15000US060375317011,796,120,65,56,24,38,41,40,731,116,163,64,568,133,7724
15000US060375317012,510,100,68,41,45,36,23,24,442,98,61,39,381,102,7725
15000US060375317021,231,78,8,12,0,12,8,12,223,77,109,71,114,56,7726
15000US060375317022,286,73,27,25,27,25,0,12,259,75,47,39,212,77,7727
15000US060375317023,485,85,61,49,14,18,47,46,424,89,113,58,311,92,7728
15000US060375317024,303,93,23,27,15,16,8,25,280,96,36,28,244,97,7729
15000US060375318001,397,105,46,40,0,12,46,40,351,114,56,49,295,105,7730
15000US060375318002,587,105,37,47,10,15,27,44,550,109,86,60,464,116,7731
15000US060375318003,267,76,72,54,21,24,51,56,195,63,49,32,146,62,7732
15000US060375319011,499,90,107,63,0,12,107,63,392,91,113,64,279,93,7733
15000US060375319012,402,97,8,13,8,13,0,12,394,94,62,35,332,92,7734
15000US060375319013,599,99,95,54,46,39,49,44,504,103,156,75,348,94,7735
15000US060375319014,199,61,34,31,18,20,16,24,165,60,58,32,107,54,7736
15000US060375319021,256,71,9,15,0,12,9,15,247,71,71,44,176,71,7737
15000US060375319022,527,90,46,42,0,12,46,42,481,87,83,44,398,95,7738
15000US060375319023,285,76,50,45,18,20,32,41,235,70,63,48,172,69,7739
15000US060375320011,629,86,79,54,58,48,21,23,550,93,258,82,292,101,7740
15000US060375320012,509,86,49,47,7,12,42,44,460,94,147,62,313,102,7741
15000US060375320021,233,59,46,38,14,22,32,31,187,60,95,52,92,44,7742
15000US060375320022,775,67,82,44,55,42,27,21,693,79,184,62,509,82,7743
15000US060375321011,620,96,95,60,61,51,34,32,525,112,125,58,400,126,7744
15000US060375321012,849,132,151,78,80,55,71,58,698,136,155,73,543,132,7745
15000US060375321013,299,96,95,66,17,19,78,62,204,80,80,63,124,64,7746
15000US060375321021,586,90,0,12,0,12,0,12,586,90,168,68,418,102,7747
15000US060375321022,499,98,26,27,0,12,26,27,473,99,174,63,299,91,7748
15000US060375322001,708,109,106,54,0,12,106,54,602,109,171,77,431,116,7749
15000US060375322002,527,118,114,62,17,28,97,55,413,119,103,62,310,109,7750
15000US060375322003,555,106,132,65,80,56,52,36,423,94,142,66,281,71,7751
15000US060375323021,384,65,65,41,41,35,24,29,319,69,113,53,206,76,7752
15000US060375323022,264,56,44,34,19,21,25,30,220,59,94,54,126,56,7753
15000US060375323023,225,62,11,17,11,17,0,12,214,64,62,41,152,64,7754
15000US060375323024,292,50,17,27,0,12,17,27,275,50,31,26,244,56,7755
15000US060375323031,313,84,31,33,0,12,31,33,282,79,81,63,201,74,7756
15000US060375323032,838,106,110,58,44,36,66,45,728,119,222,77,506,100,7757
15000US060375323033,213,75,65,48,47,43,18,20,148,74,25,27,123,72,7758
15000US060375323041,924,82,132,69,71,47,61,52,792,99,255,83,537,120,7759
15000US060375323042,150,47,19,29,0,12,19,29,131,44,40,34,91,43,7760
15000US060375324001,28,22,0,12,0,12,0,12,28,22,1,2,27,21,7761
15000US060375325001,285,70,90,57,0,12,90,57,195,78,36,36,159,77,7762
15000US060375325002,404,72,94,55,0,12,94,55,310,72,36,32,274,79,7763
15000US060375325003,434,79,38,43,0,12,38,43,396,84,112,47,284,71,7764
15000US060375326031,312,51,41,26,9,10,32,26,271,53,32,31,239,56,7765
15000US060375326032,207,46,56,37,0,12,56,37,151,50,18,20,133,49,7766
15000US060375326033,231,46,65,41,6,9,59,41,166,46,14,16,152,46,7767
15000US060375326041,175,33,22,15,0,12,22,15,153,32,37,25,116,29,7768
15000US060375326042,498,39,39,25,5,8,34,24,459,44,70,30,389,47,7769
15000US060375326051,193,44,20,32,0,12,20,32,173,39,18,29,155,44,7770
15000US060375326052,224,77,40,43,17,28,23,35,184,72,8,13,176,71,7771
15000US060375326053,712,76,133,73,73,59,60,49,579,87,179,70,400,94,7772
15000US060375326061,394,77,54,45,30,35,24,29,340,77,102,52,238,76,7773
15000US060375326062,578,75,160,70,39,36,121,60,418,87,88,45,330,82,7774
15000US060375326063,288,70,100,62,0,12,100,62,188,67,53,40,135,62,7775
15000US060375327001,351,65,109,53,6,12,103,53,242,62,40,32,202,59,7776
15000US060375327002,315,67,111,53,31,29,80,50,204,63,57,35,147,63,7777
15000US060375328001,514,63,121,50,33,27,88,44,393,70,53,28,340,70,7778
15000US060375328002,471,63,213,63,47,38,166,59,258,61,49,32,209,57,7779
15000US060375329001,145,65,57,47,24,29,33,35,88,55,36,29,52,50,7780
15000US060375329002,377,88,119,70,45,42,74,57,258,85,63,41,195,81,7781
15000US060375329003,769,106,254,92,78,53,176,75,515,100,141,66,374,97,7782
15000US060375329004,353,83,138,68,8,13,130,67,215,80,88,58,127,75,7783
15000US060375330011,579,103,176,78,35,43,141,67,403,103,64,42,339,96,7784
15000US060375330012,115,52,16,26,0,12,16,26,99,49,48,49,51,41,7785
15000US060375330013,361,84,84,58,21,22,63,55,277,80,48,38,229,77,7786
15000US060375330021,285,38,43,21,15,17,28,16,242,41,94,30,148,40,7787
15000US060375330022,339,43,70,35,29,20,41,29,269,44,70,37,199,42,7788
15000US060375331031,408,49,116,51,47,34,69,39,292,59,25,17,267,60,7789
15000US060375331032,448,51,129,48,36,26,93,43,319,56,108,41,211,58,7790
15000US060375331041,444,78,138,65,9,14,129,64,306,81,64,54,242,76,7791
15000US060375331042,804,95,154,70,17,27,137,71,650,111,213,70,437,107,7792
15000US060375331051,646,38,164,62,33,24,131,60,482,69,130,51,352,72,7793
15000US060375331061,259,35,46,27,20,20,26,21,213,42,88,34,125,40,7794
15000US060375331062,175,38,9,14,0,12,9,14,166,39,34,22,132,36,7795
15000US060375331071,203,42,23,18,0,12,23,18,180,39,25,22,155,36,7796
15000US060375331072,753,50,211,50,57,31,154,45,542,69,127,47,415,66,7797
15000US060375332011,214,49,17,16,0,12,17,16,197,50,59,42,138,44,7798
15000US060375332012,471,51,80,44,30,26,50,36,391,55,73,39,318,60,7799
15000US060375332021,274,49,59,40,0,12,59,40,215,47,71,39,144,42,7800
15000US060375332022,356,51,42,34,4,6,38,33,314,49,100,46,214,53,7801
15000US060375332031,193,36,31,25,0,12,31,25,162,36,52,21,110,36,7802
15000US060375332032,220,38,92,42,3,6,89,40,128,45,27,21,101,43,7803
15000US060375333001,335,48,93,39,13,17,80,37,242,54,28,22,214,54,7804
15000US060375333002,500,46,72,35,11,15,61,32,428,51,93,35,335,53,7805
15000US060375334011,535,72,103,63,26,34,77,55,432,86,54,36,378,83,7806
15000US060375334012,284,74,33,35,0,12,33,35,251,79,11,14,240,80,7807
15000US060375334013,359,81,38,36,4,9,34,36,321,85,71,52,250,84,7808
15000US060375334021,532,82,147,58,17,20,130,58,385,85,27,24,358,85,7809
15000US060375334022,446,71,49,39,10,16,39,35,397,64,115,55,282,69,7810
15000US060375334031,502,43,76,42,20,21,56,36,426,57,165,45,261,55,7811
15000US060375334032,219,40,65,31,22,21,43,27,154,43,29,23,125,40,7812
15000US060375335011,400,51,141,54,23,18,118,52,259,65,34,26,225,62,7813
15000US060375335012,371,50,31,28,8,14,23,23,340,49,84,36,256,53,7814
15000US060375335021,327,36,76,37,31,23,45,27,251,45,33,26,218,43,7815
15000US060375335022,165,32,12,11,5,8,7,8,153,33,38,22,115,36,7816
15000US060375335031,383,36,91,41,38,30,53,38,292,51,28,21,264,55,7817
15000US060375335032,105,35,27,18,12,20,15,17,78,34,19,17,59,32,7818
15000US060375336011,358,72,88,52,27,31,61,43,270,77,22,26,248,77,7819
15000US060375336012,585,94,103,53,7,12,96,51,482,98,65,50,417,89,7820
15000US060375336013,149,45,15,22,15,22,0,12,134,44,0,12,134,44,7821
15000US060375336021,510,85,122,68,32,34,90,63,388,79,103,53,285,69,7822
15000US060375336022,594,100,89,71,15,25,74,67,505,114,121,54,384,106,7823
15000US060375336023,233,71,50,35,0,12,50,35,183,65,29,26,154,67,7824
15000US060375336031,617,94,74,55,8,12,66,53,543,90,117,61,426,88,7825
15000US060375336032,685,102,91,46,28,31,63,34,594,102,191,63,403,88,7826
15000US060375336033,479,85,125,70,29,33,96,61,354,84,85,37,269,84,7827
15000US060375337011,398,62,52,31,13,14,39,26,346,65,75,46,271,67,7828
15000US060375337012,547,62,132,56,30,30,102,48,415,69,144,57,271,63,7829
15000US060375337021,610,55,87,32,30,23,57,30,523,62,51,30,472,65,7830
15000US060375337022,254,46,43,22,8,12,35,21,211,46,28,19,183,44,7831
15000US060375337031,389,70,56,42,17,19,39,38,333,67,61,42,272,63,7832
15000US060375337032,627,76,146,57,43,35,103,53,481,88,115,46,366,83,7833
15000US060375338031,346,62,62,35,9,14,53,32,284,70,69,45,215,72,7834
15000US060375338032,433,81,91,57,50,43,41,38,342,83,54,52,288,81,7835
15000US060375338033,305,67,58,38,22,25,36,29,247,75,9,14,238,76,7836
15000US060375338034,546,86,87,54,71,49,16,25,459,91,87,51,372,90,7837
15000US060375338041,406,95,59,55,0,12,59,55,347,102,44,44,303,97,7838
15000US060375338042,816,97,268,90,55,47,213,88,548,106,141,76,407,116,7839
15000US060375338051,561,65,72,43,21,18,51,39,489,75,107,49,382,79,7840
15000US060375338052,173,50,15,12,5,7,10,12,158,49,28,25,130,53,7841
15000US060375338053,137,40,42,37,0,12,42,37,95,44,13,11,82,42,7842
15000US060375338061,726,98,108,72,44,34,64,62,618,103,135,74,483,106,7843
15000US060375338062,232,69,39,42,0,12,39,42,193,63,42,43,151,51,7844
15000US060375339011,299,66,99,54,24,34,75,44,200,68,63,46,137,54,7845
15000US060375339012,389,59,93,51,13,16,80,48,296,68,36,28,260,65,7846
15000US060375339013,492,83,51,45,0,12,51,45,441,81,47,39,394,83,7847
15000US060375339014,234,72,17,28,0,12,17,28,217,67,38,42,179,57,7848
15000US060375339021,565,52,85,39,19,16,66,37,480,60,119,42,361,59,7849
15000US060375339022,366,49,70,33,16,17,54,32,296,54,42,21,254,53,7850
15000US060375340011,437,67,81,47,12,17,69,45,356,72,53,37,303,80,7851
15000US060375340012,571,79,165,70,37,38,128,61,406,78,60,42,346,78,7852
15000US060375340013,227,54,62,40,0,12,62,40,165,54,30,24,135,59,7853
15000US060375340021,660,67,98,55,19,23,79,51,562,77,155,57,407,88,7854
15000US060375340022,322,62,74,38,21,23,53,34,248,62,49,27,199,57,7855
15000US060375341011,164,46,31,32,0,12,31,32,133,43,47,27,86,40,7856
15000US060375341012,211,49,36,24,11,17,25,19,175,54,27,20,148,55,7857
15000US060375341013,122,41,43,40,6,9,37,39,79,37,29,31,50,27,7858
15000US060375341021,241,47,51,32,8,12,43,31,190,58,9,13,181,57,7859
15000US060375341022,497,65,112,53,18,27,94,55,385,75,85,42,300,79,7860
15000US060375341023,393,57,67,46,7,11,60,44,326,73,26,23,300,77,7861
15000US060375341024,343,55,104,53,8,11,96,52,239,57,76,39,163,51,7862
15000US060375342011,572,68,229,63,13,15,216,62,343,65,111,43,232,58,7863
15000US060375342012,435,63,59,39,49,35,10,15,376,65,86,42,290,75,7864
15000US060375342021,543,74,150,69,60,46,90,51,393,84,58,42,335,86,7865
15000US060375342022,396,71,118,56,27,31,91,50,278,80,95,47,183,68,7866
15000US060375342023,298,77,102,52,0,12,102,52,196,75,50,39,146,71,7867
15000US060375342031,329,52,36,25,7,10,29,26,293,47,54,29,239,44,7868
15000US060375342032,495,56,121,47,31,26,90,46,374,65,150,46,224,64,7869
15000US060375343011,618,64,170,76,20,31,150,74,448,91,91,58,357,95,7870
15000US060375343012,478,70,138,51,31,21,107,47,340,71,108,52,232,74,7871
15000US060375343021,418,51,122,46,46,32,76,35,296,56,42,24,254,59,7872
15000US060375343022,387,52,79,33,37,25,42,28,308,51,45,25,263,56,7873
15000US060375344031,707,34,121,50,53,38,68,35,586,57,171,50,415,58,7874
15000US060375344041,423,70,88,41,10,10,78,40,335,66,43,34,292,60,7875
15000US060375344042,496,73,159,66,23,25,136,61,337,60,80,36,257,57,7876
15000US060375344051,747,61,195,64,53,37,142,52,552,75,98,41,454,80,7877
15000US060375344052,202,56,56,42,24,24,32,34,146,47,34,27,112,45,7878
15000US060375344061,528,74,174,77,57,45,117,65,354,80,108,51,246,77,7879
15000US060375344062,474,71,184,60,80,44,104,48,290,80,24,22,266,83,7880
15000US060375345011,387,92,29,47,0,12,29,47,358,91,83,47,275,87,7881
15000US060375345012,302,72,68,42,10,16,58,39,234,72,61,40,173,74,7882
15000US060375345013,487,94,79,64,57,58,22,25,408,98,80,49,328,96,7883
15000US060375345021,468,71,69,47,22,34,47,45,399,73,83,52,316,71,7884
15000US060375345022,207,59,44,43,37,41,7,11,163,62,22,17,141,67,7885
15000US060375345023,353,73,80,55,27,33,53,44,273,70,85,46,188,62,7886
15000US060375347001,991,25,110,44,28,24,82,44,881,45,227,55,654,66,7887
15000US060375348021,409,57,19,24,0,12,19,24,390,59,122,59,268,66,7888
15000US060375348022,268,60,62,38,21,20,41,32,206,54,16,11,190,53,7889
15000US060375348031,667,76,175,75,23,23,152,74,492,104,134,59,358,92,7890
15000US060375348032,446,73,50,48,9,13,41,46,396,75,110,53,286,82,7891
15000US060375348041,603,67,58,34,21,17,37,32,545,78,132,48,413,85,7892
15000US060375348042,304,61,56,40,20,19,36,33,248,52,69,30,179,51,7893
15000US060375349001,171,86,0,12,0,12,0,12,171,86,13,19,158,84,7894
15000US060375349002,451,115,61,57,0,12,61,57,390,117,95,72,295,112,7895
15000US060375349003,310,79,42,35,19,23,23,26,268,77,96,52,172,76,7896
15000US060375349004,573,107,124,78,67,55,57,59,449,122,110,73,339,133,7897
15000US060375350011,544,73,187,67,41,33,146,66,357,77,94,35,263,75,7898
15000US060375350012,162,51,28,28,14,21,14,17,134,48,17,20,117,52,7899
15000US060375350013,280,74,90,55,24,27,66,43,190,62,19,20,171,60,7900
15000US060375350021,335,52,42,25,5,7,37,26,293,53,60,29,233,55,7901
15000US060375350022,174,46,50,28,0,12,50,28,124,39,37,24,87,36,7902
15000US060375350023,272,55,112,40,10,10,102,41,160,54,28,23,132,51,7903
15000US060375351011,419,76,55,36,0,12,55,36,364,78,40,39,324,77,7904
15000US060375351012,270,79,143,68,57,47,86,53,127,72,14,17,113,73,7905
15000US060375351013,241,69,35,44,0,12,35,44,206,60,84,44,122,62,7906
15000US060375351014,441,86,125,67,36,34,89,56,316,86,66,38,250,79,7907
15000US060375351015,430,89,101,48,7,12,94,49,329,100,84,53,245,97,7908
15000US060375351021,226,74,64,48,64,48,0,12,162,61,116,54,46,31,7909
15000US060375351022,537,93,164,79,16,19,148,80,373,89,95,58,278,96,7910
15000US060375351023,321,84,54,47,13,22,41,42,267,82,54,46,213,78,7911
15000US060375352001,473,92,160,67,28,26,132,68,313,94,47,38,266,90,7912
15000US060375352002,458,85,93,57,0,12,93,57,365,83,110,57,255,74,7913
15000US060375352003,378,101,112,66,47,47,65,53,266,91,30,37,236,94,7914
15000US060375353001,223,68,39,41,21,28,18,28,184,63,48,25,136,61,7915
15000US060375353002,233,56,38,27,0,12,38,27,195,54,14,23,181,56,7916
15000US060375353003,447,83,132,61,0,12,132,61,315,95,53,33,262,96,7917
15000US060375353004,324,71,51,36,23,26,28,27,273,73,49,31,224,73,7918
15000US060375353005,208,61,132,61,44,38,88,52,76,44,12,16,64,44,7919
15000US060375354001,414,76,41,35,0,12,41,35,373,72,160,63,213,65,7920
15000US060375354002,125,56,68,46,16,25,52,40,57,34,28,25,29,26,7921
15000US060375354003,162,60,56,47,30,36,26,31,106,50,19,23,87,48,7922
15000US060375355011,521,59,123,49,30,24,93,45,398,61,95,41,303,59,7923
15000US060375355012,484,59,107,41,41,26,66,37,377,60,89,41,288,62,7924
15000US060375355021,736,88,141,90,28,33,113,84,595,98,235,115,360,126,7925
15000US060375355022,481,85,73,54,18,30,55,45,408,90,186,75,222,93,7926
15000US060375355031,593,32,183,50,60,33,123,42,410,54,127,42,283,60,7927
15000US060375356031,300,58,5,9,5,9,0,12,295,58,39,30,256,57,7928
15000US060375356032,552,59,151,51,46,33,105,46,401,55,105,39,296,58,7929
15000US060375356041,386,45,88,40,15,15,73,37,298,50,43,25,255,50,7930
15000US060375356042,612,49,135,50,56,29,79,40,477,61,138,46,339,60,7931
15000US060375356051,549,77,144,66,57,45,87,47,405,81,124,53,281,80,7932
15000US060375356052,539,75,105,57,73,51,32,29,434,87,128,58,306,86,7933
15000US060375356061,485,18,90,47,28,26,62,40,395,50,89,43,306,57,7934
15000US060375356071,381,78,56,49,19,30,37,45,325,85,120,63,205,83,7935
15000US060375356072,278,67,57,53,20,22,37,50,221,59,49,36,172,55,7936
15000US060375356073,231,65,112,60,0,12,112,60,119,60,20,21,99,60,7937
15000US060375356074,204,54,9,19,7,14,2,12,195,56,17,18,178,55,7938
15000US060375357011,327,75,30,33,0,12,30,33,297,76,104,62,193,66,7939
15000US060375357012,587,90,74,49,24,28,50,42,513,90,88,53,425,83,7940
15000US060375357013,555,87,185,74,79,54,106,58,370,87,54,44,316,86,7941
15000US060375357021,264,82,73,55,23,31,50,48,191,73,43,38,148,67,7942
15000US060375357022,273,70,21,20,7,12,14,16,252,72,107,60,145,70,7943
15000US060375357023,306,80,85,58,51,39,34,42,221,80,93,63,128,66,7944
15000US060375357024,480,103,95,74,25,33,70,65,385,96,66,50,319,92,7945
15000US060375358021,370,76,37,25,7,12,30,22,333,81,151,66,182,60,7946
15000US060375358022,219,52,25,28,0,12,25,28,194,55,23,20,171,55,7947
15000US060375358023,342,69,61,47,18,28,43,37,281,67,71,41,210,62,7948
15000US060375358024,682,78,168,70,60,46,108,55,514,90,139,64,375,86,7949
15000US060375358031,425,70,43,38,13,20,30,32,382,74,75,40,307,79,7950
15000US060375358032,449,67,101,64,35,43,66,55,348,75,78,46,270,71,7951
15000US060375358033,214,56,17,27,17,27,0,12,197,54,29,19,168,56,7952
15000US060375358041,539,96,46,41,13,21,33,34,493,96,47,38,446,93,7953
15000US060375358042,732,102,212,89,47,48,165,74,520,125,83,68,437,122,7954
15000US060375359011,299,59,0,12,0,12,0,12,299,59,121,65,178,53,7955
15000US060375359012,287,81,47,42,19,22,28,35,240,75,52,40,188,68,7956
15000US060375359013,499,105,29,35,20,33,9,15,470,115,90,59,380,110,7957
15000US060375359014,336,82,69,51,22,24,47,46,267,78,75,47,192,77,7958
15000US060375359021,348,68,22,22,15,19,7,10,326,70,49,30,277,71,7959
15000US060375359022,273,72,25,38,0,12,25,38,248,69,78,42,170,71,7960
15000US060375359023,444,77,39,44,0,12,39,44,405,77,96,56,309,79,7961
15000US060375359024,483,83,46,41,30,32,16,23,437,81,158,70,279,86,7962
15000US060375360001,283,52,67,37,21,20,46,33,216,52,73,35,143,47,7963
15000US060375360002,709,57,90,43,14,14,76,43,619,72,130,42,489,76,7964
15000US060375361021,447,71,39,36,7,13,32,33,408,71,78,45,330,68,7965
15000US060375361022,143,65,47,39,0,12,47,39,96,64,9,14,87,63,7966
15000US060375361023,480,80,0,12,0,12,0,12,480,80,191,82,289,93,7967
15000US060375361031,322,81,15,25,0,12,15,25,307,90,78,55,229,83,7968
15000US060375361032,587,85,60,52,19,30,41,44,527,92,195,66,332,83,7969
15000US060375361033,538,86,183,76,9,16,174,76,355,81,112,59,243,75,7970
15000US060375361041,336,73,74,35,19,22,55,39,262,71,29,23,233,71,7971
15000US060375361042,240,49,6,8,6,8,0,12,234,49,131,34,103,37,7972
15000US060375361043,322,54,77,44,5,7,72,44,245,55,49,26,196,59,7973
15000US060375361044,115,47,17,15,7,9,10,11,98,49,30,27,68,43,7974
15000US060375362001,453,88,20,23,10,15,10,19,433,91,78,45,355,99,7975
15000US060375362002,436,84,22,24,13,19,9,14,414,84,97,49,317,86,7976
15000US060375362003,228,61,0,12,0,12,0,12,228,61,11,17,217,60,7977
15000US060375362004,388,96,20,31,20,31,0,12,368,99,48,47,320,98,7978
15000US060375362005,373,74,66,53,16,19,50,48,307,76,161,68,146,58,7979
15000US060375400001,411,81,43,36,8,14,35,34,368,85,155,63,213,70,7980
15000US060375400002,391,83,82,52,18,27,64,53,309,82,67,45,242,75,7981
15000US060375400003,129,53,39,37,30,32,9,17,90,42,49,40,41,28,7982
15000US060375400004,612,95,112,59,25,23,87,55,500,113,127,70,373,101,7983
15000US060375401011,305,79,43,33,8,13,35,31,262,84,48,42,214,82,7984
15000US060375401012,392,82,55,43,20,23,35,37,337,89,70,47,267,85,7985
15000US060375401013,275,67,35,35,27,33,8,13,240,60,63,34,177,58,7986
15000US060375401014,480,90,68,41,25,29,43,31,412,91,122,61,290,78,7987
15000US060375401021,365,86,57,50,9,14,48,49,308,84,35,23,273,83,7988
15000US060375401022,387,97,29,23,11,14,18,20,358,96,102,48,256,92,7989
15000US060375401023,524,89,77,57,22,36,55,44,447,81,120,51,327,88,7990
15000US060375401024,276,72,41,32,23,25,18,19,235,75,53,39,182,68,7991
15000US060375402011,304,50,58,38,13,14,45,35,246,55,50,33,196,54,7992
15000US060375402012,266,49,44,34,0,12,44,34,222,48,72,29,150,45,7993
15000US060375402021,475,95,109,62,26,35,83,50,366,93,17,19,349,93,7994
15000US060375402022,653,96,180,73,66,51,114,61,473,91,161,76,312,88,7995
15000US060375402023,252,84,23,28,0,12,23,28,229,82,33,23,196,80,7996
15000US060375402024,217,65,69,46,0,12,69,46,148,62,38,39,110,52,7997
15000US060375402031,675,83,220,75,36,35,184,72,455,96,88,53,367,89,7998
15000US060375402032,343,72,57,42,8,13,49,40,286,79,51,33,235,81,7999
15000US060375402033,283,64,42,34,24,28,18,20,241,65,26,30,215,69,8000
15000US060375403001,217,78,63,55,24,30,39,48,154,68,14,20,140,66,8001
15000US060375403002,316,78,81,52,0,12,81,52,235,74,68,44,167,65,8002
15000US060375403003,114,68,22,27,9,15,13,21,92,65,12,18,80,68,8003
15000US060375403004,513,91,173,81,30,38,143,70,340,99,116,69,224,83,8004
15000US060375404001,184,38,51,33,15,18,36,28,133,38,29,20,104,34,8005
15000US060375404002,298,40,118,53,39,31,79,39,180,56,38,28,142,50,8006
15000US060375405011,247,71,30,36,0,12,30,36,217,73,54,52,163,60,8007
15000US060375405012,213,85,32,37,12,15,20,33,181,81,51,46,130,71,8008
15000US060375405013,227,82,59,50,38,42,21,33,168,69,50,33,118,68,8009
15000US060375405014,399,86,40,38,0,12,40,38,359,80,51,55,308,90,8010
15000US060375405021,737,86,215,72,46,45,169,71,522,100,149,81,373,90,8011
15000US060375405022,363,80,77,57,10,15,67,54,286,75,94,62,192,71,8012
15000US060375405023,398,73,89,51,15,25,74,49,309,77,122,57,187,69,8013
15000US060375406001,799,102,152,76,57,49,95,59,647,109,266,84,381,103,8014
15000US060375406002,315,82,90,51,20,26,70,45,225,75,41,36,184,70,8015
15000US060375407001,230,85,15,18,0,12,15,18,215,85,55,40,160,75,8016
15000US060375407002,364,90,143,88,81,68,62,44,221,65,63,27,158,59,8017
15000US060375407003,187,58,52,46,26,34,26,28,135,53,38,33,97,49,8018
15000US060375408001,276,91,15,27,15,27,0,12,261,93,39,27,222,97,8019
15000US060375408002,295,102,45,40,9,14,36,43,250,98,51,33,199,97,8020
15000US060375408003,192,86,42,43,19,24,23,36,150,78,65,34,85,76,8021
15000US060375408004,275,89,49,55,49,55,0,12,226,77,65,43,161,79,8022
15000US060375408005,568,102,51,47,24,19,27,45,517,101,126,67,391,121,8023
15000US060375409011,212,79,38,38,10,15,28,34,174,77,55,36,119,77,8024
15000US060375409012,384,100,67,43,7,12,60,44,317,95,116,60,201,96,8025
15000US060375409013,334,83,48,46,0,12,48,46,286,78,73,48,213,77,8026
15000US060375409014,171,83,0,12,0,12,0,12,171,83,43,50,128,80,8027
15000US060375409021,470,102,112,77,27,30,85,69,358,88,121,70,237,83,8028
15000US060375409022,510,102,37,55,33,52,4,15,473,103,138,48,335,106,8029
15000US060375409023,490,93,64,53,33,37,31,37,426,89,140,73,286,85,8030
15000US060375409024,0,12,0,12,0,12,0,12,0,12,0,12,0,12,8031
15000US060375410011,316,38,47,28,17,15,30,24,269,52,123,44,146,46,8032
15000US060375410021,1008,60,52,40,14,22,38,32,956,72,368,86,588,96,8033
15000US060375411001,307,54,51,31,21,17,30,28,256,52,52,29,204,47,8034
15000US060375411002,379,67,56,38,27,24,29,29,323,68,110,45,213,70,8035
15000US060375411003,225,68,35,36,6,10,29,35,190,67,43,29,147,64,8036
15000US060375412001,263,83,29,45,0,12,29,45,234,68,76,52,158,63,8037
15000US060375412002,279,101,42,53,10,13,32,51,237,91,123,66,114,78,8038
15000US060375412003,568,101,46,41,0,12,46,41,522,105,212,84,310,101,8039
15000US060375412004,358,99,91,75,50,52,41,50,267,93,95,61,172,95,8040
15000US060375412005,403,89,38,35,13,21,25,28,365,89,174,64,191,76,8041
15000US060375413001,242,72,0,12,0,12,0,12,242,72,64,38,178,67,8042
15000US060375413002,162,62,32,28,16,23,16,18,130,63,64,47,66,45,8043
15000US060375413003,419,96,155,71,26,32,129,63,264,90,85,57,179,79,8044
15000US060375413004,365,95,41,38,10,15,31,34,324,96,90,67,234,85,8045
15000US060375413005,285,72,10,16,10,16,0,12,275,75,101,57,174,79,8046
15000US060375414001,469,108,250,100,131,81,119,70,219,96,94,58,125,84,8047
15000US060375414002,244,92,44,61,6,11,38,61,200,98,22,31,178,100,8048
15000US060375414003,187,75,113,73,0,12,113,73,74,45,7,13,67,44,8049
15000US060375414004,177,72,50,52,31,47,19,23,127,61,20,28,107,58,8050
15000US060375414005,523,95,156,83,51,49,105,79,367,110,158,70,209,92,8051
15000US060375415001,369,78,104,59,29,34,75,49,265,82,95,59,170,69,8052
15000US060375415002,181,55,41,38,8,12,33,36,140,54,42,32,98,57,8053
15000US060375415003,213,76,19,28,19,28,0,12,194,76,43,36,151,74,8054
15000US060375415004,503,100,185,84,28,34,157,79,318,96,29,26,289,96,8055
15000US060375416031,333,51,148,45,64,35,84,44,185,47,70,37,115,39,8056
15000US060375416032,344,47,49,34,38,30,11,16,295,50,78,39,217,56,8057
15000US060375416041,515,92,90,53,37,40,53,37,425,84,103,56,322,87,8058
15000US060375416042,430,81,62,46,29,33,33,33,368,76,130,52,238,78,8059
15000US060375416043,482,93,156,64,40,35,116,56,326,95,89,61,237,83,8060
15000US060375416051,224,66,66,56,24,32,42,43,158,70,56,44,102,62,8061
15000US060375416052,587,89,161,76,18,26,143,78,426,90,92,46,334,90,8062
15000US060375416053,456,92,98,76,19,30,79,69,358,95,166,77,192,80,8063
15000US060375416061,350,48,39,27,25,22,14,16,311,54,118,39,193,54,8064
15000US060375416062,253,48,39,25,17,18,22,17,214,50,71,34,143,46,8065
15000US060375417001,220,73,17,19,0,12,17,19,203,73,69,57,134,60,8066
15000US060375417002,284,63,80,50,28,35,52,40,204,66,41,34,163,59,8067
15000US060375417003,192,70,35,41,10,16,25,38,157,61,27,30,130,63,8068
15000US060375417004,141,66,23,31,23,31,0,12,118,55,24,20,94,50,8069
15000US060375417005,365,90,17,19,9,14,8,13,348,87,113,57,235,76,8070
15000US060375417006,174,52,23,35,23,35,0,12,151,54,27,23,124,52,8071
15000US060375418011,295,78,65,50,35,34,30,39,230,77,87,57,143,65,8072
15000US060375418012,615,97,193,90,91,66,102,52,422,96,73,48,349,99,8073
15000US060375418013,324,90,105,67,39,41,66,52,219,79,44,40,175,77,8074
15000US060375418021,243,75,69,44,0,12,69,44,174,73,22,27,152,72,8075
15000US060375418022,330,91,93,63,49,55,44,53,237,88,38,38,199,83,8076
15000US060375418023,360,91,76,57,36,45,40,30,284,90,96,58,188,73,8077
15000US060375418024,206,58,61,59,16,28,45,52,145,60,29,30,116,62,8078
15000US060375420001,304,93,33,34,19,28,14,21,271,90,116,52,155,76,8079
15000US060375420002,356,95,90,70,42,36,48,60,266,86,114,59,152,85,8080
15000US060375420003,566,110,195,92,72,57,123,86,371,111,67,47,304,109,8081
15000US060375421031,368,50,102,42,58,34,44,24,266,57,90,40,176,55,8082
15000US060375421032,208,39,29,18,15,17,14,16,179,39,66,29,113,34,8083
15000US060375421033,291,47,65,30,19,14,46,28,226,54,96,41,130,48,8084
15000US060375421041,349,49,53,33,5,7,48,34,296,56,61,37,235,57,8085
15000US060375421042,225,49,71,39,8,10,63,39,154,48,43,30,111,47,8086
15000US060375421043,118,41,29,30,29,30,0,12,89,35,36,20,53,30,8087
15000US060375421051,378,75,124,67,48,43,76,58,254,74,88,61,166,67,8088
15000US060375421052,207,59,101,61,63,48,38,38,106,58,39,33,67,51,8089
15000US060375421053,425,92,131,65,43,40,88,55,294,88,80,46,214,87,8090
15000US060375421061,286,45,74,32,27,20,47,27,212,52,78,40,134,48,8091
15000US060375421062,337,43,95,41,10,15,85,38,242,51,55,27,187,55,8092
15000US060375421063,130,38,46,30,46,30,0,12,84,34,6,9,78,35,8093
15000US060375422001,554,85,172,68,67,46,105,54,382,88,156,56,226,81,8094
15000US060375422002,738,96,99,62,60,48,39,39,639,103,202,80,437,102,8095
15000US060375422003,339,85,94,61,0,12,94,61,245,85,8,12,237,87,8096
15000US060375424011,296,70,54,43,14,22,40,37,242,76,76,51,166,63,8097
15000US060375424012,393,71,115,58,54,47,61,48,278,73,86,52,192,67,8098
15000US060375424013,226,66,47,40,29,34,18,20,179,71,70,37,109,66,8099
15000US060375424014,264,72,52,41,43,39,9,15,212,74,34,35,178,66,8100
15000US060375424021,399,59,107,52,37,33,70,40,292,66,106,45,186,63,8101
15000US060375424022,188,41,43,30,16,20,27,23,145,43,31,18,114,42,8102
15000US060375424023,209,48,11,12,7,10,4,8,198,48,81,35,117,44,8103
15000US060375425011,754,106,245,81,45,49,200,93,509,110,105,56,404,109,8104
15000US060375425012,488,99,116,57,27,25,89,57,372,90,172,72,200,84,8105
15000US060375425021,389,90,75,56,35,34,40,41,314,86,147,64,167,66,8106
15000US060375425022,170,67,82,53,65,51,17,19,88,52,28,40,60,35,8107
15000US060375425023,243,75,98,57,17,26,81,52,145,63,84,58,61,50,8108
15000US060375425024,480,90,98,73,33,37,65,56,382,84,157,63,225,77,8109
15000US060375426011,164,39,46,25,4,6,42,24,118,41,50,28,68,34,8110
15000US060375426012,329,41,115,45,42,30,73,39,214,45,92,34,122,43,8111
15000US060375426013,180,40,58,28,9,14,49,26,122,40,36,26,86,37,8112
15000US060375426021,377,103,72,63,34,45,38,42,305,82,38,30,267,82,8113
15000US060375426022,679,104,116,56,49,43,67,37,563,112,272,90,291,101,8114
15000US060375426023,305,90,67,55,32,44,35,34,238,81,93,58,145,61,8115
15000US060375427001,257,75,19,23,10,17,9,16,238,77,85,54,153,71,8116
15000US060375427002,227,74,42,36,0,12,42,36,185,82,87,60,98,63,8117
15000US060375427003,443,89,47,43,17,28,30,31,396,86,154,71,242,86,8118
15000US060375427004,251,74,41,38,5,8,36,37,210,73,55,46,155,72,8119
15000US060375427005,114,60,36,34,0,12,36,34,78,49,6,10,72,52,8120
15000US060375428001,440,55,52,25,29,20,23,15,388,60,128,53,260,60,8121
15000US060375428002,269,61,20,17,14,14,6,9,249,63,63,35,186,56,8122
15000US060375428003,221,59,11,12,6,8,5,8,210,58,52,28,158,60,8123
15000US060375429001,438,53,154,52,48,30,106,44,284,55,59,29,225,50,8124
15000US060375429002,323,52,56,29,12,18,44,25,267,54,126,44,141,52,8125
15000US060375430001,265,77,57,55,0,12,57,55,208,69,67,52,141,71,8126
15000US060375430002,174,60,0,12,0,12,0,12,174,60,50,43,124,64,8127
15000US060375430003,289,92,20,33,20,33,0,12,269,93,15,17,254,92,8128
15000US060375430004,309,95,60,64,0,12,60,64,249,82,73,39,176,80,8129
15000US060375430005,229,66,6,10,6,10,0,12,223,66,130,66,93,55,8130
15000US060375431001,303,101,47,48,39,46,8,12,256,95,42,54,214,88,8131
15000US060375431002,157,60,10,16,0,12,10,16,147,58,40,27,107,59,8132
15000US060375431003,245,77,8,13,8,13,0,12,237,77,91,48,146,84,8133
15000US060375431004,407,86,102,49,27,42,75,53,305,84,90,53,215,88,8134
15000US060375431005,158,66,9,14,0,12,9,14,149,67,45,27,104,65,8135
15000US060375431006,205,81,0,12,0,12,0,12,205,81,85,58,120,64,8136
15000US060375431007,342,118,20,26,20,26,0,12,322,119,104,70,218,119,8137
15000US060375432011,413,65,37,29,13,17,24,25,376,70,110,49,266,64,8138
15000US060375432012,474,64,49,26,32,20,17,19,425,71,149,44,276,65,8139
15000US060375432021,364,66,43,37,35,34,8,13,321,65,101,48,220,68,8140
15000US060375432022,236,80,53,44,30,35,23,28,183,75,44,40,139,70,8141
15000US060375432023,325,70,44,39,7,11,37,38,281,70,102,53,179,67,8142
15000US060375432024,224,68,28,25,0,12,28,25,196,65,56,39,140,65,8143
15000US060375433041,402,88,27,43,0,12,27,43,375,80,75,45,300,95,8144
15000US060375433042,751,107,0,12,0,12,0,12,751,107,126,60,625,121,8145
15000US060375433043,470,90,0,12,0,12,0,12,470,90,122,57,348,86,8146
15000US060375433044,391,96,12,16,3,8,9,13,379,100,83,58,296,89,8147
15000US060375433051,992,79,82,52,14,23,68,49,910,95,289,99,621,111,8148
15000US060375433061,707,124,30,36,11,18,19,32,677,129,231,87,446,120,8149
15000US060375433062,349,105,0,12,0,12,0,12,349,105,83,49,266,113,8150
15000US060375433063,232,85,0,12,0,12,0,12,232,85,58,49,174,75,8151
15000US060375433064,762,135,42,47,42,47,0,12,720,123,307,104,413,123,8152
15000US060375433211,941,121,45,52,19,25,26,42,896,125,104,58,792,116,8153
15000US060375433212,841,119,54,38,18,24,36,29,787,125,184,82,603,105,8154
15000US060375433221,473,119,71,67,26,36,45,57,402,136,173,101,229,111,8155
15000US060375433222,338,106,0,12,0,12,0,12,338,106,182,88,156,95,8156
15000US060375433223,875,147,88,93,70,89,18,29,787,151,226,101,561,157,8157
15000US060375433224,126,55,0,12,0,12,0,12,126,55,48,35,78,49,8158
15000US060375433225,341,95,0,12,0,12,0,12,341,95,108,79,233,73,8159
15000US060375434001,349,55,19,19,11,13,8,14,330,53,145,53,185,51,8160
15000US060375434002,438,62,41,26,11,12,30,23,397,68,146,46,251,60,8161
15000US060375434003,164,46,3,5,0,12,3,5,161,46,82,37,79,35,8162
15000US060375435011,254,107,0,12,0,12,0,12,254,107,33,28,221,112,8163
15000US060375435012,401,101,21,33,0,12,21,33,380,105,102,68,278,93,8164
15000US060375435013,606,132,38,39,30,35,8,14,568,135,99,49,469,130,8165
15000US060375435014,785,137,42,42,12,19,30,35,743,130,238,86,505,123,8166
15000US060375435021,419,102,16,22,5,10,11,19,403,102,125,73,278,83,8167
15000US060375435022,227,83,33,28,0,12,33,28,194,81,73,42,121,68,8168
15000US060375435023,692,96,9,15,9,15,0,12,683,93,144,71,539,108,8169
15000US060375435031,833,100,8,12,8,12,0,12,825,100,107,56,718,102,8170
15000US060375435032,911,99,53,39,36,32,17,19,858,103,228,84,630,112,8171
15000US060375436011,1007,54,22,23,9,14,13,18,985,55,264,61,721,76,8172
15000US060375436021,1368,149,148,104,49,70,99,73,1220,167,257,109,963,166,8173
15000US060375436022,603,122,0,12,0,12,0,12,603,122,77,52,526,125,8174
15000US060375436023,709,123,12,20,0,12,12,20,697,124,153,95,544,134,8175
15000US060375436031,805,74,37,28,20,19,17,20,768,75,296,75,472,85,8176
15000US060375436032,686,67,18,20,8,12,10,16,668,69,196,62,472,79,8177
15000US060375436041,776,94,17,20,8,13,9,15,759,100,301,96,458,105,8178
15000US060375436042,554,84,37,37,0,12,37,37,517,83,144,60,373,84,8179
15000US060375437011,328,44,30,28,25,28,5,8,298,48,106,39,192,47,8180
15000US060375437012,328,44,34,30,34,30,0,12,294,47,73,43,221,48,8181
15000US060375437021,362,77,30,47,0,12,30,47,332,66,114,51,218,61,8182
15000US060375437022,686,96,110,68,42,35,68,58,576,98,81,47,495,94,8183
15000US060375437023,171,57,0,12,0,12,0,12,171,57,49,31,122,56,8184
15000US060375437024,335,88,12,15,12,15,0,12,323,90,18,20,305,90,8185
15000US060375437025,248,71,0,12,0,12,0,12,248,71,64,46,184,81,8186
15000US060375437031,943,24,92,47,58,41,34,35,851,52,220,65,631,73,8187
15000US060375438011,958,99,30,37,30,37,0,12,928,103,308,94,620,120,8188
15000US060375438012,309,62,24,26,0,12,24,26,285,64,19,21,266,65,8189
15000US060375438013,214,66,7,13,7,13,0,12,207,65,77,36,130,74,8190
15000US060375438021,538,144,44,64,39,64,5,10,494,136,128,64,366,140,8191
15000US060375438022,217,68,9,13,9,13,0,12,208,69,72,41,136,70,8192
15000US060375438023,435,94,66,64,8,13,58,64,369,85,119,66,250,80,8193
15000US060375438024,770,130,8,13,0,12,8,13,762,129,171,69,591,124,8194
15000US060375439031,519,81,55,40,38,29,17,26,464,85,149,64,315,80,8195
15000US060375439032,575,79,30,24,10,16,20,20,545,85,167,52,378,86,8196
15000US060375439051,150,44,70,39,20,21,50,36,80,41,32,33,48,28,8197
15000US060375439052,400,71,111,62,41,52,70,40,289,69,51,28,238,61,8198
15000US060375439053,408,70,104,45,30,22,74,41,304,60,62,28,242,54,8199
15000US060375440011,121,45,4,8,4,8,0,12,117,45,57,35,60,40,8200
15000US060375440012,243,63,29,31,20,28,9,14,214,59,33,23,181,64,8201
15000US060375440013,256,91,66,48,42,40,24,30,190,88,53,40,137,79,8202
15000US060375440014,435,99,62,48,15,18,47,47,373,101,158,75,215,91,8203
15000US060375440021,208,28,25,22,0,12,25,22,183,31,82,30,101,37,8204
15000US060375440022,311,49,34,26,34,26,0,12,277,52,40,20,237,54,8205
15000US060375440023,294,49,13,12,5,8,8,9,281,49,74,32,207,51,8206
15000US060375500001,151,26,0,12,0,12,0,12,151,26,21,13,130,30,8207
15000US060375501001,147,68,8,14,0,12,8,14,139,67,29,24,110,75,8208
15000US060375501002,336,97,36,47,36,47,0,12,300,87,77,41,223,92,8209
15000US060375501003,324,83,0,12,0,12,0,12,324,83,52,33,272,87,8210
15000US060375501004,381,86,41,31,7,12,34,32,340,87,27,20,313,87,8211
15000US060375501005,269,74,15,22,0,12,15,22,254,72,48,44,206,60,8212
15000US060375501006,392,91,60,44,38,40,22,17,332,90,78,47,254,92,8213
15000US060375502011,415,47,35,18,20,12,15,13,380,48,93,36,287,58,8214
15000US060375502012,340,49,41,31,18,21,23,24,299,48,98,34,201,50,8215
15000US060375502021,381,73,90,52,31,36,59,42,291,73,58,33,233,75,8216
15000US060375502022,413,75,29,37,2,8,27,39,384,76,134,61,250,77,8217
15000US060375502023,183,47,8,13,0,12,8,13,175,48,65,33,110,45,8218
15000US060375502024,232,65,0,12,0,12,0,12,232,65,90,63,142,57,8219
15000US060375502025,219,63,28,43,0,12,28,43,191,59,48,45,143,56,8220
15000US060375503001,252,96,20,33,20,33,0,12,232,94,88,55,144,78,8221
15000US060375503002,370,97,36,42,0,12,36,42,334,98,90,66,244,99,8222
15000US060375503003,212,67,0,12,0,12,0,12,212,67,29,31,183,65,8223
15000US060375503004,424,118,48,40,15,24,33,31,376,120,42,39,334,114,8224
15000US060375503005,342,119,104,89,25,43,79,77,238,116,14,24,224,116,8225
15000US060375503006,138,61,7,12,7,12,0,12,131,63,22,24,109,58,8226
15000US060375503007,225,83,11,18,0,12,11,18,214,84,84,55,130,90,8227
15000US060375504001,378,34,14,15,8,12,6,9,364,36,126,48,238,52,8228
15000US060375505001,605,138,16,30,0,12,16,30,589,131,31,30,558,131,8229
15000US060375505002,411,144,133,91,39,61,94,74,278,126,131,109,147,83,8230
15000US060375505003,273,71,0,12,0,12,0,12,273,71,51,50,222,85,8231
15000US060375505004,175,61,0,12,0,12,0,12,175,61,45,37,130,54,8232
15000US060375505005,367,114,0,12,0,12,0,12,367,114,48,41,319,127,8233
15000US060375505006,327,93,65,86,0,12,65,86,262,76,48,44,214,68,8234
15000US060375506011,844,99,167,74,66,60,101,60,677,108,122,64,555,113,8235
15000US060375506012,220,54,6,11,6,11,0,12,214,55,47,27,167,56,8236
15000US060375506013,234,67,0,12,0,12,0,12,234,67,35,39,199,63,8237
15000US060375506014,333,73,25,23,7,12,18,19,308,77,34,36,274,73,8238
15000US060375506021,181,46,21,32,21,32,0,12,160,47,35,35,125,52,8239
15000US060375506022,321,67,11,16,0,12,11,16,310,68,56,39,254,74,8240
15000US060375506023,525,73,6,10,0,12,6,10,519,72,136,63,383,86,8241
15000US060375506024,177,52,22,29,0,12,22,29,155,47,51,21,104,45,8242
15000US060375507001,348,96,38,54,0,12,38,54,310,91,58,60,252,85,8243
15000US060375507002,398,116,14,23,0,12,14,23,384,114,39,38,345,119,8244
15000US060375507003,301,83,0,12,0,12,0,12,301,83,102,60,199,78,8245
15000US060375507004,186,74,0,12,0,12,0,12,186,74,47,39,139,69,8246
15000US060375507005,391,130,0,12,0,12,0,12,391,130,68,46,323,122,8247
15000US060375507006,260,83,0,12,0,12,0,12,260,83,41,36,219,80,8248
15000US060375508001,396,116,17,27,17,27,0,12,379,116,57,60,322,112,8249
15000US060375508002,208,92,21,38,0,12,21,38,187,94,14,22,173,90,8250
15000US060375508003,297,91,43,60,0,12,43,60,254,91,13,24,241,94,8251
15000US060375508004,198,54,0,12,0,12,0,12,198,54,0,12,198,54,8252
15000US060375508005,338,124,0,12,0,12,0,12,338,124,114,89,224,100,8253
15000US060375508006,418,123,9,17,0,12,9,17,409,124,74,62,335,134,8254
15000US060375508007,271,122,15,23,0,12,15,23,256,124,41,43,215,118,8255
15000US060375509011,634,101,70,65,0,12,70,65,564,99,151,65,413,86,8256
15000US060375509012,223,71,0,12,0,12,0,12,223,71,69,48,154,65,8257
15000US060375509013,471,83,62,53,39,42,23,32,409,89,74,38,335,92,8258
15000US060375509021,320,81,0,12,0,12,0,12,320,81,37,30,283,74,8259
15000US060375509022,687,111,103,54,18,29,85,44,584,101,47,47,537,107,8260
15000US060375509023,274,71,0,12,0,12,0,12,274,71,65,39,209,79,8261
15000US060375509024,636,94,80,49,18,20,62,47,556,98,38,26,518,104,8262
15000US060375510001,365,108,17,25,0,12,17,25,348,108,85,69,263,118,8263
15000US060375510002,310,137,27,31,27,31,0,12,283,141,69,46,214,151,8264
15000US060375510003,458,121,0,12,0,12,0,12,458,121,96,64,362,144,8265
15000US060375510004,366,120,0,12,0,12,0,12,366,120,68,52,298,119,8266
15000US060375510005,365,109,38,61,0,12,38,61,327,106,135,91,192,83,8267
15000US060375510006,334,90,0,12,0,12,0,12,334,90,85,64,249,106,8268
15000US060375511011,498,87,25,24,17,20,8,13,473,89,96,52,377,88,8269
15000US060375511012,181,65,9,14,0,12,9,14,172,62,25,22,147,58,8270
15000US060375511013,510,95,152,63,9,13,143,63,358,96,57,49,301,90,8271
15000US060375511021,371,91,96,62,10,16,86,62,275,98,26,30,249,100,8272
15000US060375511022,588,91,98,63,13,20,85,60,490,96,72,50,418,89,8273
15000US060375511023,719,108,79,43,32,25,47,37,640,112,178,97,462,115,8274
15000US060375512011,482,81,18,22,0,12,18,22,464,83,58,44,406,83,8275
15000US060375512012,654,82,52,39,52,39,0,12,602,87,153,63,449,84,8276
15000US060375512021,651,121,11,19,0,12,11,19,640,122,127,65,513,133,8277
15000US060375512022,192,75,23,35,23,35,0,12,169,75,62,54,107,66,8278
15000US060375512023,566,114,81,41,13,21,68,48,485,115,141,95,344,116,8279
15000US060375512024,714,142,76,80,30,51,46,59,638,137,67,59,571,133,8280
15000US060375513001,668,103,28,27,0,12,28,27,640,105,150,69,490,112,8281
15000US060375513002,421,96,50,35,14,17,36,30,371,97,158,74,213,89,8282
15000US060375513003,689,105,90,68,30,37,60,57,599,112,109,47,490,116,8283
15000US060375514011,779,106,133,102,5,9,128,102,646,136,69,56,577,148,8284
15000US060375514012,587,111,13,15,5,9,8,13,574,109,178,66,396,105,8285
15000US060375514021,396,81,28,29,28,29,0,12,368,77,58,42,310,83,8286
15000US060375514022,522,88,10,17,0,12,10,17,512,90,64,37,448,89,8287
15000US060375514023,367,83,0,12,0,12,0,12,367,83,69,41,298,83,8288
15000US060375515011,1008,105,84,67,23,26,61,61,924,103,102,51,822,106,8289
15000US060375515012,383,72,0,12,0,12,0,12,383,72,100,73,283,93,8290
15000US060375515021,438,117,97,94,0,12,97,94,341,108,121,84,220,84,8291
15000US060375515022,397,93,0,12,0,12,0,12,397,93,91,55,306,89,8292
15000US060375515023,352,91,0,12,0,12,0,12,352,91,113,68,239,87,8293
15000US060375516001,0,12,0,12,0,12,0,12,0,12,0,12,0,12,8294
15000US060375517001,650,83,50,42,30,36,20,22,600,78,150,70,450,78,8295
15000US060375517002,284,62,21,21,6,10,15,19,263,61,22,20,241,61,8296
15000US060375517003,266,59,53,47,6,10,47,45,213,57,47,28,166,56,8297
15000US060375517004,221,62,53,41,18,29,35,33,168,60,33,27,135,58,8298
15000US060375517005,215,60,0,12,0,12,0,12,215,60,46,35,169,58,8299
15000US060375518001,939,132,31,49,0,12,31,49,908,125,92,54,816,132,8300
15000US060375518002,382,108,0,12,0,12,0,12,382,108,128,64,254,98,8301
15000US060375518003,417,132,0,12,0,12,0,12,417,132,70,68,347,124,8302
15000US060375518004,246,83,16,28,0,12,16,28,230,93,123,90,107,40,8303
15000US060375518005,323,104,13,21,0,12,13,21,310,104,54,45,256,116,8304
15000US060375519001,227,71,0,12,0,12,0,12,227,71,57,41,170,71,8305
15000US060375519002,162,53,44,48,0,12,44,48,118,33,33,24,85,38,8306
15000US060375519003,287,82,31,31,0,12,31,31,256,89,75,50,181,84,8307
15000US060375519004,276,72,21,33,0,12,21,33,255,71,42,30,213,72,8308
15000US060375519005,240,94,62,45,24,37,38,26,178,90,40,48,138,77,8309
15000US060375519006,257,71,0,12,0,12,0,12,257,71,41,34,216,74,8310
15000US060375520011,387,52,0,12,0,12,0,12,387,52,95,34,292,57,8311
15000US060375520012,346,47,5,7,0,12,5,7,341,48,54,26,287,52,8312
15000US060375520013,270,56,39,26,14,13,25,23,231,53,34,19,197,51,8313
15000US060375520021,546,65,33,28,15,19,18,21,513,70,82,35,431,68,8314
15000US060375520022,228,52,14,13,10,11,4,7,214,54,31,26,183,53,8315
15000US060375520023,181,47,29,20,0,12,29,20,152,48,32,22,120,45,8316
15000US060375521001,340,77,0,12,0,12,0,12,340,77,161,68,179,61,8317
15000US060375521002,723,121,28,44,0,12,28,44,695,118,254,92,441,114,8318
15000US060375521003,290,77,34,42,34,42,0,12,256,69,50,33,206,68,8319
15000US060375521004,214,67,8,13,0,12,8,13,206,68,58,46,148,65,8320
15000US060375521005,319,75,20,18,6,9,14,16,299,76,104,54,195,75,8321
15000US060375522001,568,111,78,48,8,13,70,50,490,106,128,82,362,87,8322
15000US060375522002,746,117,193,79,31,36,162,80,553,102,125,49,428,104,8323
15000US060375522003,383,99,75,52,15,18,60,48,308,92,47,33,261,94,8324
15000US060375523011,441,86,32,48,0,12,32,48,409,75,49,32,360,83,8325
15000US060375523012,649,90,24,25,12,19,12,17,625,93,226,67,399,106,8326
15000US060375523013,251,63,36,41,0,12,36,41,215,64,10,15,205,69,8327
15000US060375523021,436,101,93,60,58,46,35,42,343,103,96,59,247,107,8328
15000US060375523022,237,83,0,12,0,12,0,12,237,83,50,44,187,83,8329
15000US060375523023,571,119,57,40,31,29,26,26,514,113,258,91,256,80,8330
15000US060375524001,89,27,28,23,11,13,17,19,61,24,32,18,29,16,8331
15000US060375524002,251,38,20,16,10,11,10,10,231,41,71,33,160,39,8332
15000US060375524003,233,44,10,12,6,9,4,8,223,46,47,23,176,45,8333
15000US060375526011,319,78,29,29,0,12,29,29,290,76,111,70,179,66,8334
15000US060375526012,391,84,92,59,9,15,83,58,299,86,138,58,161,77,8335
15000US060375526013,251,74,32,29,17,20,15,22,219,73,101,60,118,49,8336
15000US060375526014,236,74,44,41,24,26,20,30,192,66,22,20,170,67,8337
15000US060375526021,356,54,3,10,3,10,0,12,353,53,120,61,233,65,8338
15000US060375526022,279,76,33,37,0,12,33,37,246,72,87,51,159,71,8339
15000US060375526023,514,84,96,46,22,35,74,37,418,82,80,52,338,87,8340
15000US060375527001,613,89,75,63,49,58,26,26,538,86,119,48,419,92,8341
15000US060375527002,193,58,0,12,0,12,0,12,193,58,43,29,150,63,8342
15000US060375527003,391,84,41,32,21,23,20,26,350,87,96,49,254,78,8343
15000US060375527004,279,80,6,11,0,12,6,11,273,82,120,64,153,68,8344
15000US060375527005,331,70,75,59,6,10,69,57,256,80,62,43,194,80,8345
15000US060375528001,287,86,73,63,26,39,47,53,214,70,32,26,182,76,8346
15000US060375528002,673,109,79,46,39,22,40,41,594,108,157,87,437,98,8347
15000US060375528003,257,82,0,12,0,12,0,12,257,82,52,51,205,70,8348
15000US060375528004,402,83,5,8,0,12,5,8,397,83,82,48,315,79,8349
15000US060375529001,165,56,0,12,0,12,0,12,165,56,41,34,124,54,8350
15000US060375529002,230,69,0,12,0,12,0,12,230,69,97,58,133,65,8351
15000US060375529003,223,66,8,12,0,12,8,12,215,69,57,51,158,70,8352
15000US060375529004,777,101,101,77,58,54,43,57,676,102,238,91,438,109,8353
15000US060375529005,432,85,57,56,7,11,50,55,375,72,125,41,250,73,8354
15000US060375530001,213,59,6,10,6,10,0,12,207,61,39,27,168,63,8355
15000US060375530002,240,84,12,14,12,14,0,12,228,85,27,31,201,86,8356
15000US060375530003,473,105,0,12,0,12,0,12,473,105,120,65,353,88,8357
15000US060375530004,308,85,0,12,0,12,0,12,308,85,81,51,227,76,8358
15000US060375531001,869,123,27,38,4,10,23,35,842,126,176,63,666,123,8359
15000US060375531002,238,65,31,29,0,12,31,29,207,60,74,41,133,66,8360
15000US060375531003,224,60,7,12,7,12,0,12,217,63,34,25,183,66,8361
15000US060375531004,479,85,39,35,16,24,23,26,440,90,113,47,327,80,8362
15000US060375532001,302,69,17,20,0,12,17,20,285,68,102,45,183,68,8363
15000US060375532002,221,53,19,30,0,12,19,30,202,51,56,31,146,52,8364
15000US060375532003,187,58,8,13,8,13,0,12,179,59,80,46,99,63,8365
15000US060375532004,269,64,15,15,15,15,0,12,254,67,53,26,201,72,8366
15000US060375532005,447,78,116,63,8,13,108,66,331,79,87,57,244,71,8367
15000US060375532006,222,49,6,10,6,10,0,12,216,49,81,40,135,52,8368
15000US060375532007,315,65,0,12,0,12,0,12,315,65,64,37,251,75,8369
15000US060375533001,247,80,1,8,1,8,0,12,246,80,78,46,168,75,8370
15000US060375533002,288,76,31,30,11,19,20,25,257,79,100,61,157,67,8371
15000US060375533003,436,94,34,31,8,12,26,27,402,94,83,46,319,94,8372
15000US060375534001,333,59,15,15,5,8,10,10,318,60,33,21,285,64,8373
15000US060375534002,327,68,35,27,16,15,19,22,292,68,63,36,229,62,8374
15000US060375534003,235,46,54,40,25,26,29,31,181,45,27,18,154,44,8375
15000US060375535021,556,107,38,27,15,17,23,22,518,113,125,66,393,110,8376
15000US060375535022,667,96,169,90,24,22,145,86,498,109,101,62,397,109,8377
15000US060375535031,739,40,80,36,33,26,47,26,659,51,131,51,528,60,8378
15000US060375535041,451,88,98,50,15,21,83,43,353,92,86,45,267,86,8379
15000US060375535042,492,90,153,81,17,26,136,81,339,82,120,61,219,75,8380
15000US060375535043,399,90,74,63,51,50,23,35,325,89,75,55,250,76,8381
15000US060375536011,886,91,197,80,90,68,107,60,689,106,151,81,538,118,8382
15000US060375536012,360,83,15,14,8,14,7,11,345,85,158,78,187,73,8383
15000US060375536021,1008,79,146,79,34,31,112,71,862,111,112,54,750,106,8384
15000US060375536022,323,71,18,23,18,23,0,12,305,77,63,34,242,76,8385
15000US060375537011,268,46,39,24,39,24,0,12,229,49,52,28,177,47,8386
15000US060375537012,403,60,122,41,16,15,106,40,281,59,109,53,172,55,8387
15000US060375537013,188,44,37,32,0,12,37,32,151,43,23,24,128,41,8388
15000US060375537021,610,71,162,78,99,55,63,49,448,101,179,68,269,87,8389
15000US060375537022,445,71,30,31,8,12,22,27,415,70,163,64,252,66,8390
15000US060375538011,275,54,26,31,0,12,26,31,249,56,44,44,205,58,8391
15000US060375538012,248,65,46,43,11,17,35,40,202,69,57,42,145,62,8392
15000US060375538013,514,96,114,55,28,27,86,45,400,102,118,65,282,95,8393
15000US060375538021,508,99,88,59,15,16,73,60,420,91,183,77,237,87,8394
15000US060375538022,779,112,31,25,10,11,21,23,748,115,278,94,470,124,8395
15000US060375538023,631,120,110,71,1,8,109,70,521,116,158,75,363,109,8396
15000US060375539011,406,75,55,47,0,12,55,47,351,80,134,61,217,68,8397
15000US060375539012,460,80,71,43,9,13,62,42,389,78,116,52,273,76,8398
15000US060375539013,422,106,73,55,16,18,57,53,349,102,65,42,284,105,8399
15000US060375539014,357,76,60,42,22,21,38,40,297,76,97,58,200,72,8400
15000US060375539021,582,85,67,50,14,16,53,47,515,85,55,45,460,91,8401
15000US060375539022,569,87,63,43,9,13,54,40,506,98,100,64,406,91,8402
15000US060375539023,471,88,169,81,43,39,126,67,302,78,127,57,175,66,8403
15000US060375540011,357,78,40,50,1,12,39,51,317,80,106,44,211,80,8404
15000US060375540012,265,73,11,19,11,19,0,12,254,76,83,42,171,72,8405
15000US060375540013,252,70,44,50,8,12,36,54,208,55,115,44,93,54,8406
15000US060375540014,263,80,0,12,0,12,0,12,263,80,66,38,197,81,8407
15000US060375540021,588,86,89,59,60,51,29,29,499,80,155,70,344,87,8408
15000US060375540022,772,109,175,78,128,64,47,42,597,117,123,57,474,109,8409
15000US060375540023,298,79,22,34,22,34,0,12,276,77,9,14,267,80,8410
15000US060375541011,281,77,23,30,0,12,23,30,258,74,46,35,212,84,8411
15000US060375541012,717,97,194,64,15,24,179,63,523,97,95,52,428,109,8412
15000US060375541031,440,32,25,23,5,9,20,19,415,35,78,36,337,38,8413
15000US060375541041,281,51,35,28,10,10,25,27,246,52,72,37,174,50,8414
15000US060375541042,450,62,87,48,22,23,65,46,363,65,115,48,248,59,8415
15000US060375541051,792,111,152,71,22,25,130,69,640,110,106,67,534,104,8416
15000US060375541052,682,102,143,66,6,11,137,65,539,113,131,63,408,117,8417
15000US060375542011,289,64,29,32,0,12,29,32,260,63,60,42,200,69,8418
15000US060375542012,412,89,17,24,0,12,17,24,395,87,73,52,322,87,8419
15000US060375542013,487,94,106,62,35,33,71,50,381,101,60,33,321,102,8420
15000US060375542031,225,60,59,58,27,43,32,44,166,57,37,35,129,54,8421
15000US060375542032,599,91,8,13,0,12,8,13,591,90,113,57,478,86,8422
15000US060375542033,391,75,46,41,30,37,16,19,345,81,56,36,289,82,8423
15000US060375542041,249,66,0,12,0,12,0,12,249,66,54,31,195,66,8424
15000US060375542042,643,105,119,73,10,15,109,74,524,114,197,87,327,106,8425
15000US060375542043,723,132,102,77,0,12,102,77,621,135,178,103,443,111,8426
15000US060375543011,401,75,72,63,8,13,64,61,329,96,27,22,302,99,8427
15000US060375543012,447,89,84,75,0,12,84,75,363,76,148,74,215,68,8428
15000US060375543013,180,63,52,39,14,20,38,36,128,55,14,16,114,56,8429
15000US060375543021,758,91,150,87,0,12,150,87,608,103,99,65,509,111,8430
15000US060375543022,452,92,32,23,8,12,24,20,420,93,121,67,299,95,8431
15000US060375544031,903,126,143,66,39,38,104,55,760,136,140,55,620,131,8432
15000US060375544032,789,89,101,53,58,44,43,39,688,98,87,46,601,93,8433
15000US060375544041,478,81,75,54,21,23,54,49,403,87,117,62,286,97,8434
15000US060375544042,832,97,203,86,11,17,192,81,629,119,126,71,503,116,8435
15000US060375544051,210,79,9,13,0,12,9,13,201,79,44,39,157,68,8436
15000US060375544052,974,95,96,40,63,36,33,33,878,99,194,83,684,119,8437
15000US060375544061,732,95,9,15,0,12,9,15,723,93,169,75,554,101,8438
15000US060375544062,236,50,15,17,7,12,8,12,221,54,46,30,175,58,8439
15000US060375544063,646,96,51,44,14,22,37,39,595,98,113,55,482,108,8440
15000US060375545111,826,68,13,15,9,14,4,7,813,69,113,48,700,78,8441
15000US060375545112,332,64,0,12,0,12,0,12,332,64,58,32,274,67,8442
15000US060375545121,1152,87,26,23,18,19,8,13,1126,90,162,57,964,101,8443
15000US060375545122,738,82,38,48,29,45,9,16,700,78,171,60,529,95,8444
15000US060375545131,818,37,26,26,0,12,26,26,792,42,161,46,631,51,8445
15000US060375545141,448,73,9,13,9,13,0,12,439,74,85,59,354,77,8446
15000US060375545142,462,77,12,18,12,18,0,12,450,80,90,53,360,80,8447
15000US060375545143,497,80,4,10,0,12,4,10,493,81,43,31,450,80,8448
15000US060375545151,386,61,0,12,0,12,0,12,386,61,77,42,309,67,8449
15000US060375545152,764,68,16,19,16,19,0,12,748,73,187,61,561,90,8450
15000US060375545161,611,78,21,22,11,16,10,16,590,80,109,45,481,89,8451
15000US060375545162,532,72,9,14,9,14,0,12,523,75,74,40,449,79,8452
15000US060375545171,876,91,41,33,12,18,29,24,835,95,187,54,648,96,8453
15000US060375545172,565,84,4,8,4,8,0,12,561,84,80,41,481,87,8454
15000US060375545181,394,56,0,12,0,12,0,12,394,56,36,26,358,63,8455
15000US060375545182,818,70,0,12,0,12,0,12,818,70,148,58,670,86,8456
15000US060375545183,460,72,0,12,0,12,0,12,460,72,162,62,298,69,8457
15000US060375545191,420,73,8,14,8,14,0,12,412,74,111,54,301,60,8458
15000US060375545192,753,78,0,12,0,12,0,12,753,78,131,60,622,82,8459
15000US060375545211,673,87,9,14,9,14,0,12,664,88,155,58,509,90,8460
15000US060375545212,643,78,19,20,0,12,19,20,624,78,108,48,516,97,8461
15000US060375545213,649,81,37,39,26,35,11,17,612,81,201,59,411,78,8462
15000US060375545221,370,91,0,12,0,12,0,12,370,91,76,67,294,86,8463
15000US060375545222,493,94,38,43,0,12,38,43,455,93,131,60,324,85,8464
15000US060375545223,662,89,28,30,9,14,19,25,634,93,157,67,477,95,8465
15000US060375546001,826,78,40,42,0,12,40,42,786,79,262,90,524,97,8466
15000US060375546002,457,76,45,42,0,12,45,42,412,83,77,41,335,84,8467
15000US060375547001,353,63,80,56,6,11,74,54,273,61,124,38,149,51,8468
15000US060375547002,469,69,77,52,4,6,73,52,392,72,132,39,260,76,8469
15000US060375547003,205,52,24,19,0,12,24,19,181,51,86,35,95,45,8470
15000US060375548011,522,59,115,51,30,28,85,43,407,63,53,30,354,73,8471
15000US060375548012,246,53,4,6,4,6,0,12,242,53,83,33,159,49,8472
15000US060375548021,759,106,44,43,37,47,7,12,715,101,188,58,527,97,8473
15000US060375548022,563,105,17,19,17,19,0,12,546,107,78,51,468,111,8474
15000US060375548023,436,90,20,23,12,18,8,14,416,88,155,65,261,66,8475
15000US060375549001,482,124,28,33,0,12,28,33,454,126,166,114,288,101,8476
15000US060375549002,307,76,0,12,0,12,0,12,307,76,49,51,258,71,8477
15000US060375549003,158,57,0,12,0,12,0,12,158,57,64,45,94,48,8478
15000US060375549004,874,132,112,108,56,82,56,65,762,141,236,126,526,135,8479
15000US060375549005,317,101,0,12,0,12,0,12,317,101,151,98,166,91,8480
15000US060375550011,357,62,10,18,10,18,0,12,347,62,149,56,198,64,8481
15000US060375550012,187,52,6,9,0,12,6,9,181,53,62,43,119,62,8482
15000US060375550013,382,74,18,24,0,12,18,24,364,73,81,44,283,80,8483
15000US060375550014,582,76,113,50,33,43,80,51,469,75,170,68,299,74,8484
15000US060375550021,373,76,87,57,43,41,44,43,286,89,42,38,244,84,8485
15000US060375550022,696,80,17,18,9,14,8,12,679,79,119,67,560,85,8486
15000US060375551021,1011,112,201,91,56,50,145,92,810,114,238,85,572,116,8487
15000US060375551022,928,111,255,87,29,34,226,80,673,137,219,103,454,139,8488
15000US060375551031,614,107,39,29,9,17,30,27,575,106,135,70,440,92,8489
15000US060375551032,815,107,2,9,2,9,0,12,813,107,136,69,677,101,8490
15000US060375551041,844,94,7,12,0,12,7,12,837,94,175,86,662,97,8491
15000US060375551042,463,100,73,69,9,14,64,69,390,111,66,45,324,115,8492
15000US060375552021,603,92,0,12,0,12,0,12,603,92,146,62,457,92,8493
15000US060375552022,462,86,0,12,0,12,0,12,462,86,57,35,405,88,8494
15000US060375552111,540,96,139,78,28,23,111,73,401,96,107,47,294,103,8495
15000US060375552112,119,59,14,20,14,20,0,12,105,59,64,52,41,29,8496
15000US060375552113,703,100,186,92,59,62,127,70,517,119,170,85,347,118,8497
15000US060375552121,1195,92,247,95,85,50,162,82,948,129,172,61,776,127,8498
15000US060375700011,410,76,0,12,0,12,0,12,410,76,109,57,301,75,8499
15000US060375700012,292,70,0,12,0,12,0,12,292,70,108,47,184,71,8500
15000US060375700013,386,70,19,29,0,12,19,29,367,69,92,42,275,69,8501
15000US060375700014,321,55,6,10,0,12,6,10,315,55,77,40,238,65,8502
15000US060375700021,258,44,14,15,14,15,0,12,244,44,44,33,200,44,8503
15000US060375700022,305,53,9,12,0,12,9,12,296,55,100,42,196,49,8504
15000US060375700023,357,46,13,14,0,12,13,14,344,45,94,43,250,49,8505
15000US060375700031,301,68,43,45,35,43,8,13,258,64,30,25,228,61,8506
15000US060375700032,363,63,18,20,18,20,0,12,345,65,59,28,286,67,8507
15000US060375700033,277,79,43,49,36,46,7,12,234,79,36,27,198,77,8508
15000US060375700034,216,72,0,12,0,12,0,12,216,72,27,32,189,74,8509
15000US060375700035,250,55,14,19,0,12,14,19,236,57,115,45,121,45,8510
15000US060375701001,341,54,8,11,8,11,0,12,333,54,99,41,234,55,8511
15000US060375701002,387,55,31,23,22,19,9,10,356,59,86,46,270,54,8512
15000US060375702021,238,70,25,21,17,18,8,12,213,71,46,45,167,71,8513
15000US060375702022,312,76,25,23,8,13,17,18,287,77,48,37,239,74,8514
15000US060375702023,311,72,35,32,23,34,12,18,276,74,131,62,145,65,8515
15000US060375702024,207,62,34,34,27,33,7,11,173,61,15,19,158,62,8516
15000US060375702025,497,97,62,47,25,32,37,37,435,88,131,62,304,90,8517
15000US060375702031,731,104,134,74,85,59,49,44,597,125,153,87,444,107,8518
15000US060375702032,427,88,113,68,27,32,86,60,314,87,53,35,261,83,8519
15000US060375702041,319,76,0,12,0,12,0,12,319,76,61,37,258,75,8520
15000US060375702042,732,83,190,101,75,61,115,84,542,102,103,71,439,109,8521
15000US060375703011,929,130,277,127,8,14,269,127,652,127,168,79,484,130,8522
15000US060375703012,477,123,102,94,0,12,102,94,375,130,100,81,275,120,8523
15000US060375703013,374,97,124,85,108,88,16,27,250,93,45,58,205,87,8524
15000US060375703014,451,119,172,102,12,21,160,103,279,117,18,20,261,116,8525
15000US060375703031,536,96,154,88,103,74,51,50,382,85,87,49,295,93,8526
15000US060375703032,650,99,128,79,106,70,22,37,522,98,159,66,363,109,8527
15000US060375703041,426,84,126,68,48,43,78,53,300,79,44,29,256,75,8528
15000US060375703042,626,94,135,78,77,64,58,45,491,90,131,67,360,90,8529
15000US060375703043,367,77,87,52,13,20,74,47,280,75,51,36,229,78,8530
15000US060375704021,431,51,47,31,14,21,33,27,384,61,90,38,294,61,8531
15000US060375704022,252,39,33,24,33,24,0,12,219,41,51,25,168,42,8532
15000US060375704023,234,44,38,22,19,19,19,24,196,42,53,30,143,40,8533
15000US060375704031,264,62,73,46,19,18,54,42,191,59,53,37,138,59,8534
15000US060375704032,333,72,68,52,8,14,60,50,265,76,73,49,192,66,8535
15000US060375704033,552,88,239,79,67,51,172,74,313,77,47,34,266,88,8536
15000US060375704041,376,47,72,36,20,16,52,32,304,54,83,40,221,52,8537
15000US060375704042,453,51,93,38,20,22,73,37,360,51,134,46,226,48,8538
15000US060375705011,501,146,0,12,0,12,0,12,501,146,151,82,350,129,8539
15000US060375705012,435,108,29,35,16,28,13,20,406,115,157,103,249,104,8540
15000US060375705013,600,136,41,63,41,63,0,12,559,134,94,57,465,141,8541
15000US060375705014,505,124,88,88,0,12,88,88,417,121,82,76,335,118,8542
15000US060375705021,437,94,45,41,7,11,38,39,392,91,94,42,298,97,8543
15000US060375705022,605,101,92,61,48,47,44,41,513,107,79,49,434,107,8544
15000US060375705023,305,70,57,42,15,24,42,33,248,62,55,34,193,62,8545
15000US060375705024,382,82,75,64,9,15,66,62,307,78,58,33,249,80,8546
15000US060375706011,609,86,82,48,23,29,59,40,527,90,132,64,395,84,8547
15000US060375706012,539,82,83,43,53,35,30,29,456,83,102,55,354,88,8548
15000US060375706013,312,71,79,59,39,40,40,44,233,60,52,34,181,61,8549
15000US060375706021,528,82,38,37,38,37,0,12,490,83,161,72,329,78,8550
15000US060375706022,545,96,107,62,46,48,61,45,438,101,146,60,292,92,8551
15000US060375706023,406,79,74,44,6,10,68,42,332,79,119,65,213,79,8552
15000US060375706024,337,75,79,59,33,39,46,52,258,75,100,55,158,64,8553
15000US060375706031,566,102,133,61,31,34,102,57,433,105,231,89,202,79,8554
15000US060375706032,854,111,327,97,86,65,241,87,527,107,157,72,370,110,8555
15000US060375706033,305,86,13,24,0,12,13,24,292,88,45,45,247,85,8556
15000US060375707011,195,83,0,12,0,12,0,12,195,83,51,49,144,79,8557
15000US060375707012,940,164,74,64,0,12,74,64,866,160,95,66,771,162,8558
15000US060375707013,238,80,0,12,0,12,0,12,238,80,90,55,148,76,8559
15000US060375707014,267,82,14,23,0,12,14,23,253,85,87,59,166,91,8560
15000US060375707015,752,119,84,70,12,22,72,67,668,118,134,84,534,125,8561
15000US060375707021,478,52,22,25,0,12,22,25,456,52,117,39,339,54,8562
15000US060375707022,340,46,0,12,0,12,0,12,340,46,75,32,265,53,8563
15000US060375708001,327,63,0,12,0,12,0,12,327,63,116,63,211,57,8564
15000US060375708002,450,79,15,23,15,23,0,12,435,78,73,50,362,88,8565
15000US060375708003,266,53,18,22,9,13,9,17,248,55,71,38,177,50,8566
15000US060375708004,340,72,8,12,0,12,8,12,332,73,121,51,211,72,8567
15000US060375708005,339,80,0,12,0,12,0,12,339,80,46,26,293,86,8568
15000US060375709011,506,73,19,22,19,22,0,12,487,71,96,45,391,77,8569
15000US060375709012,453,89,0,12,0,12,0,12,453,89,95,45,358,90,8570
15000US060375709013,463,77,0,12,0,12,0,12,463,77,83,37,380,84,8571
15000US060375709014,169,44,0,12,0,12,0,12,169,44,27,23,142,43,8572
15000US060375709015,295,72,0,12,0,12,0,12,295,72,93,58,202,50,8573
15000US060375709021,261,65,0,12,0,12,0,12,261,65,22,20,239,62,8574
15000US060375709022,485,84,46,42,0,12,46,42,439,86,81,44,358,87,8575
15000US060375709023,443,81,9,13,0,12,9,13,434,81,98,69,336,74,8576
15000US060375710001,312,68,4,8,0,12,4,8,308,68,69,36,239,69,8577
15000US060375710002,355,76,0,12,0,12,0,12,355,76,66,31,289,87,8578
15000US060375710003,274,49,0,12,0,12,0,12,274,49,44,31,230,49,8579
15000US060375710004,259,71,0,12,0,12,0,12,259,71,32,22,227,68,8580
15000US060375710005,261,42,7,12,7,12,0,12,254,43,78,38,176,45,8581
15000US060375710006,478,69,57,63,0,12,57,63,421,60,70,37,351,67,8582
15000US060375711011,232,62,0,12,0,12,0,12,232,62,76,50,156,58,8583
15000US060375711012,296,68,22,22,22,22,0,12,274,73,20,21,254,75,8584
15000US060375711013,369,80,11,17,0,12,11,17,358,81,77,40,281,76,8585
15000US060375711014,363,64,15,23,0,12,15,23,348,62,59,33,289,71,8586
15000US060375711015,237,51,0,12,0,12,0,12,237,51,16,17,221,53,8587
15000US060375711021,278,49,0,12,0,12,0,12,278,49,37,25,241,52,8588
15000US060375711022,251,69,0,12,0,12,0,12,251,69,72,38,179,66,8589
15000US060375711023,315,74,21,23,14,20,7,11,294,73,57,31,237,77,8590
15000US060375711024,216,62,0,12,0,12,0,12,216,62,53,40,163,61,8591
15000US060375711025,250,51,0,12,0,12,0,12,250,51,98,57,152,53,8592
15000US060375712001,773,129,0,12,0,12,0,12,773,129,151,83,622,128,8593
15000US060375712002,381,100,12,20,0,12,12,20,369,101,128,79,241,88,8594
15000US060375712003,224,84,0,12,0,12,0,12,224,84,51,37,173,78,8595
15000US060375712004,421,99,18,31,18,31,0,12,403,102,12,19,391,101,8596
15000US060375712005,269,109,0,12,0,12,0,12,269,109,55,54,214,115,8597
15000US060375712006,479,151,0,12,0,12,0,12,479,151,84,88,395,148,8598
15000US060375712007,529,139,18,28,18,28,0,12,511,136,131,60,380,131,8599
15000US060375713001,439,80,0,12,0,12,0,12,439,80,148,64,291,73,8600
15000US060375713002,322,66,0,12,0,12,0,12,322,66,78,40,244,66,8601
15000US060375713003,551,82,20,24,20,24,0,12,531,82,120,83,411,79,8602
15000US060375713004,202,41,0,12,0,12,0,12,202,41,23,22,179,40,8603
15000US060375714001,368,64,0,12,0,12,0,12,368,64,59,30,309,63,8604
15000US060375714002,243,60,0,12,0,12,0,12,243,60,44,31,199,63,8605
15000US060375714003,371,77,38,40,0,12,38,40,333,77,96,63,237,72,8606
15000US060375714004,444,75,0,12,0,12,0,12,444,75,127,66,317,71,8607
15000US060375714005,319,64,7,11,7,11,0,12,312,66,92,55,220,55,8608
15000US060375715021,443,91,56,48,41,47,15,16,387,89,148,80,239,66,8609
15000US060375715022,416,88,21,23,21,23,0,12,395,89,117,65,278,97,8610
15000US060375715023,606,104,36,31,11,17,25,26,570,106,133,73,437,99,8611
15000US060375715024,265,80,18,20,0,12,18,20,247,80,97,50,150,70,8612
15000US060375715031,725,100,84,69,31,35,53,58,641,111,96,51,545,111,8613
15000US060375715032,553,103,19,23,8,11,11,20,534,100,55,32,479,106,8614
15000US060375715041,319,83,45,53,0,12,45,53,274,65,67,38,207,66,8615
15000US060375715042,534,106,45,58,0,12,45,58,489,113,57,57,432,106,8616
15000US060375715043,428,78,12,18,0,12,12,18,416,81,61,41,355,82,8617
15000US060375715044,553,107,0,12,0,12,0,12,553,107,33,30,520,111,8618
15000US060375716001,793,22,345,58,52,26,293,54,448,60,239,51,209,56,8619
15000US060375717011,414,97,72,56,22,20,50,52,342,84,72,43,270,89,8620
15000US060375717012,515,101,68,46,0,12,68,46,447,100,93,59,354,94,8621
15000US060375717013,814,120,149,62,18,18,131,65,665,121,135,59,530,126,8622
15000US060375717031,149,62,8,13,8,13,0,12,141,62,23,36,118,57,8623
15000US060375717032,567,112,177,82,113,83,64,66,390,106,149,73,241,87,8624
15000US060375717033,104,49,0,12,0,12,0,12,104,49,11,14,93,50,8625
15000US060375717034,189,79,85,63,21,33,64,52,104,70,27,28,77,67,8626
15000US060375717041,475,86,105,68,6,10,99,68,370,87,113,58,257,85,8627
15000US060375717042,174,74,65,62,0,12,65,62,109,50,10,16,99,49,8628
15000US060375717043,491,90,152,83,116,73,36,42,339,88,66,50,273,88,8629
15000US060375718001,531,82,8,14,0,12,8,14,523,87,174,68,349,88,8630
15000US060375718002,442,89,12,20,12,20,0,12,430,91,83,44,347,96,8631
15000US060375718003,327,89,0,12,0,12,0,12,327,89,35,25,292,93,8632
15000US060375719001,730,155,8,17,0,12,8,17,722,155,57,45,665,159,8633
15000US060375719002,622,133,108,99,71,83,37,57,514,135,111,91,403,142,8634
15000US060375719003,582,125,13,22,0,12,13,22,569,130,178,67,391,131,8635
15000US060375719004,443,107,17,28,17,28,0,12,426,102,50,48,376,107,8636
15000US060375720011,781,96,50,47,0,12,50,47,731,101,113,62,618,120,8637
15000US060375720012,406,93,0,12,0,12,0,12,406,93,66,41,340,93,8638
15000US060375720013,393,96,31,33,0,12,31,33,362,102,44,56,318,92,8639
15000US060375720014,480,99,0,12,0,12,0,12,480,99,85,63,395,103,8640
15000US060375720021,522,94,8,14,0,12,8,14,514,95,166,47,348,97,8641
15000US060375720022,975,119,26,24,8,12,18,20,949,122,241,86,708,117,8642
15000US060375720023,498,83,57,57,25,41,32,39,441,83,103,41,338,86,8643
15000US060375721001,293,31,10,7,0,12,10,7,283,33,84,30,199,37,8644
15000US060375722011,409,98,16,25,0,12,16,25,393,104,147,85,246,97,8645
15000US060375722012,286,102,0,12,0,12,0,12,286,102,45,39,241,98,8646
15000US060375722013,803,131,172,106,101,87,71,62,631,134,303,121,328,110,8647
15000US060375722014,645,101,13,23,0,12,13,23,632,104,176,78,456,125,8648
15000US060375722021,253,70,22,24,0,12,22,24,231,70,30,26,201,66,8649
15000US060375722022,161,60,0,12,0,12,0,12,161,60,73,49,88,41,8650
15000US060375722023,233,96,13,20,13,20,0,12,220,96,79,68,141,57,8651
15000US060375722024,427,67,16,19,8,14,8,13,411,67,35,30,376,68,8652
15000US060375723011,478,79,71,35,0,12,71,35,407,82,145,58,262,72,8653
15000US060375723012,477,77,92,48,26,28,66,38,385,69,84,33,301,67,8654
15000US060375723021,216,56,25,20,20,19,5,8,191,60,58,34,133,57,8655
15000US060375723022,188,55,19,19,5,10,14,15,169,56,46,35,123,48,8656
15000US060375723023,436,69,133,55,24,31,109,45,303,76,71,36,232,68,8657
15000US060375724001,287,64,29,28,29,28,0,12,258,57,71,28,187,61,8658
15000US060375725001,804,142,374,155,104,58,270,149,430,121,213,82,217,100,8659
15000US060375725002,357,109,82,61,82,61,0,12,275,99,125,72,150,77,8660
15000US060375726001,241,64,15,17,0,12,15,17,226,63,116,53,110,55,8661
15000US060375726002,385,81,28,28,9,14,19,23,357,81,124,48,233,85,8662
15000US060375726003,445,85,81,68,18,31,63,68,364,102,46,37,318,97,8663
15000US060375726004,167,38,23,22,15,18,8,12,144,40,24,24,120,39,8664
15000US060375727001,227,76,0,12,0,12,0,12,227,76,66,47,161,62,8665
15000US060375727002,345,79,30,47,0,12,30,47,315,83,113,66,202,79,8666
15000US060375727003,309,85,41,37,32,34,9,14,268,85,87,51,181,82,8667
15000US060375727004,450,91,53,51,8,12,45,50,397,99,80,40,317,100,8668
15000US060375728001,187,44,51,30,46,29,5,7,136,42,47,26,89,39,8669
15000US060375729001,436,77,138,69,79,52,59,54,298,75,103,53,195,63,8670
15000US060375729002,574,90,209,83,76,59,133,73,365,93,105,53,260,90,8671
15000US060375729003,255,57,3,10,0,12,3,10,252,58,48,34,204,60,8672
15000US060375730021,552,96,147,76,26,30,121,71,405,106,67,44,338,108,8673
15000US060375730022,526,98,132,56,35,33,97,46,394,101,16,25,378,101,8674
15000US060375730031,592,43,66,40,16,15,50,37,526,50,59,31,467,53,8675
15000US060375730041,425,109,63,49,25,40,38,40,362,109,16,22,346,110,8676
15000US060375730042,459,112,148,84,75,61,73,58,311,100,33,26,278,103,8677
15000US060375730043,244,94,14,24,0,12,14,24,230,95,21,19,209,92,8678
15000US060375730044,421,105,73,47,14,16,59,45,348,112,58,43,290,116,8679
15000US060375731001,577,124,98,75,34,39,64,61,479,136,69,56,410,154,8680
15000US060375731002,1182,134,245,94,20,27,225,97,937,144,122,62,815,157,8681
15000US060375731003,349,97,28,33,28,33,0,12,321,101,30,31,291,97,8682
15000US060375731004,285,87,17,28,17,28,0,12,268,89,81,72,187,95,8683
15000US060375732011,669,83,59,44,41,39,18,21,610,73,158,61,452,80,8684
15000US060375732012,663,77,108,61,40,36,68,51,555,95,132,55,423,93,8685
15000US060375732021,478,89,109,59,31,27,78,51,369,96,72,44,297,92,8686
15000US060375732022,604,112,126,72,38,38,88,55,478,95,100,56,378,86,8687
15000US060375732023,589,100,219,90,76,56,143,77,370,102,59,40,311,100,8688
15000US060375733001,723,75,290,89,76,51,214,76,433,92,111,53,322,91,8689
15000US060375733002,334,60,105,52,19,19,86,53,229,61,9,14,220,62,8690
15000US060375734011,533,50,31,25,0,12,31,25,502,53,65,33,437,51,8691
15000US060375734021,0,12,0,12,0,12,0,12,0,12,0,12,0,12,8692
15000US060375734022,314,99,33,26,0,12,33,26,281,97,80,54,201,105,8693
15000US060375734023,692,175,79,71,39,47,40,43,613,186,23,35,590,187,8694
15000US060375734024,647,141,15,24,0,12,15,24,632,142,168,89,464,137,8695
15000US060375734025,655,130,13,21,0,12,13,21,642,133,114,58,528,133,8696
15000US060375734031,1261,87,25,29,0,12,25,29,1236,92,141,53,1095,100,8697
15000US060375736011,507,121,0,12,0,12,0,12,507,121,105,63,402,140,8698
15000US060375736012,269,79,16,27,0,12,16,27,253,81,49,46,204,83,8699
15000US060375736013,249,64,0,12,0,12,0,12,249,64,87,51,162,73,8700
15000US060375736014,0,12,0,12,0,12,0,12,0,12,0,12,0,12,8701
15000US060375736015,0,12,0,12,0,12,0,12,0,12,0,12,0,12,8702
15000US060375736016,269,78,0,12,0,12,0,12,269,78,55,52,214,96,8703
15000US060375736017,337,89,13,21,13,21,0,12,324,94,51,47,273,97,8704
15000US060375736018,295,82,0,12,0,12,0,12,295,82,92,55,203,93,8705
15000US060375736019,356,112,0,12,0,12,0,12,356,112,46,37,310,113,8706
15000US060375737001,319,71,15,22,0,12,15,22,304,69,67,47,237,73,8707
15000US060375737002,197,47,0,12,0,12,0,12,197,47,73,32,124,46,8708
15000US060375737003,357,68,5,10,5,10,0,12,352,69,76,50,276,65,8709
15000US060375737004,333,73,11,19,0,12,11,19,322,72,35,24,287,71,8710
15000US060375737005,188,40,0,12,0,12,0,12,188,40,77,34,111,37,8711
15000US060375737006,290,57,18,19,0,12,18,19,272,55,95,33,177,56,8712
15000US060375738001,473,75,8,12,0,12,8,12,465,75,72,40,393,82,8713
15000US060375738002,350,69,0,12,0,12,0,12,350,69,88,45,262,73,8714
15000US060375738003,285,69,16,18,0,12,16,18,269,70,67,38,202,69,8715
15000US060375738004,356,68,14,18,0,12,14,18,342,66,90,36,252,69,8716
15000US060375739021,832,40,0,12,0,12,0,12,832,40,207,55,625,64,8717
15000US060375740001,342,58,10,14,0,12,10,14,332,61,56,34,276,60,8718
15000US060375740002,305,48,0,12,0,12,0,12,305,48,36,26,269,53,8719
15000US060375740003,407,61,0,12,0,12,0,12,407,61,75,40,332,67,8720
15000US060375740004,339,51,0,12,0,12,0,12,339,51,114,47,225,65,8721
15000US060375740005,486,76,4,8,4,8,0,12,482,77,80,40,402,82,8722
15000US060375741001,306,54,10,16,0,12,10,16,296,55,82,37,214,54,8723
15000US060375741002,431,78,0,12,0,12,0,12,431,78,62,37,369,86,8724
15000US060375741003,348,55,19,21,0,12,19,21,329,59,26,25,303,57,8725
15000US060375741004,413,62,0,12,0,12,0,12,413,62,76,37,337,73,8726
15000US060375741005,385,57,8,12,8,12,0,12,377,57,37,30,340,66,8727
15000US060375742011,329,54,0,12,0,12,0,12,329,54,67,38,262,54,8728
15000US060375742012,317,56,0,12,0,12,0,12,317,56,41,31,276,60,8729
15000US060375742013,252,56,8,12,8,12,0,12,244,57,43,29,201,61,8730
15000US060375742014,204,41,0,12,0,12,0,12,204,41,46,28,158,49,8731
15000US060375742021,315,47,0,12,0,12,0,12,315,47,40,19,275,45,8732
15000US060375742022,387,55,32,25,4,7,28,24,355,57,101,41,254,65,8733
15000US060375743001,293,66,0,12,0,12,0,12,293,66,97,60,196,79,8734
15000US060375743002,262,55,0,12,0,12,0,12,262,55,111,49,151,54,8735
15000US060375743003,375,96,29,37,0,12,29,37,346,102,62,70,284,92,8736
15000US060375743004,252,79,0,12,0,12,0,12,252,79,85,58,167,86,8737
15000US060375743005,311,64,0,12,0,12,0,12,311,64,84,45,227,72,8738
15000US060375743006,344,76,0,12,0,12,0,12,344,76,18,27,326,75,8739
15000US060375743007,375,86,0,12,0,12,0,12,375,86,101,67,274,73,8740
15000US060375744001,249,45,0,12,0,12,0,12,249,45,40,28,209,48,8741
15000US060375744002,292,45,10,16,10,16,0,12,282,47,67,35,215,48,8742
15000US060375744003,346,45,15,21,15,21,0,12,331,47,60,35,271,56,8743
15000US060375744004,440,58,11,18,11,18,0,12,429,60,107,42,322,64,8744
15000US060375744005,275,47,0,12,0,12,0,12,275,47,57,35,218,55,8745
15000US060375744006,278,48,0,12,0,12,0,12,278,48,52,28,226,53,8746
15000US060375745001,595,87,0,12,0,12,0,12,595,87,178,76,417,99,8747
15000US060375745002,726,116,15,25,0,12,15,25,711,117,137,65,574,130,8748
15000US060375745003,489,102,0,12,0,12,0,12,489,102,49,38,440,104,8749
15000US060375745004,428,109,0,12,0,12,0,12,428,109,191,77,237,93,8750
15000US060375746011,0,12,0,12,0,12,0,12,0,12,0,12,0,12,8751
15000US060375746021,544,27,5,8,0,12,5,8,539,24,146,38,393,43,8752
15000US060375747001,0,12,0,12,0,12,0,12,0,12,0,12,0,12,8753
15000US060375748001,338,70,0,12,0,12,0,12,338,70,66,34,272,74,8754
15000US060375748002,751,109,11,15,0,12,11,15,740,108,99,69,641,107,8755
15000US060375748003,328,67,12,19,0,12,12,19,316,67,65,40,251,72,8756
15000US060375749011,378,74,0,12,0,12,0,12,378,74,27,23,351,75,8757
15000US060375749012,237,60,0,12,0,12,0,12,237,60,52,45,185,57,8758
15000US060375749013,388,60,0,12,0,12,0,12,388,60,54,33,334,66,8759
15000US060375749014,372,56,0,12,0,12,0,12,372,56,113,45,259,69,8760
15000US060375749021,310,72,5,9,5,9,0,12,305,75,64,38,241,69,8761
15000US060375749022,495,84,24,39,24,39,0,12,471,79,45,32,426,84,8762
15000US060375749023,934,102,29,35,0,12,29,35,905,97,95,38,810,103,8763
15000US060375750011,479,78,0,12,0,12,0,12,479,78,76,38,403,82,8764
15000US060375750012,1140,106,13,15,7,12,6,9,1127,106,77,51,1050,110,8765
15000US060375750021,718,104,21,32,21,32,0,12,697,104,56,45,641,105,8766
15000US060375750022,625,83,67,52,19,25,48,46,558,92,60,34,498,88,8767
15000US060375750023,504,72,38,43,0,12,38,43,466,71,29,26,437,73,8768
15000US060375751011,809,103,167,72,33,27,134,69,642,118,196,80,446,127,8769
15000US060375751012,605,97,48,41,21,20,27,37,557,97,48,28,509,96,8770
15000US060375751021,612,89,116,60,9,14,107,60,496,88,52,37,444,89,8771
15000US060375751022,592,85,211,78,22,26,189,72,381,86,53,40,328,88,8772
15000US060375751031,756,99,174,71,28,42,146,77,582,110,127,62,455,104,8773
15000US060375751032,773,108,61,39,29,29,32,27,712,114,110,58,602,121,8774
15000US060375751033,460,87,32,40,9,15,23,37,428,89,33,27,395,96,8775
15000US060375752011,355,68,66,52,19,30,47,42,289,67,80,43,209,66,8776
15000US060375752012,414,68,95,56,27,31,68,47,319,83,93,49,226,72,8777
15000US060375752013,467,77,147,58,15,17,132,58,320,74,96,50,224,70,8778
15000US060375752021,495,81,135,62,53,40,82,46,360,74,63,36,297,79,8779
15000US060375752022,384,74,154,64,65,44,89,54,230,74,43,35,187,67,8780
15000US060375752023,355,62,129,59,30,35,99,54,226,64,50,29,176,65,8781
15000US060375753001,352,81,137,79,0,12,137,79,215,66,56,37,159,73,8782
15000US060375753002,561,100,269,89,95,68,174,69,292,83,110,52,182,79,8783
15000US060375753003,442,95,189,86,36,46,153,79,253,81,117,56,136,73,8784
15000US060375754011,72,32,30,24,0,12,30,24,42,27,0,12,42,27,8785
15000US060375754012,139,44,27,34,0,12,27,34,112,38,84,44,28,21,8786
15000US060375754013,238,95,69,51,24,29,45,42,169,85,89,66,80,46,8787
15000US060375754014,792,105,262,77,43,36,219,76,530,97,50,39,480,104,8788
15000US060375754021,814,56,320,60,100,52,220,65,494,72,103,46,391,75,8789
15000US060375754022,192,40,49,26,9,13,40,24,143,40,69,24,74,34,8790
15000US060375755001,25,14,8,13,8,13,0,12,17,15,10,16,7,8,8791
15000US060375758011,451,57,158,58,22,23,136,54,293,58,89,40,204,53,8792
15000US060375758012,202,42,75,39,27,23,48,33,127,38,38,29,89,34,8793
15000US060375758021,733,91,232,82,56,30,176,80,501,92,129,64,372,94,8794
15000US060375758022,820,98,231,82,56,41,175,75,589,97,187,68,402,93,8795
15000US060375758031,596,112,173,72,15,22,158,75,423,102,132,77,291,96,8796
15000US060375758032,633,113,125,66,21,22,104,62,508,112,145,72,363,89,8797
15000US060375759011,513,87,148,78,87,68,61,55,365,79,91,56,274,80,8798
15000US060375759012,302,57,20,23,10,16,10,15,282,52,58,38,224,49,8799
15000US060375759013,230,52,59,39,16,26,43,31,171,49,30,21,141,47,8800
15000US060375759014,330,74,35,38,18,29,17,26,295,71,45,32,250,67,8801
15000US060375759021,850,158,136,90,27,23,109,87,714,160,84,73,630,159,8802
15000US060375759022,1075,151,55,64,14,23,41,60,1020,151,236,109,784,176,8803
15000US060375759023,776,117,88,65,28,41,60,50,688,132,128,82,560,125,8804
15000US060375760011,1077,177,0,12,0,12,0,12,1077,177,112,88,965,152,8805
15000US060375760012,1672,204,58,87,0,12,58,87,1614,189,83,59,1531,184,8806
15000US060375760013,500,133,46,76,0,12,46,76,454,118,60,51,394,121,8807
15000US060375762001,500,122,183,98,14,25,169,99,317,106,27,31,290,104,8808
15000US060375762002,622,142,81,68,13,20,68,66,541,130,226,125,315,138,8809
15000US060375762003,636,136,89,73,40,42,49,59,547,139,172,91,375,135,8810
15000US060375762004,405,121,73,61,61,59,12,22,332,115,162,83,170,91,8811
15000US060375762005,716,169,105,103,14,23,91,101,611,145,137,79,474,139,8812
15000US060375763011,373,84,55,35,0,12,55,35,318,85,101,45,217,81,8813
15000US060375763012,500,83,47,39,27,31,20,25,453,82,87,52,366,87,8814
15000US060375763013,530,78,106,58,56,45,50,45,424,84,60,37,364,81,8815
15000US060375763014,268,71,20,23,8,12,12,18,248,73,76,54,172,63,8816
15000US060375763021,410,96,84,52,0,12,84,52,326,104,24,24,302,108,8817
15000US060375763022,337,70,157,73,21,25,136,73,180,75,11,17,169,78,8818
15000US060375763023,469,125,83,57,32,40,51,45,386,132,155,114,231,78,8819
15000US060375764011,467,94,174,72,92,70,82,51,293,89,138,68,155,70,8820
15000US060375764012,755,99,186,79,61,50,125,73,569,128,141,75,428,119,8821
15000US060375764021,601,94,230,80,80,54,150,71,371,86,134,69,237,84,8822
15000US060375764022,690,100,165,69,24,30,141,68,525,91,118,69,407,81,8823
15000US060375764031,695,101,232,71,41,39,191,59,463,91,142,62,321,94,8824
15000US060375764032,715,96,237,77,67,50,170,69,478,88,170,72,308,83,8825
15000US060375765011,637,94,76,46,5,8,71,46,561,93,155,70,406,96,8826
15000US060375765012,798,105,112,71,19,30,93,66,686,99,119,63,567,100,8827
15000US060375765021,1019,131,220,97,40,38,180,93,799,119,214,93,585,120,8828
15000US060375765022,428,87,136,70,68,46,68,54,292,79,50,29,242,75,8829
15000US060375765023,535,108,17,18,10,15,7,10,518,107,122,64,396,110,8830
15000US060375765031,880,111,93,52,0,12,93,52,787,106,188,77,599,101,8831
15000US060375765032,991,114,61,48,27,32,34,38,930,114,134,64,796,127,8832
15000US060375766011,1666,197,36,34,14,22,22,27,1630,201,349,106,1281,230,8833
15000US060375766012,525,145,17,29,0,12,17,29,508,146,42,38,466,142,8834
15000US060375766013,597,157,15,23,0,12,15,23,582,162,198,135,384,138,8835
15000US060375766020,0,12,0,12,0,12,0,12,0,12,0,12,0,12,8836
15000US060375766021,955,183,0,12,0,12,0,12,955,183,185,92,770,200,8837
15000US060375766022,518,137,47,45,16,27,31,36,471,137,32,38,439,137,8838
15000US060375766023,495,158,0,12,0,12,0,12,495,158,43,42,452,161,8839
15000US060375766024,706,149,65,86,0,12,65,86,641,149,126,93,515,140,8840
15000US060375767001,620,138,35,56,35,56,0,12,585,131,84,40,501,134,8841
15000US060375767002,387,90,0,12,0,12,0,12,387,90,96,56,291,95,8842
15000US060375767003,1075,208,23,26,23,26,0,12,1052,210,91,77,961,212,8843
15000US060375768011,356,116,56,78,9,18,47,77,300,121,19,26,281,120,8844
15000US060375768012,678,126,34,40,34,40,0,12,644,129,100,65,544,132,8845
15000US060375768013,1011,152,36,41,36,41,0,12,975,153,139,112,836,168,8846
15000US060375768021,1009,111,73,55,25,29,48,47,936,112,158,89,778,111,8847
15000US060375768022,879,122,15,21,0,12,15,21,864,119,160,77,704,105,8848
15000US060375769011,686,102,168,63,73,43,95,55,518,103,64,44,454,103,8849
15000US060375769012,661,89,119,61,17,27,102,56,542,84,91,45,451,84,8850
15000US060375769013,499,90,149,69,38,36,111,69,350,90,8,13,342,89,8851
15000US060375769031,661,101,108,60,30,27,78,56,553,108,56,40,497,110,8852
15000US060375769032,739,108,57,41,18,24,39,31,682,106,48,31,634,106,8853
15000US060375769041,614,85,44,40,5,9,39,40,570,93,32,25,538,91,8854
15000US060375769042,565,98,81,55,46,56,35,36,484,96,101,65,383,80,8855
15000US060375770001,1035,167,11,24,10,20,1,8,1024,158,129,116,895,178,8856
15000US060375770002,717,148,36,31,19,23,17,27,681,147,25,29,656,147,8857
15000US060375770003,482,119,24,39,0,12,24,39,458,112,58,43,400,114,8858
15000US060375770004,435,129,40,63,0,12,40,63,395,119,36,33,359,123,8859
15000US060375770005,362,109,0,12,0,12,0,12,362,109,32,32,330,108,8860
15000US060375771001,654,140,14,25,0,12,14,25,640,141,170,111,470,121,8861
15000US060375771002,537,94,0,12,0,12,0,12,537,94,20,29,517,94,8862
15000US060375771003,476,109,20,24,0,12,20,24,456,110,38,48,418,108,8863
15000US060375771004,906,144,9,15,9,15,0,12,897,143,88,65,809,146,8864
15000US060375771005,806,129,57,48,14,22,43,42,749,146,202,95,547,145,8865
15000US060375772001,681,127,0,12,0,12,0,12,681,127,30,35,651,130,8866
15000US060375772002,566,114,0,12,0,12,0,12,566,114,63,46,503,118,8867
15000US060375772003,648,126,0,12,0,12,0,12,648,126,178,111,470,112,8868
15000US060375772004,1272,190,12,22,12,22,0,12,1260,193,203,133,1057,189,8869
15000US060375773001,513,135,16,25,16,25,0,12,497,135,26,30,471,133,8870
15000US060375773002,736,169,13,22,0,12,13,22,723,169,63,56,660,173,8871
15000US060375773003,401,131,28,30,14,21,14,22,373,138,0,12,373,138,8872
15000US060375773004,746,147,0,12,0,12,0,12,746,147,75,79,671,143,8873
15000US060375773005,463,128,0,12,0,12,0,12,463,128,16,26,447,127,8874
15000US060375773006,311,99,0,12,0,12,0,12,311,99,29,36,282,92,8875
15000US060375774001,284,72,0,12,0,12,0,12,284,72,17,19,267,70,8876
15000US060375774002,302,60,8,14,0,12,8,14,294,60,14,16,280,66,8877
15000US060375774003,522,77,20,22,12,18,8,13,502,83,69,52,433,78,8878
15000US060375774004,414,77,0,12,0,12,0,12,414,77,77,44,337,76,8879
15000US060375775011,652,84,0,12,0,12,0,12,652,84,91,68,561,88,8880
15000US060375775012,520,81,0,12,0,12,0,12,520,81,83,45,437,79,8881
15000US060375775013,527,78,11,18,11,18,0,12,516,79,133,66,383,78,8882
15000US060375775041,360,49,0,12,0,12,0,12,360,49,75,33,285,58,8883
15000US060375775042,382,52,0,12,0,12,0,12,382,52,32,22,350,55,8884
15000US060375776021,821,97,0,12,0,12,0,12,821,97,103,57,718,102,8885
15000US060375776022,829,86,11,19,11,19,0,12,818,89,184,66,634,101,8886
15000US060375776031,931,134,0,12,0,12,0,12,931,134,135,81,796,137,8887
15000US060375776032,749,119,0,12,0,12,0,12,749,119,105,60,644,122,8888
15000US060375776033,665,147,0,12,0,12,0,12,665,147,26,28,639,149,8889
15000US060375776034,811,142,25,29,13,21,12,20,786,145,107,61,679,141,8890
15000US060375776035,495,105,14,23,0,12,14,23,481,115,13,22,468,116,8891
15000US060375776041,737,61,5,7,5,7,0,12,732,62,94,34,638,65,8892
15000US060375990001,203,86,21,20,0,12,21,20,182,80,33,29,149,78,8893
15000US060375990002,208,85,41,41,16,25,25,31,167,78,20,32,147,72,8894
15000US060375990003,243,83,0,12,0,12,0,12,243,83,53,43,190,74,8895
15000US060375990004,600,112,66,54,15,24,51,49,534,113,80,53,454,105,8896
15000US060375991001,0,12,0,12,0,12,0,12,0,12,0,12,0,12,8897
15000US060375991002,128,46,9,14,0,12,9,14,119,45,12,18,107,43,8898
15000US060376001001,909,115,246,96,111,68,135,76,663,125,220,87,443,123,8899
15000US060376001002,467,95,128,64,19,30,109,59,339,98,111,62,228,89,8900
15000US060376001003,666,103,243,89,37,34,206,90,423,90,140,65,283,86,8901
15000US060376002011,414,100,82,47,28,31,54,42,332,103,114,79,218,86,8902
15000US060376002012,444,101,90,67,25,29,65,57,354,101,85,59,269,90,8903
15000US060376002013,441,100,97,59,50,40,47,43,344,91,123,70,221,100,8904
15000US060376002021,588,99,107,57,52,42,55,38,481,96,111,71,370,91,8905
15000US060376002022,1057,114,209,80,60,50,149,81,848,140,313,99,535,125,8906
15000US060376002023,485,96,133,66,51,48,82,47,352,106,75,48,277,100,8907
15000US060376003021,488,88,142,81,45,37,97,75,346,79,118,44,228,81,8908
15000US060376003022,247,74,30,42,0,12,30,42,217,76,72,54,145,77,8909
15000US060376003023,327,67,45,40,10,15,35,38,282,66,133,49,149,56,8910
15000US060376003031,178,72,55,55,0,12,55,55,123,58,48,44,75,46,8911
15000US060376003032,381,96,203,81,96,63,107,71,178,77,97,64,81,55,8912
15000US060376003033,609,89,163,73,12,19,151,68,446,85,136,69,310,83,8913
15000US060376003041,499,69,178,60,49,29,129,55,321,66,57,31,264,59,8914
15000US060376003042,248,50,51,35,16,19,35,32,197,49,38,24,159,47,8915
15000US060376003043,322,60,129,45,37,27,92,38,193,58,62,36,131,51,8916
15000US060376004001,445,112,107,65,32,34,75,58,338,110,57,43,281,115,8917
15000US060376004002,223,81,50,61,13,21,37,57,173,71,43,35,130,66,8918
15000US060376004003,378,102,38,51,5,18,33,51,340,97,103,62,237,95,8919
15000US060376004004,488,102,32,50,32,50,0,12,456,103,126,77,330,92,8920
15000US060376005011,472,66,26,18,0,12,26,18,446,68,129,46,317,68,8921
15000US060376005012,431,60,73,37,20,13,53,34,358,59,97,45,261,60,8922
15000US060376005021,298,42,15,17,15,17,0,12,283,44,111,41,172,48,8923
15000US060376005022,374,43,18,16,7,11,11,12,356,45,118,38,238,59,8924
15000US060376006011,237,46,22,25,0,12,22,25,215,45,77,33,138,38,8925
15000US060376006012,439,52,40,29,12,12,28,26,399,50,148,43,251,53,8926
15000US060376006013,229,48,26,22,19,20,7,11,203,48,63,30,140,48,8927
15000US060376006021,741,38,174,63,87,45,87,53,567,71,220,59,347,71,8928
15000US060376007021,320,84,20,32,20,32,0,12,300,85,154,79,146,60,8929
15000US060376007022,332,80,0,12,0,12,0,12,332,80,59,36,273,81,8930
15000US060376007023,722,95,54,45,8,12,46,45,668,109,55,40,613,117,8931
15000US060376007031,910,52,11,19,0,12,11,19,899,54,200,56,699,71,8932
15000US060376007041,495,96,104,68,23,37,81,61,391,85,84,40,307,94,8933
15000US060376007042,689,99,19,22,6,11,13,19,670,102,132,55,538,104,8934
15000US060376008011,328,77,0,12,0,12,0,12,328,77,53,34,275,79,8935
15000US060376008012,233,62,19,25,0,12,19,25,214,66,63,40,151,73,8936
15000US060376008013,282,83,39,40,8,13,31,36,243,93,43,46,200,90,8937
15000US060376008014,411,110,0,12,0,12,0,12,411,110,129,64,282,106,8938
15000US060376008021,337,76,41,55,41,55,0,12,296,76,23,21,273,75,8939
15000US060376008022,334,93,16,18,16,18,0,12,318,89,85,43,233,91,8940
15000US060376008023,440,85,0,12,0,12,0,12,440,85,83,63,357,91,8941
15000US060376009021,440,99,0,12,0,12,0,12,440,99,115,67,325,95,8942
15000US060376009022,632,148,173,111,23,37,150,105,459,128,101,80,358,121,8943
15000US060376009023,453,115,54,63,54,63,0,12,399,122,63,58,336,132,8944
15000US060376009024,1014,149,176,103,79,58,97,91,838,157,181,89,657,171,8945
15000US060376009111,390,87,85,44,55,50,30,27,305,83,76,37,229,84,8946
15000US060376009112,728,81,52,49,0,12,52,49,676,83,117,55,559,88,8947
15000US060376009121,721,105,161,53,54,43,107,54,560,109,156,74,404,102,8948
15000US060376009122,557,91,80,50,52,43,28,25,477,96,70,39,407,93,8949
15000US060376009123,235,75,0,12,0,12,0,12,235,75,71,57,164,51,8950
15000US060376010011,325,68,13,18,0,12,13,18,312,67,70,51,242,84,8951
15000US060376010012,751,81,102,66,47,49,55,41,649,93,205,79,444,107,8952
15000US060376010021,536,118,61,65,0,12,61,65,475,112,149,97,326,115,8953
15000US060376010022,722,151,65,65,0,12,65,65,657,146,110,66,547,142,8954
15000US060376010023,746,134,132,84,38,56,94,73,614,129,141,81,473,125,8955
15000US060376011001,605,110,202,91,14,22,188,90,403,100,110,68,293,95,8956
15000US060376011002,762,126,165,87,77,54,88,73,597,140,158,82,439,136,8957
15000US060376011003,737,138,111,80,47,52,64,63,626,121,181,90,445,134,8958
15000US060376012021,487,83,110,68,0,12,110,68,377,89,84,49,293,78,8959
15000US060376012022,279,69,16,25,0,12,16,25,263,64,91,42,172,66,8960
15000US060376012023,278,67,69,49,59,47,10,17,209,62,78,54,131,50,8961
15000US060376012111,573,71,71,46,25,25,46,37,502,80,171,57,331,79,8962
15000US060376012112,543,75,68,46,6,10,62,44,475,71,123,58,352,76,8963
15000US060376012121,1317,159,233,116,69,74,164,105,1084,180,284,148,800,176,8964
15000US060376012122,721,126,110,72,27,30,83,68,611,139,141,70,470,143,8965
15000US060376013011,328,54,13,21,13,21,0,12,315,54,70,31,245,63,8966
15000US060376013012,436,53,63,41,32,28,31,34,373,62,77,31,296,60,8967
15000US060376013021,256,106,57,65,57,65,0,12,199,90,61,61,138,77,8968
15000US060376013022,785,160,120,104,32,46,88,87,665,151,72,77,593,140,8969
15000US060376013023,609,158,201,113,13,21,188,110,408,147,99,74,309,138,8970
15000US060376013024,1159,172,312,146,86,62,226,133,847,166,338,155,509,156,8971
15000US060376013031,635,108,111,58,27,25,84,57,524,109,147,72,377,96,8972
15000US060376013032,425,95,44,47,27,44,17,18,381,99,76,51,305,93,8973
15000US060376013033,933,107,165,64,75,58,90,53,768,105,210,74,558,102,8974
15000US060376014011,791,89,135,72,35,33,100,65,656,97,145,53,511,101,8975
15000US060376014012,328,74,42,36,6,10,36,34,286,69,111,58,175,64,8976
15000US060376014013,475,81,65,44,24,29,41,33,410,88,100,51,310,80,8977
15000US060376014021,432,81,7,12,0,12,7,12,425,81,106,60,319,87,8978
15000US060376014022,300,87,11,18,0,12,11,18,289,84,77,41,212,81,8979
15000US060376014023,288,79,32,35,5,8,27,34,256,77,67,49,189,67,8980
15000US060376014024,300,75,0,12,0,12,0,12,300,75,70,55,230,74,8981
15000US060376015011,413,67,57,50,19,30,38,42,356,74,113,54,243,67,8982
15000US060376015012,675,65,142,78,20,32,122,73,533,90,69,43,464,97,8983
15000US060376015021,677,79,131,54,27,26,104,47,546,84,121,45,425,87,8984
15000US060376015022,203,68,55,47,49,47,6,9,148,57,47,38,101,49,8985
15000US060376016001,230,72,50,53,0,12,50,53,180,72,39,32,141,70,8986
15000US060376016002,479,90,82,62,19,27,63,57,397,88,46,39,351,89,8987
15000US060376016003,337,73,78,58,21,22,57,55,259,68,47,39,212,75,8988
15000US060376017001,136,60,0,12,0,12,0,12,136,60,20,31,116,57,8989
15000US060376017002,443,96,96,59,19,28,77,57,347,94,84,47,263,103,8990
15000US060376017003,291,86,38,23,0,12,38,23,253,92,61,47,192,93,8991
15000US060376017004,435,87,78,60,7,11,71,59,357,85,90,52,267,83,8992
15000US060376018011,549,57,153,50,37,26,116,46,396,64,93,43,303,65,8993
15000US060376018012,289,54,66,39,23,26,43,32,223,54,54,39,169,56,8994
15000US060376018021,603,73,148,71,47,40,101,62,455,81,94,49,361,89,8995
15000US060376018022,389,74,55,43,14,18,41,40,334,77,53,32,281,70,8996
15000US060376019001,773,98,224,75,133,63,91,65,549,94,56,42,493,86,8997
15000US060376019002,509,96,98,63,6,12,92,64,411,99,68,48,343,103,8998
15000US060376020021,312,45,64,36,0,12,64,36,248,46,65,35,183,45,8999
15000US060376020022,541,53,57,30,7,11,50,31,484,53,67,34,417,60,9000
15000US060376020031,679,82,106,56,63,43,43,37,573,95,93,53,480,105,9001
15000US060376020032,601,78,71,39,12,14,59,40,530,82,125,63,405,92,9002
15000US060376020041,615,63,79,59,23,24,56,50,536,77,127,55,409,89,9003
15000US060376020042,434,66,31,32,9,14,22,29,403,65,91,44,312,62,9004
15000US060376021031,635,173,92,68,28,46,64,56,543,179,60,69,483,179,9005
15000US060376021032,590,125,145,85,13,22,132,80,445,140,133,87,312,119,9006
15000US060376021033,914,143,141,138,44,53,97,125,773,143,208,107,565,152,9007
15000US060376021041,969,119,312,118,112,78,200,91,657,126,106,56,551,119,9008
15000US060376021042,762,121,43,34,0,12,43,34,719,122,183,72,536,116,9009
15000US060376021051,330,75,38,36,12,19,26,31,292,76,51,32,241,78,9010
15000US060376021052,716,87,253,86,35,36,218,84,463,78,115,61,348,74,9011
15000US060376021053,269,77,10,20,0,12,10,20,259,75,41,37,218,82,9012
15000US060376021061,1140,153,41,39,25,32,16,25,1099,150,107,81,992,147,9013
15000US060376021062,616,150,32,35,0,12,32,35,584,146,115,67,469,136,9014
15000US060376021063,315,110,0,12,0,12,0,12,315,110,21,29,294,110,9015
15000US060376022001,660,133,12,19,0,12,12,19,648,135,116,77,532,134,9016
15000US060376022002,180,54,12,20,0,12,12,20,168,58,64,43,104,62,9017
15000US060376022003,128,47,7,18,7,18,0,12,121,46,51,34,70,44,9018
15000US060376022004,626,138,0,12,0,12,0,12,626,138,157,108,469,138,9019
15000US060376022005,885,166,64,92,0,12,64,92,821,175,155,91,666,162,9020
15000US060376023011,425,91,73,59,46,45,27,43,352,78,107,63,245,72,9021
15000US060376023012,479,97,0,12,0,12,0,12,479,97,109,68,370,99,9022
15000US060376023013,395,83,0,12,0,12,0,12,395,83,10,15,385,83,9023
15000US060376023014,240,81,7,13,0,12,7,13,233,81,46,56,187,66,9024
15000US060376023015,387,89,0,12,0,12,0,12,387,89,109,57,278,78,9025
15000US060376023021,323,57,0,12,0,12,0,12,323,57,62,37,261,62,9026
15000US060376023022,211,55,0,12,0,12,0,12,211,55,29,26,182,56,9027
15000US060376023023,255,53,21,24,12,19,9,15,234,54,40,34,194,51,9028
15000US060376023024,596,100,12,19,0,12,12,19,584,104,124,54,460,100,9029
15000US060376024021,390,101,15,24,0,12,15,24,375,103,77,69,298,100,9030
15000US060376024022,402,107,13,22,13,22,0,12,389,107,84,56,305,112,9031
15000US060376024023,311,80,10,18,0,12,10,18,301,85,139,66,162,77,9032
15000US060376024024,408,113,22,31,7,13,15,26,386,110,99,82,287,99,9033
15000US060376024025,240,72,0,12,0,12,0,12,240,72,53,62,187,74,9034
15000US060376024026,300,67,51,42,22,32,29,49,249,68,16,25,233,73,9035
15000US060376024031,446,84,26,33,0,12,26,33,420,84,99,58,321,82,9036
15000US060376024032,662,94,105,59,8,13,97,58,557,85,128,64,429,88,9037
15000US060376024033,548,95,95,60,10,15,85,59,453,102,68,52,385,96,9038
15000US060376024041,664,97,74,56,43,40,31,35,590,108,159,69,431,100,9039
15000US060376024042,496,96,79,53,28,32,51,49,417,85,94,58,323,83,9040
15000US060376024043,906,118,109,67,7,12,102,66,797,107,59,43,738,120,9041
15000US060376025041,1154,107,176,75,10,17,166,72,978,111,166,66,812,94,9042
15000US060376025042,586,85,94,62,8,13,86,60,492,77,63,38,429,80,9043
15000US060376025051,1044,100,244,88,50,40,194,80,800,106,67,46,733,114,9044
15000US060376025052,579,84,56,37,28,27,28,23,523,84,100,55,423,90,9045
15000US060376025061,624,108,84,45,12,16,72,42,540,108,100,59,440,94,9046
15000US060376025062,1032,119,181,87,37,43,144,81,851,119,70,41,781,116,9047
15000US060376025071,945,110,117,68,15,15,102,68,828,119,219,77,609,113,9048
15000US060376025072,759,103,117,63,16,27,101,57,642,105,97,55,545,107,9049
15000US060376025081,458,118,37,40,0,12,37,40,421,119,112,60,309,116,9050
15000US060376025082,675,152,14,22,14,22,0,12,661,153,45,50,616,145,9051
15000US060376025083,619,139,122,73,41,50,81,62,497,139,51,61,446,130,9052
15000US060376025084,736,134,92,74,38,48,54,59,644,137,71,42,573,137,9053
15000US060376025091,424,72,7,12,7,12,0,12,417,76,73,37,344,78,9054
15000US060376025092,210,62,37,35,8,12,29,34,173,59,57,39,116,54,9055
15000US060376025093,270,66,28,28,0,12,28,28,242,65,78,46,164,61,9056
15000US060376025094,193,59,32,36,19,30,13,21,161,57,24,23,137,55,9057
15000US060376026001,396,115,30,49,0,12,30,49,366,106,100,68,266,101,9058
15000US060376026002,475,131,88,73,33,39,55,77,387,123,118,80,269,106,9059
15000US060376026003,318,90,82,63,33,40,49,58,236,81,30,31,206,85,9060
15000US060376026004,337,114,63,67,63,67,0,12,274,106,69,52,205,89,9061
15000US060376026005,216,83,41,45,16,24,25,38,175,95,78,79,97,79,9062
15000US060376026006,605,131,0,12,0,12,0,12,605,131,148,90,457,148,9063
15000US060376026007,567,123,0,12,0,12,0,12,567,123,180,91,387,106,9064
15000US060376027001,359,74,44,36,20,23,24,30,315,76,114,62,201,70,9065
15000US060376027002,301,70,9,15,9,15,0,12,292,71,72,46,220,71,9066
15000US060376027003,235,60,13,20,0,12,13,20,222,61,65,35,157,61,9067
15000US060376027004,314,78,68,48,44,41,24,27,246,74,80,46,166,63,9068
15000US060376028011,922,102,110,61,51,38,59,49,812,108,171,69,641,121,9069
15000US060376028012,226,81,66,51,0,12,66,51,160,79,14,14,146,79,9070
15000US060376028021,354,82,49,42,0,12,49,42,305,83,59,34,246,80,9071
15000US060376028022,264,77,8,12,0,12,8,12,256,78,51,46,205,73,9072
15000US060376028023,259,67,36,34,0,12,36,34,223,73,33,30,190,70,9073
15000US060376028024,467,91,30,37,8,12,22,35,437,87,122,51,315,94,9074
15000US060376029001,436,74,67,43,41,36,26,24,369,83,99,40,270,84,9075
15000US060376029002,411,85,61,47,19,18,42,47,350,80,68,46,282,72,9076
15000US060376029003,465,75,39,38,9,14,30,36,426,82,72,48,354,79,9077
15000US060376030011,403,116,26,41,0,12,26,41,377,109,125,71,252,113,9078
15000US060376030012,591,163,33,40,13,22,20,34,558,172,56,66,502,177,9079
15000US060376030013,670,139,27,26,9,15,18,28,643,134,199,99,444,125,9080
15000US060376030014,736,158,22,35,0,12,22,35,714,164,113,62,601,162,9081
15000US060376030041,617,46,48,31,9,9,39,30,569,56,107,43,462,67,9082
15000US060376030051,579,115,49,46,27,30,22,36,530,112,150,84,380,104,9083
15000US060376030052,778,140,193,82,15,16,178,80,585,136,103,81,482,139,9084
15000US060376030053,476,99,58,52,7,12,51,51,418,94,26,23,392,99,9085
15000US060376030061,540,65,23,27,0,12,23,27,517,71,106,42,411,67,9086
15000US060376030062,256,45,12,12,0,12,12,12,244,45,73,34,171,45,9087
15000US060376031011,407,85,41,42,0,12,41,42,366,84,118,59,248,77,9088
15000US060376031012,464,100,62,49,35,43,27,26,402,93,103,47,299,77,9089
15000US060376031013,672,91,58,47,9,14,49,43,614,91,126,60,488,97,9090
15000US060376031021,496,83,40,33,9,14,31,31,456,83,71,38,385,86,9091
15000US060376031022,481,77,34,24,0,12,34,24,447,78,112,53,335,75,9092
15000US060376031023,362,74,28,26,0,12,28,26,334,72,108,56,226,68,9093
15000US060376032001,282,61,34,39,0,12,34,39,248,61,43,58,205,59,9094
15000US060376032002,500,92,0,12,0,12,0,12,500,92,83,41,417,93,9095
15000US060376032003,355,88,0,12,0,12,0,12,355,88,96,72,259,75,9096
15000US060376033011,364,82,0,12,0,12,0,12,364,82,47,40,317,80,9097
15000US060376033012,620,103,26,32,0,12,26,32,594,102,105,58,489,96,9098
15000US060376033013,551,90,51,43,12,18,39,39,500,97,105,64,395,93,9099
15000US060376033021,374,90,0,12,0,12,0,12,374,90,58,34,316,99,9100
15000US060376033022,694,106,0,12,0,12,0,12,694,106,210,82,484,100,9101
15000US060376033023,438,88,9,14,0,12,9,14,429,89,113,49,316,89,9102
15000US060376034001,503,112,43,39,0,12,43,39,460,107,41,30,419,111,9103
15000US060376034002,498,99,26,30,0,12,26,30,472,96,107,38,365,90,9104
15000US060376034003,456,104,0,12,0,12,0,12,456,104,139,46,317,108,9105
15000US060376035001,278,47,9,10,0,12,9,10,269,47,73,29,196,48,9106
15000US060376035002,296,49,9,12,9,12,0,12,287,49,61,31,226,49,9107
15000US060376035003,323,49,6,9,6,9,0,12,317,50,85,38,232,59,9108
15000US060376036001,391,63,0,12,0,12,0,12,391,63,109,57,282,67,9109
15000US060376036002,294,57,0,12,0,12,0,12,294,57,61,35,233,57,9110
15000US060376036003,711,76,18,18,8,12,10,15,693,79,124,50,569,91,9111
15000US060376037021,245,63,4,9,4,9,0,12,241,63,45,30,196,61,9112
15000US060376037022,337,66,6,9,0,12,6,9,331,67,101,51,230,65,9113
15000US060376037023,531,79,9,13,0,12,9,13,522,80,171,78,351,91,9114
15000US060376037024,408,57,54,52,39,46,15,22,354,54,60,36,294,58,9115
15000US060376037031,202,38,4,8,4,8,0,12,198,38,39,22,159,43,9116
15000US060376037032,314,48,0,12,0,12,0,12,314,48,112,48,202,49,9117
15000US060376037033,284,50,18,17,6,10,12,14,266,54,51,28,215,56,9118
15000US060376037041,437,128,35,39,18,30,17,28,402,128,126,96,276,131,9119
15000US060376037042,1124,150,88,74,3,15,85,74,1036,153,212,91,824,157,9120
15000US060376037043,570,136,105,97,49,80,56,62,465,135,126,90,339,133,9121
15000US060376038011,808,110,46,37,14,22,32,30,762,116,113,56,649,116,9122
15000US060376038012,266,85,9,15,0,12,9,15,257,84,98,65,159,74,9123
15000US060376038013,375,75,24,35,24,35,0,12,351,85,37,31,314,85,9124
15000US060376038021,680,94,64,38,7,12,57,36,616,107,151,71,465,101,9125
15000US060376038022,498,92,23,28,8,14,15,25,475,87,175,79,300,84,9126
15000US060376039001,236,80,30,35,11,19,19,31,206,78,66,40,140,75,9127
15000US060376039002,243,99,0,12,0,12,0,12,243,99,41,39,202,113,9128
15000US060376039003,205,78,59,72,44,67,15,24,146,56,37,28,109,55,9129
15000US060376039004,534,126,68,73,0,12,68,73,466,116,71,51,395,123,9130
15000US060376039005,187,87,34,51,0,12,34,51,153,78,51,47,102,81,9131
15000US060376039006,928,162,86,85,20,34,66,75,842,166,122,87,720,163,9132
15000US060376040011,624,100,21,19,5,9,16,17,603,101,114,52,489,94,9133
15000US060376040012,411,75,86,61,31,38,55,51,325,67,79,38,246,62,9134
15000US060376040013,249,63,6,10,0,12,6,10,243,64,35,29,208,67,9135
15000US060376040021,328,79,45,41,18,20,27,35,283,82,63,42,220,75,9136
15000US060376040022,692,90,9,13,0,12,9,13,683,90,130,64,553,103,9137
15000US060376040023,327,78,0,12,0,12,0,12,327,78,0,12,327,78,9138
15000US060376040024,161,52,0,12,0,12,0,12,161,52,81,47,80,39,9139
15000US060376041001,419,109,23,25,10,16,13,19,396,112,71,60,325,123,9140
15000US060376041002,310,109,35,61,0,12,35,61,275,110,71,59,204,112,9141
15000US060376041003,225,99,42,67,42,67,0,12,183,82,58,44,125,74,9142
15000US060376041004,607,121,51,41,12,19,39,36,556,128,81,64,475,124,9143
15000US060376041005,487,131,112,109,82,94,30,52,375,118,129,82,246,107,9144
15000US060376099001,423,48,19,18,14,15,5,10,404,48,152,54,252,58,9145
15000US060376099002,189,37,0,12,0,12,0,12,189,37,66,25,123,39,9146
15000US060376200011,420,72,0,12,0,12,0,12,420,72,72,42,348,78,9147
15000US060376200012,436,98,21,31,0,12,21,31,415,96,73,58,342,76,9148
15000US060376200013,589,89,45,39,8,12,37,36,544,102,111,58,433,100,9149
15000US060376200021,516,87,8,12,0,12,8,12,508,86,18,17,490,88,9150
15000US060376200022,505,84,21,33,0,12,21,33,484,86,30,21,454,85,9151
15000US060376200023,464,80,8,13,0,12,8,13,456,80,93,48,363,78,9152
15000US060376201011,613,123,45,72,0,12,45,72,568,123,37,35,531,125,9153
15000US060376201012,685,125,0,12,0,12,0,12,685,125,58,47,627,139,9154
15000US060376201013,864,115,54,46,0,12,54,46,810,121,113,81,697,126,9155
15000US060376201021,414,65,7,12,7,12,0,12,407,66,42,29,365,66,9156
15000US060376201022,412,76,0,12,0,12,0,12,412,76,63,42,349,73,9157
15000US060376201023,755,87,0,12,0,12,0,12,755,87,113,58,642,98,9158
15000US060376202011,378,70,0,12,0,12,0,12,378,70,21,19,357,70,9159
15000US060376202012,489,81,0,12,0,12,0,12,489,81,19,17,470,82,9160
15000US060376203011,506,82,10,17,0,12,10,17,496,79,108,59,388,80,9161
15000US060376203012,410,70,0,12,0,12,0,12,410,70,70,51,340,76,9162
15000US060376203013,426,68,0,12,0,12,0,12,426,68,44,44,382,63,9163
15000US060376203014,373,67,0,12,0,12,0,12,373,67,19,21,354,66,9164
15000US060376203031,503,74,0,12,0,12,0,12,503,74,45,31,458,80,9165
15000US060376203032,337,80,24,30,0,12,24,30,313,75,42,42,271,68,9166
15000US060376203033,388,73,0,12,0,12,0,12,388,73,67,39,321,79,9167
15000US060376203034,301,62,0,12,0,12,0,12,301,62,40,26,261,66,9168
15000US060376203051,237,96,0,12,0,12,0,12,237,96,13,20,224,96,9169
15000US060376203052,583,124,0,12,0,12,0,12,583,124,27,33,556,121,9170
15000US060376203053,397,168,0,12,0,12,0,12,397,168,17,28,380,166,9171
15000US060376203054,268,86,0,12,0,12,0,12,268,86,0,12,268,86,9172
15000US060376203055,373,106,0,12,0,12,0,12,373,106,55,46,318,106,9173
15000US060376203056,280,115,0,12,0,12,0,12,280,115,72,82,208,81,9174
15000US060376203057,553,118,0,12,0,12,0,12,553,118,14,23,539,123,9175
15000US060376204001,668,104,0,12,0,12,0,12,668,104,97,64,571,117,9176
15000US060376204002,324,97,13,24,13,24,0,12,311,99,66,48,245,107,9177
15000US060376204003,507,144,0,12,0,12,0,12,507,144,35,47,472,144,9178
15000US060376204004,494,93,41,62,0,12,41,62,453,95,70,51,383,97,9179
15000US060376205011,379,78,0,12,0,12,0,12,379,78,39,40,340,85,9180
15000US060376205012,256,74,0,12,0,12,0,12,256,74,44,42,212,80,9181
15000US060376205013,432,103,0,12,0,12,0,12,432,103,105,76,327,103,9182
15000US060376205014,244,77,20,33,0,12,20,33,224,76,0,12,224,76,9183
15000US060376205015,215,98,0,12,0,12,0,12,215,98,31,36,184,104,9184
15000US060376205016,616,118,0,12,0,12,0,12,616,118,55,49,561,122,9185
15000US060376205211,437,86,42,35,22,26,20,22,395,79,46,39,349,76,9186
15000US060376205212,463,75,23,25,12,17,11,17,440,81,25,23,415,81,9187
15000US060376205213,300,74,0,12,0,12,0,12,300,74,53,41,247,80,9188
15000US060376205214,337,61,9,13,0,12,9,13,328,62,54,45,274,66,9189
15000US060376205221,510,78,53,47,46,46,7,12,457,82,40,31,417,83,9190
15000US060376205222,731,107,23,24,15,21,8,15,708,107,95,64,613,115,9191
15000US060376205223,615,89,0,12,0,12,0,12,615,89,89,56,526,85,9192
15000US060376206011,438,100,0,12,0,12,0,12,438,100,132,65,306,100,9193
15000US060376206012,617,127,12,19,0,12,12,19,605,130,67,55,538,126,9194
15000US060376206013,539,120,0,12,0,12,0,12,539,120,121,103,418,101,9195
15000US060376206014,704,123,16,22,16,22,0,12,688,122,127,67,561,118,9196
15000US060376206021,435,101,44,54,12,21,32,51,391,99,73,52,318,118,9197
15000US060376206022,292,91,0,12,0,12,0,12,292,91,16,26,276,91,9198
15000US060376206023,259,82,0,12,0,12,0,12,259,82,28,31,231,85,9199
15000US060376206024,530,122,0,12,0,12,0,12,530,122,100,76,430,96,9200
15000US060376206025,519,109,29,47,0,12,29,47,490,99,104,68,386,116,9201
15000US060376207011,1097,148,0,12,0,12,0,12,1097,148,122,86,975,146,9202
15000US060376207012,662,147,16,26,16,26,0,12,646,155,98,60,548,160,9203
15000US060376207013,433,96,0,12,0,12,0,12,433,96,83,58,350,110,9204
15000US060376207014,656,131,0,12,0,12,0,12,656,131,51,41,605,132,9205
15000US060376207021,269,73,0,12,0,12,0,12,269,73,63,45,206,81,9206
15000US060376207022,770,139,17,26,17,26,0,12,753,141,95,58,658,148,9207
15000US060376207023,488,134,0,12,0,12,0,12,488,134,129,92,359,148,9208
15000US060376207024,518,89,0,12,0,12,0,12,518,89,94,66,424,94,9209
15000US060376207025,398,91,0,12,0,12,0,12,398,91,91,58,307,86,9210
15000US060376208001,335,76,6,13,0,12,6,13,329,80,84,65,245,92,9211
15000US060376208002,334,60,0,12,0,12,0,12,334,60,73,54,261,68,9212
15000US060376208003,446,80,0,12,0,12,0,12,446,80,24,36,422,76,9213
15000US060376208004,345,83,7,16,0,12,7,16,338,86,36,36,302,91,9214
15000US060376208005,479,122,0,12,0,12,0,12,479,122,14,23,465,126,9215
15000US060376208006,410,86,0,12,0,12,0,12,410,86,79,49,331,91,9216
15000US060376208007,288,84,0,12,0,12,0,12,288,84,62,74,226,76,9217
15000US060376208008,275,74,0,12,0,12,0,12,275,74,15,24,260,75,9218
15000US060376209011,462,52,0,12,0,12,0,12,462,52,55,26,407,54,9219
15000US060376209012,250,45,0,12,0,12,0,12,250,45,46,22,204,49,9220
15000US060376209013,275,48,7,12,7,12,0,12,268,46,26,18,242,50,9221
15000US060376209041,255,64,0,12,0,12,0,12,255,64,34,36,221,67,9222
15000US060376209042,208,60,0,12,0,12,0,12,208,60,22,26,186,62,9223
15000US060376209043,223,49,0,12,0,12,0,12,223,49,16,18,207,48,9224
15000US060376209044,428,80,0,12,0,12,0,12,428,80,47,35,381,85,9225
15000US060376210011,1565,112,7,11,0,12,7,11,1558,112,255,59,1303,111,9226
15000US060376210012,477,83,0,12,0,12,0,12,477,83,35,27,442,87,9227
15000US060376210021,506,62,33,35,0,12,33,35,473,66,48,27,425,61,9228
15000US060376210041,421,114,33,49,0,12,33,49,388,113,106,74,282,112,9229
15000US060376210042,686,154,52,80,0,12,52,80,634,149,49,45,585,149,9230
15000US060376210043,260,74,0,12,0,12,0,12,260,74,32,37,228,74,9231
15000US060376210044,458,108,0,12,0,12,0,12,458,108,36,41,422,113,9232
15000US060376210045,357,104,0,12,0,12,0,12,357,104,31,34,326,107,9233
15000US060376211021,423,69,9,15,0,12,9,15,414,67,58,37,356,65,9234
15000US060376211022,759,96,0,12,0,12,0,12,759,96,97,44,662,104,9235
15000US060376211041,676,153,0,12,0,12,0,12,676,153,53,54,623,161,9236
15000US060376211042,318,117,12,19,0,12,12,19,306,116,63,49,243,109,9237
15000US060376211043,503,150,0,12,0,12,0,12,503,150,49,38,454,155,9238
15000US060376211044,1236,202,0,12,0,12,0,12,1236,202,81,50,1155,210,9239
15000US060376211045,552,123,0,12,0,12,0,12,552,123,101,57,451,132,9240
15000US060376212011,742,126,12,21,0,12,12,21,730,127,81,51,649,134,9241
15000US060376212012,887,119,0,12,0,12,0,12,887,119,105,63,782,129,9242
15000US060376212013,906,126,0,12,0,12,0,12,906,126,125,72,781,116,9243
15000US060376212041,1590,122,0,12,0,12,0,12,1590,122,209,77,1381,139,9244
15000US060376212042,300,91,0,12,0,12,0,12,300,91,48,32,252,88,9245
15000US060376213011,1159,162,10,17,0,12,10,17,1149,163,148,94,1001,184,9246
15000US060376213012,551,144,59,76,0,12,59,76,492,130,98,86,394,108,9247
15000US060376213013,495,140,26,39,26,39,0,12,469,143,47,36,422,135,9248
15000US060376213014,741,141,24,27,13,20,11,17,717,147,165,104,552,144,9249
15000US060376213241,1331,165,25,29,0,12,25,29,1306,166,56,46,1250,167,9250
15000US060376213242,541,120,0,12,0,12,0,12,541,120,67,51,474,119,9251
15000US060376213261,511,104,0,12,0,12,0,12,511,104,0,12,511,104,9252
15000US060376213262,427,80,27,24,0,12,27,24,400,84,22,20,378,83,9253
15000US060376213263,800,112,0,12,0,12,0,12,800,112,43,29,757,110,9254
15000US060376214001,576,79,18,20,7,11,11,17,558,85,67,34,491,84,9255
15000US060376214002,620,85,24,37,0,12,24,37,596,91,91,57,505,89,9256
15000US060376214003,202,67,13,17,0,12,13,17,189,71,12,17,177,73,9257
15000US060376214004,411,63,0,12,0,12,0,12,411,63,72,38,339,75,9258
15000US060376500011,591,158,0,12,0,12,0,12,591,158,152,84,439,153,9259
15000US060376500012,215,67,0,12,0,12,0,12,215,67,45,34,170,69,9260
15000US060376500013,721,119,33,40,0,12,33,40,688,118,225,89,463,104,9261
15000US060376500014,305,109,0,12,0,12,0,12,305,109,53,42,252,121,9262
15000US060376500015,333,92,15,24,15,24,0,12,318,92,29,34,289,92,9263
15000US060376500031,669,79,23,22,7,11,16,18,646,77,131,42,515,83,9264
15000US060376500032,488,71,44,44,0,12,44,44,444,76,95,58,349,83,9265
15000US060376500041,505,74,46,51,23,34,23,37,459,82,48,37,411,87,9266
15000US060376500042,400,72,76,55,6,9,70,54,324,81,66,40,258,88,9267
15000US060376500043,414,65,12,18,0,12,12,18,402,68,48,35,354,71,9268
15000US060376500044,181,38,0,12,0,12,0,12,181,38,13,13,168,40,9269
15000US060376501011,570,126,17,27,0,12,17,27,553,127,80,57,473,129,9270
15000US060376501012,319,76,16,27,0,12,16,27,303,79,44,36,259,77,9271
15000US060376501013,679,133,0,12,0,12,0,12,679,133,184,85,495,137,9272
15000US060376501014,428,101,0,12,0,12,0,12,428,101,128,82,300,82,9273
15000US060376501021,237,53,14,16,5,7,9,14,223,54,27,20,196,54,9274
15000US060376501022,523,74,0,12,0,12,0,12,523,74,178,67,345,70,9275
15000US060376502001,296,62,20,21,20,21,0,12,276,64,105,43,171,56,9276
15000US060376502002,331,65,22,18,0,12,22,18,309,65,82,60,227,58,9277
15000US060376502003,648,86,29,36,0,12,29,36,619,93,96,69,523,94,9278
15000US060376502004,694,102,10,16,0,12,10,16,684,102,199,74,485,113,9279
15000US060376503001,294,129,0,12,0,12,0,12,294,129,44,39,250,132,9280
15000US060376503002,541,129,21,34,21,34,0,12,520,129,193,96,327,127,9281
15000US060376503003,496,121,10,20,10,20,0,12,486,124,100,82,386,127,9282
15000US060376503004,485,118,0,12,0,12,0,12,485,118,45,38,440,120,9283
15000US060376503005,596,109,9,14,9,14,0,12,587,112,219,110,368,123,9284
15000US060376504011,333,48,0,12,0,12,0,12,333,48,82,41,251,57,9285
15000US060376504012,220,56,0,12,0,12,0,12,220,56,88,44,132,49,9286
15000US060376504013,354,69,17,20,17,20,0,12,337,72,64,37,273,78,9287
15000US060376504014,287,52,0,12,0,12,0,12,287,52,71,53,216,54,9288
15000US060376504015,265,49,0,12,0,12,0,12,265,49,53,25,212,52,9289
15000US060376505011,415,55,0,12,0,12,0,12,415,55,111,38,304,70,9290
15000US060376505012,327,58,0,12,0,12,0,12,327,58,46,29,281,61,9291
15000US060376505013,286,48,15,21,15,21,0,12,271,49,58,34,213,49,9292
15000US060376505021,349,69,0,12,0,12,0,12,349,69,46,29,303,69,9293
15000US060376505022,219,42,14,16,14,16,0,12,205,44,50,33,155,43,9294
15000US060376505023,977,77,10,15,0,12,10,15,967,79,121,47,846,82,9295
15000US060376506021,892,175,41,61,41,61,0,12,851,179,256,135,595,138,9296
15000US060376506022,924,173,46,72,46,72,0,12,878,181,118,60,760,179,9297
15000US060376506023,972,156,16,26,0,12,16,26,956,160,104,79,852,144,9298
15000US060376506031,921,103,11,17,0,12,11,17,910,104,192,71,718,111,9299
15000US060376506032,565,78,0,12,0,12,0,12,565,78,208,79,357,73,9300
15000US060376506041,1278,143,15,24,15,24,0,12,1263,143,184,107,1079,158,9301
15000US060376506042,1258,146,71,90,71,90,0,12,1187,156,113,87,1074,159,9302
15000US060376506051,1087,74,50,50,44,49,6,9,1037,92,186,66,851,101,9303
15000US060376507011,272,39,5,7,0,12,5,7,267,39,96,40,171,39,9304
15000US060376507012,667,45,11,11,6,9,5,7,656,48,140,40,516,53,9305
15000US060376507021,396,70,0,12,0,12,0,12,396,70,131,71,265,63,9306
15000US060376507022,180,41,0,12,0,12,0,12,180,41,22,21,158,48,9307
15000US060376507023,574,80,10,15,0,12,10,15,564,83,145,61,419,85,9308
15000US060376507024,243,47,0,12,0,12,0,12,243,47,16,18,227,53,9309
15000US060376507025,219,44,0,12,0,12,0,12,219,44,87,38,132,41,9310
15000US060376508001,917,133,26,21,13,21,13,22,891,137,240,101,651,132,9311
15000US060376508002,665,109,77,86,13,21,64,83,588,106,125,62,463,116,9312
15000US060376508003,1251,153,0,12,0,12,0,12,1251,153,107,81,1144,170,9313
15000US060376509011,857,159,33,50,0,12,33,50,824,151,18,26,806,154,9314
15000US060376509012,581,132,111,123,0,12,111,123,470,141,98,109,372,105,9315
15000US060376509013,433,100,0,12,0,12,0,12,433,100,42,39,391,108,9316
15000US060376509014,628,138,0,12,0,12,0,12,628,138,58,44,570,138,9317
15000US060376509021,667,164,20,32,0,12,20,32,647,170,116,89,531,166,9318
15000US060376509022,713,144,94,69,38,44,56,76,619,141,64,53,555,142,9319
15000US060376509023,1106,190,0,12,0,12,0,12,1106,190,203,114,903,201,9320
15000US060376510011,437,76,30,41,30,41,0,12,407,78,75,38,332,79,9321
15000US060376510012,384,85,23,25,23,25,0,12,361,90,105,69,256,64,9322
15000US060376510013,767,90,22,28,22,28,0,12,745,93,161,66,584,96,9323
15000US060376510014,312,59,0,12,0,12,0,12,312,59,16,19,296,61,9324
15000US060376510021,507,78,11,16,0,12,11,16,496,79,147,61,349,82,9325
15000US060376510022,447,61,8,13,0,12,8,13,439,62,121,57,318,70,9326
15000US060376510023,333,54,12,17,12,17,0,12,321,54,63,34,258,58,9327
15000US060376510024,445,72,7,11,0,12,7,11,438,74,54,36,384,78,9328
15000US060376511011,895,96,18,28,18,28,0,12,877,99,121,52,756,98,9329
15000US060376511012,947,86,0,12,0,12,0,12,947,86,258,97,689,85,9330
15000US060376511021,890,81,44,44,9,14,35,42,846,89,183,77,663,96,9331
15000US060376511022,816,92,10,15,10,15,0,12,806,93,200,56,606,98,9332
15000US060376512011,333,69,0,12,0,12,0,12,333,69,37,25,296,74,9333
15000US060376512012,380,65,0,12,0,12,0,12,380,65,104,40,276,60,9334
15000US060376512013,213,55,0,12,0,12,0,12,213,55,26,24,187,59,9335
15000US060376512014,351,60,0,12,0,12,0,12,351,60,46,30,305,67,9336
15000US060376512015,392,59,0,12,0,12,0,12,392,59,115,47,277,64,9337
15000US060376512211,1418,44,100,59,28,35,72,54,1318,72,325,93,993,117,9338
15000US060376512221,1182,151,0,12,0,12,0,12,1182,151,288,136,894,172,9339
15000US060376512222,1193,144,15,23,0,12,15,23,1178,146,186,80,992,162,9340
15000US060376513021,523,104,50,37,18,23,32,29,473,110,106,59,367,117,9341
15000US060376513022,600,95,0,12,0,12,0,12,600,95,144,64,456,114,9342
15000US060376513023,301,70,0,12,0,12,0,12,301,70,118,78,183,65,9343
15000US060376513024,204,53,0,12,0,12,0,12,204,53,26,30,178,56,9344
15000US060376513025,359,99,0,12,0,12,0,12,359,99,98,79,261,94,9345
15000US060376513026,363,62,0,12,0,12,0,12,363,62,61,46,302,68,9346
15000US060376513041,452,134,0,12,0,12,0,12,452,134,95,83,357,142,9347
15000US060376513042,392,96,0,12,0,12,0,12,392,96,29,31,363,99,9348
15000US060376513043,832,141,46,44,0,12,46,44,786,146,117,95,669,139,9349
15000US060376513044,361,76,30,48,0,12,30,48,331,70,33,39,298,75,9350
15000US060376513045,357,87,0,12,0,12,0,12,357,87,57,44,300,99,9351
15000US060376514011,583,78,8,13,8,13,0,12,575,77,243,83,332,71,9352
15000US060376514012,612,75,0,12,0,12,0,12,612,75,149,71,463,101,9353
15000US060376514021,454,87,0,12,0,12,0,12,454,87,106,73,348,97,9354
15000US060376514022,530,90,0,12,0,12,0,12,530,90,69,55,461,87,9355
15000US060376514023,779,99,0,12,0,12,0,12,779,99,126,62,653,120,9356
15000US060376514024,513,86,0,12,0,12,0,12,513,86,81,63,432,99,9357
15000US060376700011,644,92,59,49,32,35,27,41,585,91,79,44,506,91,9358
15000US060376700012,630,108,18,20,0,12,18,20,612,109,166,67,446,105,9359
15000US060376700021,529,92,6,11,6,11,0,12,523,90,149,68,374,101,9360
15000US060376700022,948,96,68,53,46,45,22,23,880,104,194,68,686,108,9361
15000US060376700031,211,83,0,12,0,12,0,12,211,83,23,25,188,87,9362
15000US060376700032,523,108,11,17,0,12,11,17,512,106,115,69,397,102,9363
15000US060376700033,466,82,34,40,11,17,23,36,432,87,91,59,341,83,9364
15000US060376700034,910,153,22,25,10,16,12,20,888,154,106,59,782,152,9365
15000US060376701001,1318,194,134,98,20,32,114,94,1184,196,170,90,1014,196,9366
15000US060376701002,468,128,13,20,0,12,13,20,455,133,43,48,412,133,9367
15000US060376701003,843,178,120,104,39,62,81,119,723,152,258,100,465,130,9368
15000US060376701004,263,121,0,12,0,12,0,12,263,121,99,87,164,83,9369
15000US060376702011,465,52,6,9,6,9,0,12,459,54,71,37,388,63,9370
15000US060376702012,1007,88,0,12,0,12,0,12,1007,88,188,71,819,100,9371
15000US060376702021,944,58,0,12,0,12,0,12,944,58,184,56,760,78,9372
15000US060376703241,431,77,0,12,0,12,0,12,431,77,142,69,289,85,9373
15000US060376703242,254,63,0,12,0,12,0,12,254,63,60,43,194,59,9374
15000US060376703243,456,80,0,12,0,12,0,12,456,80,129,71,327,80,9375
15000US060376703244,680,121,0,12,0,12,0,12,680,121,166,64,514,125,9376
15000US060376703261,521,65,0,12,0,12,0,12,521,65,108,47,413,71,9377
15000US060376703262,578,64,0,12,0,12,0,12,578,64,108,52,470,73,9378
15000US060376703263,232,42,0,12,0,12,0,12,232,42,20,21,212,45,9379
15000US060376703281,322,62,10,15,10,15,0,12,312,62,64,47,248,60,9380
15000US060376703282,410,59,0,12,0,12,0,12,410,59,53,38,357,67,9381
15000US060376703283,929,80,0,12,0,12,0,12,929,80,118,56,811,84,9382
15000US060376704031,967,52,6,8,6,8,0,12,961,53,140,35,821,51,9383
15000US060376704051,1190,57,0,12,0,12,0,12,1190,57,299,93,891,97,9384
15000US060376704061,701,55,0,12,0,12,0,12,701,55,157,45,544,69,9385
15000US060376704071,1272,128,85,87,85,87,0,12,1187,128,62,52,1125,141,9386
15000US060376704072,462,89,16,26,0,12,16,26,446,94,50,46,396,94,9387
15000US060376704073,526,84,0,12,0,12,0,12,526,84,93,52,433,84,9388
15000US060376704111,842,83,0,12,0,12,0,12,842,83,200,59,642,93,9389
15000US060376704112,734,75,0,12,0,12,0,12,734,75,129,48,605,85,9390
15000US060376704131,802,78,10,15,10,15,0,12,792,78,138,47,654,83,9391
15000US060376704132,1033,96,33,48,33,48,0,12,1000,104,233,76,767,123,9392
15000US060376704161,567,75,21,27,0,12,21,27,546,79,136,54,410,79,9393
15000US060376704162,973,102,31,27,14,21,17,16,942,100,225,68,717,106,9394
15000US060376705001,637,40,3,4,3,4,0,12,634,40,153,34,481,44,9395
15000US060376706021,1031,123,21,30,0,12,21,30,1010,130,259,104,751,165,9396
15000US060376706022,914,133,0,12,0,12,0,12,914,133,282,148,632,141,9397
15000US060376706023,857,96,0,12,0,12,0,12,857,96,197,86,660,116,9398
15000US060376707011,921,134,81,82,0,12,81,82,840,136,106,89,734,142,9399
15000US060376707012,878,115,0,12,0,12,0,12,878,115,134,72,744,135,9400
15000US060376707013,388,89,0,12,0,12,0,12,388,89,121,65,267,82,9401
15000US060376707014,380,99,0,12,0,12,0,12,380,99,203,112,177,88,9402
15000US060376707021,652,131,0,12,0,12,0,12,652,131,170,91,482,129,9403
15000US060376707022,278,67,0,12,0,12,0,12,278,67,44,41,234,67,9404
15000US060376707023,523,106,0,12,0,12,0,12,523,106,91,71,432,111,9405
15000US060376707024,584,118,39,54,39,54,0,12,545,125,68,58,477,135,9406
15000US060377001011,332,117,15,24,15,24,0,12,317,118,34,38,283,116,9407
15000US060377001012,715,176,16,26,0,12,16,26,699,178,205,124,494,147,9408
15000US060377001013,516,145,0,12,0,12,0,12,516,145,156,108,360,108,9409
15000US060377001014,930,176,16,25,0,12,16,25,914,175,398,150,516,147,9410
15000US060377001015,519,110,15,21,0,12,15,21,504,111,129,100,375,130,9411
15000US060377001021,698,183,55,62,0,12,55,62,643,179,135,69,508,186,9412
15000US060377001022,805,152,56,65,15,24,41,61,749,164,123,95,626,169,9413
15000US060377001023,921,165,85,69,27,42,58,56,836,169,223,115,613,151,9414
15000US060377002001,1916,269,90,60,0,12,90,60,1826,264,187,128,1639,257,9415
15000US060377002002,303,156,0,12,0,12,0,12,303,156,93,92,210,131,9416
15000US060377002003,283,179,0,12,0,12,0,12,283,179,20,30,263,178,9417
15000US060377002004,398,155,76,121,0,12,76,121,322,107,44,51,278,100,9418
15000US060377002005,1468,243,46,54,26,43,20,32,1422,238,185,125,1237,240,9419
15000US060377003001,1157,182,0,12,0,12,0,12,1157,182,114,85,1043,190,9420
15000US060377003002,718,178,0,12,0,12,0,12,718,178,80,49,638,173,9421
15000US060377003003,708,144,0,12,0,12,0,12,708,144,103,53,605,141,9422
15000US060377003004,1315,178,13,21,0,12,13,21,1302,178,265,107,1037,201,9423
15000US060377004001,1054,180,13,20,13,20,0,12,1041,180,112,61,929,195,9424
15000US060377004002,391,106,0,12,0,12,0,12,391,106,0,12,391,106,9425
15000US060377004003,1143,177,48,48,0,12,48,48,1095,173,136,91,959,165,9426
15000US060377004004,621,160,0,12,0,12,0,12,621,160,60,56,561,154,9427
15000US060377005011,856,206,0,12,0,12,0,12,856,206,74,50,782,202,9428
15000US060377005012,646,136,0,12,0,12,0,12,646,136,53,53,593,137,9429
15000US060377005013,914,203,38,64,38,64,0,12,876,209,193,107,683,207,9430
15000US060377005021,2220,207,30,33,15,24,15,23,2190,210,152,85,2038,219,9431
15000US060377005022,685,164,0,12,0,12,0,12,685,164,89,80,596,152,9432
15000US060377006001,364,76,9,14,9,14,0,12,355,77,52,32,303,76,9433
15000US060377006002,388,86,0,12,0,12,0,12,388,86,113,67,275,75,9434
15000US060377006003,196,72,0,12,0,12,0,12,196,72,98,61,98,59,9435
15000US060377006004,503,104,0,12,0,12,0,12,503,104,164,90,339,100,9436
15000US060377006005,168,69,0,12,0,12,0,12,168,69,8,14,160,68,9437
15000US060377007001,286,86,0,12,0,12,0,12,286,86,79,49,207,74,9438
15000US060377007002,193,66,0,12,0,12,0,12,193,66,20,23,173,66,9439
15000US060377007003,545,93,0,12,0,12,0,12,545,93,58,52,487,95,9440
15000US060377008011,1772,226,0,12,0,12,0,12,1772,226,418,147,1354,239,9441
15000US060377008012,293,116,0,12,0,12,0,12,293,116,102,86,191,105,9442
15000US060377008013,557,142,0,12,0,12,0,12,557,142,271,109,286,119,9443
15000US060377008021,519,94,12,20,12,20,0,12,507,92,133,69,374,84,9444
15000US060377008022,804,110,0,12,0,12,0,12,804,110,145,63,659,110,9445
15000US060377008023,595,90,26,26,10,16,16,20,569,89,47,42,522,95,9446
15000US060377009011,478,99,0,12,0,12,0,12,478,99,36,34,442,96,9447
15000US060377009012,243,68,6,11,6,11,0,12,237,67,94,62,143,50,9448
15000US060377009013,363,77,9,15,9,15,0,12,354,78,86,53,268,74,9449
15000US060377009014,408,67,0,12,0,12,0,12,408,67,54,36,354,71,9450
15000US060377009021,796,167,0,12,0,12,0,12,796,167,76,71,720,157,9451
15000US060377009022,627,116,0,12,0,12,0,12,627,116,109,64,518,114,9452
15000US060377009023,950,148,5,11,0,12,5,11,945,147,122,72,823,151,9453
15000US060377009024,862,154,9,15,0,12,9,15,853,154,129,72,724,166,9454
15000US060377010001,287,107,0,12,0,12,0,12,287,107,64,82,223,87,9455
15000US060377010002,682,127,0,12,0,12,0,12,682,127,38,38,644,131,9456
15000US060377010003,349,95,2,10,2,10,0,12,347,93,86,50,261,108,9457
15000US060377010004,988,169,0,12,0,12,0,12,988,169,172,97,816,156,9458
15000US060377010005,362,98,0,12,0,12,0,12,362,98,44,38,318,102,9459
15000US060377011001,49,24,14,18,0,12,14,18,35,22,0,12,35,22,9460
15000US060377012011,260,69,0,12,0,12,0,12,260,69,27,24,233,69,9461
15000US060377012012,326,65,0,12,0,12,0,12,326,65,92,54,234,56,9462
15000US060377012013,296,55,0,12,0,12,0,12,296,55,86,39,210,66,9463
15000US060377012014,317,52,0,12,0,12,0,12,317,52,91,43,226,57,9464
15000US060377012015,276,63,0,12,0,12,0,12,276,63,55,47,221,59,9465
15000US060377012021,946,100,28,25,9,14,19,21,918,102,50,34,868,99,9466
15000US060377012022,831,102,0,12,0,12,0,12,831,102,55,36,776,102,9467
15000US060377013021,1066,129,16,26,0,12,16,26,1050,133,28,24,1022,139,9468
15000US060377013022,1836,157,32,28,19,31,13,22,1804,160,139,78,1665,186,9469
15000US060377013041,603,98,0,12,0,12,0,12,603,98,86,60,517,103,9470
15000US060377013042,964,170,15,24,15,24,0,12,949,168,207,143,742,148,9471
15000US060377013043,1173,181,11,18,11,18,0,12,1162,184,155,101,1007,175,9472
15000US060377013044,343,101,0,12,0,12,0,12,343,101,83,55,260,97,9473
15000US060377014021,533,182,0,12,0,12,0,12,533,182,47,53,486,177,9474
15000US060377014022,1288,248,71,114,71,114,0,12,1217,267,223,98,994,251,9475
15000US060377014023,942,186,22,36,22,36,0,12,920,188,286,171,634,164,9476
15000US060377014024,1190,253,24,39,0,12,24,39,1166,253,233,132,933,260,9477
15000US060377015011,765,139,0,12,0,12,0,12,765,139,64,45,701,136,9478
15000US060377015012,677,130,0,12,0,12,0,12,677,130,115,84,562,139,9479
15000US060377015013,1227,157,0,12,0,12,0,12,1227,157,113,52,1114,161,9480
15000US060377015021,376,72,9,14,0,12,9,14,367,74,47,34,320,77,9481
15000US060377015022,732,101,37,46,29,44,8,14,695,93,72,43,623,103,9482
15000US060377015023,782,115,0,12,0,12,0,12,782,115,77,58,705,110,9483
15000US060377016011,216,59,0,12,0,12,0,12,216,59,58,43,158,51,9484
15000US060377016012,839,104,11,16,0,12,11,16,828,105,100,63,728,112,9485
15000US060377016013,323,67,10,15,0,12,10,15,313,67,36,31,277,67,9486
15000US060377016014,530,93,0,12,0,12,0,12,530,93,45,31,485,92,9487
15000US060377016021,721,95,11,17,0,12,11,17,710,98,41,31,669,97,9488
15000US060377016022,850,105,14,18,7,12,7,11,836,102,53,38,783,115,9489
15000US060377016023,428,86,0,12,0,12,0,12,428,86,35,27,393,91,9490
15000US060377017011,737,101,0,12,0,12,0,12,737,101,115,68,622,103,9491
15000US060377017012,708,89,24,23,7,12,17,20,684,93,79,59,605,103,9492
15000US060377017013,200,53,0,12,0,12,0,12,200,53,68,40,132,38,9493
15000US060377017021,419,103,0,12,0,12,0,12,419,103,100,70,319,86,9494
15000US060377017022,484,93,25,23,0,12,25,23,459,94,78,39,381,90,9495
15000US060377017023,850,134,8,14,0,12,8,14,842,134,31,30,811,138,9496
15000US060377018011,427,112,0,12,0,12,0,12,427,112,19,32,408,113,9497
15000US060377018012,330,91,0,12,0,12,0,12,330,91,41,46,289,99,9498
15000US060377018013,246,98,16,25,16,25,0,12,230,97,51,46,179,88,9499
15000US060377018014,678,152,65,76,38,55,27,46,613,144,63,57,550,135,9500
15000US060377018015,922,191,93,75,33,36,60,78,829,183,152,101,677,184,9501
15000US060377018021,606,83,88,48,8,13,80,48,518,82,100,50,418,86,9502
15000US060377018022,491,78,39,32,29,27,10,15,452,86,55,33,397,88,9503
15000US060377018023,465,77,22,31,0,12,22,31,443,77,70,46,373,73,9504
15000US060377018024,256,68,0,12,0,12,0,12,256,68,67,49,189,54,9505
15000US060377019021,1846,192,12,20,12,20,0,12,1834,193,291,114,1543,195,9506
15000US060377019022,431,104,0,12,0,12,0,12,431,104,107,86,324,120,9507
15000US060377019023,589,137,0,12,0,12,0,12,589,137,59,55,530,147,9508
15000US060377020021,1017,201,44,71,0,12,44,71,973,192,266,125,707,184,9509
15000US060377020022,692,152,46,42,17,27,29,33,646,165,109,85,537,146,9510
15000US060377020023,781,147,29,33,0,12,29,33,752,148,83,80,669,143,9511
15000US060377020024,963,178,0,12,0,12,0,12,963,178,91,99,872,162,9512
15000US060377021021,743,146,0,12,0,12,0,12,743,146,268,113,475,125,9513
15000US060377021022,420,109,0,12,0,12,0,12,420,109,55,66,365,97,9514
15000US060377021023,278,122,15,24,15,24,0,12,263,118,84,62,179,114,9515
15000US060377021024,627,163,0,12,0,12,0,12,627,163,112,100,515,158,9516
15000US060377021025,380,138,0,12,0,12,0,12,380,138,53,87,327,122,9517
15000US060377021026,312,117,0,12,0,12,0,12,312,117,35,41,277,114,9518
15000US060377021027,979,195,0,12,0,12,0,12,979,195,76,88,903,196,9519
15000US060377022011,455,115,14,22,0,12,14,22,441,116,78,55,363,129,9520
15000US060377022012,292,84,0,12,0,12,0,12,292,84,10,17,282,91,9521
15000US060377022013,412,77,16,26,0,12,16,26,396,81,81,43,315,86,9522
15000US060377022014,563,124,42,65,0,12,42,65,521,126,103,87,418,116,9523
15000US060377022015,397,89,14,22,14,22,0,12,383,92,94,75,289,82,9524
15000US060377022021,550,86,11,18,11,18,0,12,539,90,163,86,376,97,9525
15000US060377022022,242,49,23,26,0,12,23,26,219,48,10,15,209,47,9526
15000US060377022023,292,47,0,12,0,12,0,12,292,47,29,26,263,50,9527
15000US060377022024,294,54,8,14,0,12,8,14,286,56,32,25,254,61,9528
15000US060377022025,355,79,10,16,0,12,10,16,345,78,39,28,306,79,9529
15000US060377023001,603,136,0,12,0,12,0,12,603,136,137,112,466,127,9530
15000US060377023002,533,126,0,12,0,12,0,12,533,126,130,88,403,105,9531
15000US060377023003,532,121,0,12,0,12,0,12,532,121,59,46,473,118,9532
15000US060377023004,541,155,29,45,0,12,29,45,512,150,177,124,335,120,9533
15000US060377023005,859,151,32,51,32,51,0,12,827,155,74,54,753,166,9534
15000US060377024001,541,92,9,13,9,13,0,12,532,91,71,42,461,98,9535
15000US060377024002,350,83,0,12,0,12,0,12,350,83,78,52,272,85,9536
15000US060377024003,280,68,32,37,0,12,32,37,248,66,10,15,238,65,9537
15000US060377024004,465,93,4,9,4,9,0,12,461,93,33,26,428,91,9538
15000US060377024005,266,60,10,17,10,17,0,12,256,63,57,36,199,66,9539
15000US060377025011,506,109,10,19,0,12,10,19,496,114,26,30,470,118,9540
15000US060377025012,168,51,0,12,0,12,0,12,168,51,71,43,97,44,9541
15000US060377025013,429,99,0,12,0,12,0,12,429,99,42,40,387,103,9542
15000US060377025014,619,134,0,12,0,12,0,12,619,134,48,43,571,139,9543
15000US060377025015,207,55,0,12,0,12,0,12,207,55,32,34,175,57,9544
15000US060377025021,328,78,0,12,0,12,0,12,328,78,89,60,239,87,9545
15000US060377025022,763,136,0,12,0,12,0,12,763,136,179,125,584,132,9546
15000US060377025023,977,135,0,12,0,12,0,12,977,135,159,82,818,138,9547
15000US060377026001,217,73,0,12,0,12,0,12,217,73,99,66,118,67,9548
15000US060377026002,404,94,0,12,0,12,0,12,404,94,72,46,332,92,9549
15000US060377026003,345,92,9,14,0,12,9,14,336,93,95,48,241,89,9550
15000US060377026004,482,96,0,12,0,12,0,12,482,96,187,85,295,93,9551
15000US060377026005,201,67,0,12,0,12,0,12,201,67,46,33,155,66,9552
15000US060377026006,548,173,11,18,0,12,11,18,537,176,53,39,484,186,9553
15000US060377027001,363,53,0,12,0,12,0,12,363,53,68,39,295,63,9554
15000US060377027002,376,55,11,19,0,12,11,19,365,59,34,31,331,62,9555
15000US060377027003,243,46,0,12,0,12,0,12,243,46,72,44,171,49,9556
15000US060377027004,345,51,0,12,0,12,0,12,345,51,23,25,322,51,9557
15000US060377028011,904,167,40,39,12,22,28,31,864,164,91,55,773,169,9558
15000US060377028012,693,152,0,12,0,12,0,12,693,152,67,52,626,152,9559
15000US060377028013,603,118,0,12,0,12,0,12,603,118,216,91,387,108,9560
15000US060377028021,430,44,46,29,16,19,30,22,384,44,73,29,311,50,9561
15000US060377028022,471,45,0,12,0,12,0,12,471,45,96,30,375,50,9562
15000US060377028031,284,68,9,14,0,12,9,14,275,70,21,21,254,71,9563
15000US060377028032,386,78,17,18,8,13,9,13,369,80,107,58,262,75,9564
15000US060377028033,554,88,0,12,0,12,0,12,554,88,133,48,421,83,9565
15000US060377029011,1790,265,0,12,0,12,0,12,1790,265,205,155,1585,266,9566
15000US060377029012,1104,296,0,12,0,12,0,12,1104,296,153,134,951,276,9567
15000US060377029013,1907,298,18,28,18,28,0,12,1889,298,208,150,1681,279,9568
15000US060377029014,646,173,0,12,0,12,0,12,646,173,140,73,506,166,9569
15000US060377030011,1426,216,0,12,0,12,0,12,1426,216,128,83,1298,227,9570
15000US060377030012,941,169,18,32,0,12,18,32,923,169,170,103,753,174,9571
15000US060377030013,750,122,0,12,0,12,0,12,750,122,127,70,623,124,9572
15000US060377030021,704,153,18,28,0,12,18,28,686,151,220,93,466,154,9573
15000US060377030022,458,110,0,12,0,12,0,12,458,110,142,79,316,113,9574
15000US060377030023,978,144,75,76,0,12,75,76,903,155,234,95,669,158,9575
15000US060377030024,754,137,49,77,0,12,49,77,705,135,160,81,545,138,9576
15000US060377031001,235,93,0,12,0,12,0,12,235,93,36,37,199,83,9577
15000US060377031002,465,97,39,46,0,12,39,46,426,100,61,50,365,117,9578
15000US060377031003,573,138,20,31,20,31,0,12,553,143,55,43,498,144,9579
15000US060377031004,429,137,56,88,56,88,0,12,373,133,44,41,329,137,9580
15000US060377031005,315,93,0,12,0,12,0,12,315,93,48,47,267,100,9581
15000US060377031006,324,102,15,23,0,12,15,23,309,104,84,60,225,101,9582
15000US060377032001,472,104,23,37,23,37,0,12,449,106,98,53,351,105,9583
15000US060377032002,444,99,0,12,0,12,0,12,444,99,165,88,279,91,9584
15000US060377032003,313,84,86,68,55,52,31,52,227,76,58,52,169,83,9585
15000US060377032004,391,81,0,12,0,12,0,12,391,81,126,54,265,96,9586
15000US060377032005,315,85,0,12,0,12,0,12,315,85,45,32,270,89,9587
15000US060377032006,350,116,18,30,0,12,18,30,332,113,30,34,302,109,9588
15000US060378001011,866,83,10,16,0,12,10,16,856,84,154,71,702,93,9589
15000US060378001012,1142,90,17,19,17,19,0,12,1125,91,231,90,894,126,9590
15000US060378001021,879,175,12,18,0,12,12,18,867,176,136,84,731,165,9591
15000US060378001022,842,186,15,23,15,23,0,12,827,187,57,57,770,180,9592
15000US060378001023,760,143,0,12,0,12,0,12,760,143,147,89,613,125,9593
15000US060378002021,253,83,12,18,0,12,12,18,241,86,22,28,219,88,9594
15000US060378002022,1720,120,12,19,12,19,0,17,1708,121,129,54,1579,130,9595
15000US060378002031,553,76,13,16,13,16,0,12,540,74,116,35,424,61,9596
15000US060378002032,1411,90,42,49,11,18,31,48,1369,87,185,80,1184,116,9597
15000US060378002041,795,110,0,12,0,12,0,12,795,110,168,98,627,112,9598
15000US060378002042,1020,115,0,12,0,12,0,12,1020,115,227,127,793,157,9599
15000US060378003241,242,68,9,15,9,15,0,12,233,71,29,25,204,72,9600
15000US060378003242,895,129,0,12,0,12,0,12,895,129,168,103,727,144,9601
15000US060378003243,492,108,0,12,0,12,0,12,492,108,16,25,476,109,9602
15000US060378003244,705,107,14,24,14,24,0,12,691,111,149,79,542,121,9603
15000US060378003251,759,94,12,19,0,12,12,19,747,94,165,66,582,104,9604
15000US060378003252,809,89,0,12,0,12,0,12,809,89,185,62,624,96,9605
15000US060378003261,799,106,46,51,26,41,20,31,753,101,74,50,679,100,9606
15000US060378003262,479,101,0,12,0,12,0,12,479,101,97,53,382,94,9607
15000US060378003263,706,78,0,12,0,12,0,12,706,78,108,50,598,88,9608
15000US060378003271,1138,188,94,125,0,12,94,125,1044,170,191,92,853,164,9609
15000US060378003272,404,131,13,21,0,12,13,21,391,132,45,37,346,134,9610
15000US060378003273,557,150,42,52,0,12,42,52,515,150,75,51,440,151,9611
15000US060378003281,478,71,10,16,10,16,0,12,468,76,133,58,335,75,9612
15000US060378003282,564,79,7,12,0,12,7,12,557,79,57,36,500,85,9613
15000US060378003291,305,68,0,12,0,12,0,12,305,68,38,38,267,78,9614
15000US060378003292,1135,176,45,47,22,35,23,26,1090,173,149,90,941,166,9615
15000US060378003293,1041,160,11,18,0,12,11,18,1030,160,145,104,885,160,9616
15000US060378003301,381,38,5,8,0,12,5,8,376,40,61,37,315,45,9617
15000US060378003311,253,31,0,12,0,12,0,12,253,31,41,16,212,31,9618
15000US060378003321,382,98,0,12,0,12,0,12,382,98,75,41,307,98,9619
15000US060378003322,351,79,0,12,0,12,0,12,351,79,125,73,226,68,9620
15000US060378003323,172,58,0,12,0,12,0,12,172,58,22,27,150,62,9621
15000US060378003324,499,83,0,12,0,12,0,12,499,83,100,55,399,93,9622
15000US060378003325,413,90,0,12,0,12,0,12,413,90,67,50,346,90,9623
15000US060378003326,384,89,0,12,0,12,0,12,384,89,100,93,284,86,9624
15000US060378004061,451,66,0,12,0,12,0,12,451,66,64,27,387,66,9625
15000US060378004062,254,58,0,12,0,12,0,12,254,58,83,39,171,50,9626
15000US060378004063,239,60,20,32,0,12,20,32,219,54,50,37,169,46,9627
15000US060378004081,373,131,0,12,0,12,0,12,373,131,82,101,291,108,9628
15000US060378004082,1303,174,14,23,14,23,0,12,1289,177,142,76,1147,172,9629
15000US060378004083,721,130,0,12,0,12,0,12,721,130,93,59,628,141,9630
15000US060378004084,596,119,0,12,0,12,0,12,596,119,99,55,497,126,9631
15000US060378004101,642,65,0,12,0,12,0,12,642,65,71,40,571,63,9632
15000US060378005041,1130,134,27,26,9,14,18,21,1103,135,187,55,916,140,9633
15000US060378005061,532,84,17,24,0,12,17,24,515,84,90,53,425,94,9634
15000US060378005062,318,103,0,12,0,12,0,12,318,103,42,45,276,100,9635
15000US060378005063,538,92,0,12,0,12,0,12,538,92,72,46,466,102,9636
15000US060379001021,294,46,44,25,12,11,32,23,250,44,81,32,169,45,9637
15000US060379001031,492,115,61,35,32,30,29,24,431,117,83,45,348,110,9638
15000US060379001032,474,90,32,27,32,27,0,12,442,89,130,78,312,96,9639
15000US060379001033,735,135,39,35,28,31,11,16,696,136,130,61,566,138,9640
15000US060379001041,532,112,158,92,87,64,71,65,374,94,93,43,281,92,9641
15000US060379001042,499,113,68,59,33,42,35,40,431,112,211,86,220,91,9642
15000US060379001043,559,93,115,76,83,59,32,48,444,91,173,71,271,93,9643
15000US060379002011,391,50,37,32,9,10,28,31,354,59,67,32,287,64,9644
15000US060379003001,1083,106,89,46,57,38,32,28,994,107,187,66,807,104,9645
15000US060379005011,490,97,43,35,11,17,32,31,447,100,114,54,333,106,9646
15000US060379005012,570,114,93,57,39,38,54,38,477,116,111,47,366,108,9647
15000US060379005013,949,119,84,43,45,28,39,31,865,116,184,72,681,132,9648
15000US060379005041,550,113,46,38,0,12,46,38,504,115,43,25,461,116,9649
15000US060379005042,1349,123,43,33,28,25,15,22,1306,129,257,85,1049,131,9650
15000US060379005051,496,86,33,28,16,24,17,14,463,86,64,32,399,89,9651
15000US060379005052,755,91,106,50,23,21,83,49,649,95,181,61,468,93,9652
15000US060379005061,586,81,32,28,13,23,19,26,554,83,139,55,415,90,9653
15000US060379005062,730,100,79,57,11,17,68,55,651,108,74,46,577,114,9654
15000US060379005071,927,153,69,65,0,12,69,65,858,156,164,90,694,167,9655
15000US060379005072,535,167,156,96,33,31,123,90,379,191,0,12,379,191,9656
15000US060379005073,701,153,90,57,29,30,61,59,611,155,94,61,517,155,9657
15000US060379005081,955,46,80,36,56,29,24,20,875,51,139,43,736,64,9658
15000US060379006021,843,122,31,30,20,25,11,17,812,124,90,38,722,125,9659
15000US060379006022,744,111,93,58,41,37,52,44,651,107,145,58,506,116,9660
15000US060379006051,613,159,57,47,16,25,41,39,556,159,198,106,358,165,9661
15000US060379006052,764,151,135,77,91,66,44,45,629,160,37,40,592,158,9662
15000US060379006053,798,143,183,78,57,50,126,76,615,161,191,80,424,152,9663
15000US060379006061,820,112,85,52,63,44,22,25,735,122,86,43,649,132,9664
15000US060379006062,370,101,98,65,58,39,40,50,272,104,52,44,220,100,9665
15000US060379006071,711,101,155,61,54,30,101,54,556,96,128,54,428,90,9666
15000US060379006072,383,72,32,27,25,23,7,13,351,74,85,38,266,76,9667
15000US060379006081,655,84,124,58,93,54,31,23,531,88,55,30,476,99,9668
15000US060379006082,326,76,39,29,26,25,13,17,287,73,22,17,265,77,9669
15000US060379006091,946,112,134,56,34,26,100,48,812,128,96,59,716,120,9670
15000US060379006092,633,105,105,48,36,23,69,47,528,109,58,31,470,110,9671
15000US060379007011,473,109,118,67,72,54,46,40,355,101,139,68,216,90,9672
15000US060379007012,328,73,75,45,45,42,30,28,253,74,66,36,187,67,9673
15000US060379007013,478,89,8,12,0,12,8,12,470,90,87,44,383,94,9674
15000US060379007014,304,67,37,31,0,12,37,31,267,63,99,51,168,54,9675
15000US060379007031,679,96,43,50,5,9,38,49,636,99,52,31,584,107,9676
15000US060379007032,372,72,34,31,5,8,29,30,338,72,75,46,263,78,9677
15000US060379007033,713,110,97,58,42,37,55,42,616,112,144,53,472,107,9678
15000US060379007041,891,92,66,39,34,30,32,26,825,97,75,36,750,94,9679
15000US060379007042,430,90,28,27,9,14,19,23,402,88,45,28,357,87,9680
15000US060379007051,456,68,28,32,0,12,28,32,428,69,125,51,303,65,9681
15000US060379007052,1056,134,97,49,44,29,53,37,959,135,201,72,758,146,9682
15000US060379007053,215,86,30,24,15,17,15,17,185,82,17,20,168,82,9683
15000US060379008031,672,157,106,80,16,27,90,76,566,158,100,81,466,177,9684
15000US060379008032,677,164,33,41,2,13,31,38,644,160,167,113,477,146,9685
15000US060379008033,555,123,124,74,77,57,47,44,431,117,104,65,327,115,9686
15000US060379008034,618,175,16,28,0,12,16,28,602,177,45,55,557,183,9687
15000US060379008041,667,71,102,43,65,38,37,27,565,72,60,31,505,77,9688
15000US060379008042,353,56,40,23,20,14,20,18,313,57,55,26,258,56,9689
15000US060379008051,415,93,49,40,33,32,16,24,366,92,61,33,305,93,9690
15000US060379008052,556,125,87,92,11,15,76,91,469,109,120,65,349,111,9691
15000US060379008053,391,81,8,13,0,12,8,13,383,82,107,53,276,89,9692
15000US060379008061,766,136,59,54,0,12,59,54,707,146,129,67,578,157,9693
15000US060379008062,1214,144,79,50,60,43,19,22,1135,139,470,94,665,134,9694
15000US060379009001,850,96,12,15,0,12,12,15,838,92,177,66,661,96,9695
15000US060379009002,585,87,12,17,0,12,12,17,573,90,150,64,423,96,9696
15000US060379010031,0,17,0,17,0,17,0,17,0,17,0,17,0,17,9697
15000US060379010041,253,101,0,12,0,12,0,12,253,101,78,58,175,85,9698
15000US060379010042,724,120,10,16,0,12,10,16,714,120,124,84,590,133,9699
15000US060379010043,2728,188,143,100,0,19,143,100,2585,216,485,185,2100,277,9700
15000US060379010071,319,70,4,6,4,6,0,12,315,69,62,31,253,68,9701
15000US060379010072,354,63,10,11,0,12,10,11,344,61,49,27,295,63,9702
15000US060379010081,691,50,28,19,6,10,22,16,663,56,115,45,548,68,9703
15000US060379010082,243,44,23,18,17,15,6,9,220,46,15,13,205,48,9704
15000US060379010091,769,114,44,36,26,32,18,20,725,116,135,46,590,122,9705
15000US060379010092,407,95,43,30,36,30,7,12,364,97,66,52,298,102,9706
15000US060379010093,760,100,11,18,0,12,11,18,749,98,202,76,547,102,9707
15000US060379010101,421,82,33,27,11,17,22,20,388,83,76,41,312,91,9708
15000US060379010102,565,90,79,48,9,14,70,46,486,94,88,56,398,91,9709
15000US060379010103,561,96,139,78,48,40,91,66,422,101,64,33,358,102,9710
15000US060379010104,326,82,8,14,0,12,8,14,318,83,72,39,246,84,9711
15000US060379010111,701,106,74,42,8,13,66,41,627,105,145,57,482,114,9712
15000US060379010112,515,108,54,48,10,15,44,48,461,110,124,67,337,96,9713
15000US060379010113,667,118,9,15,0,12,9,15,658,118,75,46,583,118,9714
15000US060379011011,951,99,62,39,32,35,30,25,889,101,180,70,709,120,9715
15000US060379011012,752,110,47,47,47,47,0,12,705,104,157,45,548,99,9716
15000US060379011021,727,102,28,23,12,15,16,18,699,106,155,58,544,108,9717
15000US060379011022,525,100,16,24,0,12,16,24,509,97,137,58,372,100,9718
15000US060379011023,556,84,15,18,6,10,9,15,541,87,178,75,363,79,9719
15000US060379012051,1202,200,150,110,52,49,98,97,1052,171,131,74,921,170,9720
15000US060379012052,717,184,14,23,0,12,14,23,703,186,110,57,593,193,9721
15000US060379012053,1001,168,10,16,0,12,10,16,991,167,325,98,666,161,9722
15000US060379012054,766,150,26,29,26,29,0,12,740,148,68,49,672,148,9723
15000US060379012091,497,53,17,13,0,12,17,13,480,53,130,46,350,56,9724
15000US060379012101,642,39,3,6,0,12,3,6,639,39,187,62,452,69,9725
15000US060379012131,1275,71,28,21,5,11,23,20,1247,72,350,90,897,107,9726
15000US060379100011,356,109,138,74,19,21,119,75,218,85,20,23,198,84,9727
15000US060379100012,410,105,88,63,17,19,71,62,322,96,123,61,199,89,9728
15000US060379100013,688,113,102,62,36,31,66,55,586,116,151,65,435,104,9729
15000US060379100021,909,199,117,89,57,73,60,55,792,185,214,99,578,187,9730
15000US060379100022,633,143,114,89,72,59,42,67,519,130,264,96,255,104,9731
15000US060379100023,540,125,77,60,21,35,56,50,463,120,242,117,221,114,9732
15000US060379101011,421,46,136,51,37,26,99,46,285,52,69,37,216,48,9733
15000US060379102011,1026,79,23,25,17,23,6,13,1003,84,246,77,757,95,9734
15000US060379102012,325,88,129,72,91,55,38,36,196,72,75,48,121,58,9735
15000US060379102021,1152,76,83,62,21,24,62,57,1069,93,294,81,775,118,9736
15000US060379102022,494,86,9,16,9,16,0,12,485,86,109,49,376,87,9737
15000US060379102051,434,50,39,39,6,10,33,37,395,58,93,36,302,58,9738
15000US060379102061,973,47,75,37,31,24,44,30,898,55,98,37,800,61,9739
15000US060379102071,600,90,36,28,28,26,8,11,564,90,67,49,497,95,9740
15000US060379102072,517,113,61,59,53,59,8,13,456,108,83,40,373,115,9741
15000US060379102073,550,88,20,21,7,13,13,17,530,91,103,48,427,80,9742
15000US060379102081,793,107,18,21,0,12,18,21,775,105,221,77,554,100,9743
15000US060379102082,1031,140,128,63,28,28,100,58,903,134,270,78,633,118,9744
15000US060379102091,1295,87,60,40,24,22,36,35,1235,91,280,93,955,120,9745
15000US060379102101,2189,107,51,50,14,24,37,46,2138,112,444,161,1694,171,9746
15000US060379103011,835,89,14,17,0,12,14,17,821,87,156,58,665,97,9747
15000US060379103012,549,88,0,12,0,12,0,12,549,88,102,50,447,92,9748
15000US060379103021,424,107,0,12,0,12,0,12,424,107,44,42,380,111,9749
15000US060379103022,862,101,28,31,12,21,16,24,834,107,246,98,588,126,9750
15000US060379103023,666,106,66,82,48,79,18,25,600,123,176,71,424,131,9751
15000US060379104011,1462,158,17,27,17,27,0,12,1445,160,353,132,1092,169,9752
15000US060379104012,835,140,104,84,22,27,82,78,731,162,201,93,530,166,9753
15000US060379104021,521,58,208,59,68,32,140,57,313,60,88,40,225,64,9754
15000US060379104022,447,63,132,47,34,25,98,44,315,66,83,41,232,59,9755
15000US060379104031,593,52,276,58,37,27,239,58,317,65,34,24,283,63,9756
15000US060379104041,380,65,32,28,8,14,24,27,348,69,155,77,193,77,9757
15000US060379104042,713,97,145,73,8,13,137,70,568,114,110,51,458,113,9758
15000US060379105011,731,98,136,66,64,48,72,43,595,95,304,76,291,83,9759
15000US060379105012,669,106,334,92,111,61,223,89,335,97,143,67,192,79,9760
15000US060379105013,578,121,280,102,61,46,219,94,298,96,75,38,223,93,9761
15000US060379105021,555,106,101,64,88,64,13,17,454,105,169,59,285,100,9762
15000US060379105022,525,112,138,76,61,51,77,59,387,94,115,52,272,91,9763
15000US060379105041,360,78,54,50,16,18,38,49,306,80,172,77,134,58,9764
15000US060379105042,596,102,96,67,25,26,71,59,500,112,140,71,360,109,9765
15000US060379105043,291,96,109,63,0,12,109,63,182,80,70,65,112,70,9766
15000US060379105051,437,75,68,46,35,31,33,35,369,65,137,58,232,64,9767
15000US060379105052,374,60,50,42,8,9,42,41,324,65,123,56,201,47,9768
15000US060379106011,384,106,163,78,76,51,87,63,221,86,111,74,110,69,9769
15000US060379106012,545,113,103,63,9,17,94,60,442,104,91,56,351,114,9770
15000US060379106013,648,115,134,75,111,71,23,23,514,114,233,88,281,82,9771
15000US060379106021,1402,94,420,117,140,73,280,104,982,139,310,99,672,145,9772
15000US060379106031,459,90,63,40,21,24,42,32,396,88,108,44,288,91,9773
15000US060379106032,437,93,138,77,106,59,32,49,299,79,99,50,200,76,9774
15000US060379106033,458,87,56,36,22,22,34,33,402,89,140,72,262,93,9775
15000US060379106034,683,103,178,76,62,47,116,63,505,117,136,60,369,110,9776
15000US060379106051,821,84,163,59,7,12,156,58,658,82,116,60,542,89,9777
15000US060379106052,442,98,45,39,0,12,45,39,397,96,152,64,245,86,9778
15000US060379106061,535,56,81,44,27,22,54,38,454,57,152,47,302,58,9779
15000US060379106062,272,48,68,34,31,31,37,31,204,44,45,29,159,42,9780
15000US060379107051,1526,199,163,110,32,37,131,104,1363,206,295,115,1068,201,9781
15000US060379107052,1327,208,118,99,60,63,58,73,1209,206,341,157,868,217,9782
15000US060379107061,1475,81,216,70,83,49,133,61,1259,100,452,93,807,114,9783
15000US060379107071,1358,84,304,89,88,63,216,72,1054,118,342,80,712,133,9784
15000US060379107091,519,43,3,7,3,7,0,12,516,44,182,53,334,58,9785
15000US060379107111,1365,183,186,100,97,87,89,62,1179,181,390,130,789,195,9786
15000US060379107112,892,183,174,138,158,128,16,31,718,141,190,89,528,149,9787
15000US060379107121,639,49,98,49,43,34,55,42,541,69,181,54,360,76,9788
15000US060379107131,362,72,55,38,15,23,40,33,307,67,93,50,214,73,9789
15000US060379107132,985,95,192,75,33,27,159,69,793,107,189,67,604,107,9790
15000US060379107141,616,60,104,45,34,27,70,36,512,69,129,51,383,76,9791
15000US060379107142,259,53,24,24,12,13,12,19,235,52,43,24,192,51,9792
15000US060379107151,477,85,10,15,10,15,0,12,467,87,133,47,334,79,9793
15000US060379107152,578,113,110,63,29,28,81,58,468,103,131,58,337,98,9794
15000US060379107153,710,104,189,89,77,68,112,63,521,108,135,65,386,102,9795
15000US060379107161,730,109,48,34,27,29,21,25,682,105,126,50,556,108,9796
15000US060379107162,934,122,112,70,47,40,65,57,822,122,260,82,562,120,9797
15000US060379108041,1081,77,15,23,0,12,15,23,1066,83,155,63,911,98,9798
15000US060379108051,649,97,58,46,8,13,50,44,591,98,213,95,378,99,9799
15000US060379108052,940,103,24,19,0,12,24,19,916,104,258,103,658,111,9800
15000US060379108071,1092,93,59,39,48,38,11,14,1033,97,228,79,805,115,9801
15000US060379108072,896,86,39,29,5,10,34,28,857,86,195,77,662,110,9802
15000US060379108081,606,69,12,17,0,12,12,17,594,71,166,71,428,73,9803
15000US060379108082,530,68,22,24,0,12,22,24,508,73,129,55,379,65,9804
15000US060379108091,735,39,5,9,0,12,5,9,730,39,133,44,597,53,9805
15000US060379108101,831,19,9,10,0,12,9,10,822,20,156,53,666,53,9806
15000US060379108111,42,22,0,12,0,12,0,12,42,22,5,7,37,21,9807
15000US060379108121,166,36,0,12,0,12,0,12,166,36,37,27,129,38,9808
15000US060379108131,681,83,11,21,11,21,0,12,670,81,168,63,502,86,9809
15000US060379108132,594,71,8,14,8,14,0,12,586,71,108,48,478,79,9810
15000US060379110011,683,132,23,26,13,19,10,16,660,128,252,104,408,130,9811
15000US060379110012,276,97,0,12,0,12,0,12,276,97,122,68,154,88,9812
15000US060379110013,617,98,35,45,0,12,35,45,582,105,127,64,455,103,9813
15000US060379200111,84,31,0,12,0,12,0,12,84,31,30,16,54,29,9814
15000US060379200121,453,54,32,33,32,33,0,12,421,58,75,28,346,60,9815
15000US060379200131,475,76,17,19,17,19,0,12,458,77,237,83,221,67,9816
15000US060379200132,616,66,0,12,0,12,0,12,616,66,155,62,461,79,9817
15000US060379200133,535,77,0,12,0,12,0,12,535,77,115,49,420,86,9818
15000US060379200151,1001,84,19,22,19,22,0,12,982,83,187,68,795,98,9819
15000US060379200152,894,86,11,17,0,12,11,17,883,83,122,41,761,84,9820
15000US060379200161,415,58,21,23,0,12,21,23,394,58,97,54,297,58,9821
15000US060379200162,1063,71,0,12,0,12,0,12,1063,71,268,84,795,94,9822
15000US060379200171,429,62,12,17,12,17,0,12,417,63,136,53,281,64,9823
15000US060379200172,624,77,26,39,0,12,26,39,598,79,136,55,462,92,9824
15000US060379200173,376,57,1,9,1,9,0,12,375,57,109,53,266,55,9825
15000US060379200181,344,45,11,12,11,12,0,12,333,43,78,34,255,48,9826
15000US060379200182,247,40,13,13,7,10,6,8,234,41,3,5,231,42,9827
15000US060379200183,172,37,0,12,0,12,0,12,172,37,40,31,132,37,9828
15000US060379200201,577,102,17,28,17,28,0,12,560,105,160,90,400,107,9829
15000US060379200202,233,71,12,19,12,19,0,12,221,73,33,40,188,79,9830
15000US060379200203,1385,126,69,62,0,12,69,62,1316,120,312,109,1004,145,9831
15000US060379200231,761,30,54,29,8,10,46,28,707,38,169,59,538,67,9832
15000US060379200261,107,34,0,12,0,12,0,12,107,34,30,17,77,29,9833
15000US060379200281,1980,47,91,50,54,32,37,36,1889,76,276,96,1613,122,9834
15000US060379200291,445,71,28,24,10,14,18,20,417,72,111,48,306,81,9835
15000US060379200292,450,80,8,13,8,13,0,12,442,82,107,42,335,85,9836
15000US060379200293,226,62,0,12,0,12,0,12,226,62,33,30,193,66,9837
15000US060379200301,1221,97,77,43,31,25,46,37,1144,107,291,110,853,126,9838
15000US060379200302,646,83,50,34,18,26,32,29,596,79,73,33,523,83,9839
15000US060379200311,318,81,0,12,0,12,0,12,318,81,171,81,147,59,9840
15000US060379200312,1119,126,0,12,0,12,0,12,1119,126,478,145,641,136,9841
15000US060379200313,616,105,30,34,30,34,0,12,586,107,280,105,306,99,9842
15000US060379200314,644,128,0,12,0,12,0,12,644,128,94,56,550,129,9843
15000US060379200321,880,71,27,21,15,16,12,14,853,74,134,46,719,90,9844
15000US060379200331,197,51,16,10,8,6,8,9,181,53,79,43,102,40,9845
15000US060379200341,750,65,26,27,8,13,18,23,724,70,126,45,598,73,9846
15000US060379200342,394,78,12,19,12,19,0,12,382,79,74,48,308,80,9847
15000US060379200351,853,136,98,61,20,31,78,63,755,143,307,148,448,149,9848
15000US060379200352,261,81,0,12,0,12,0,12,261,81,35,41,226,86,9849
15000US060379200353,243,95,29,33,0,12,29,33,214,95,66,60,148,84,9850
15000US060379200354,315,100,0,12,0,12,0,12,315,100,60,55,255,117,9851
15000US060379200355,586,119,37,43,37,43,0,12,549,127,199,119,350,113,9852
15000US060379200361,299,64,41,35,11,10,30,33,258,55,59,42,199,47,9853
15000US060379200362,204,73,35,36,0,12,35,36,169,66,25,21,144,65,9854
15000US060379200363,236,50,6,8,6,8,0,12,230,53,56,31,174,52,9855
15000US060379200364,238,64,32,28,32,28,0,12,206,62,32,18,174,65,9856
15000US060379200371,897,155,120,99,86,91,34,38,777,164,182,97,595,177,9857
15000US060379200372,821,173,193,132,39,63,154,117,628,172,191,99,437,160,9858
15000US060379200373,639,179,82,65,45,55,37,32,557,173,181,123,376,157,9859
15000US060379200381,1161,116,168,81,89,54,79,58,993,150,330,102,663,121,9860
15000US060379200382,500,103,116,90,0,12,116,90,384,102,112,73,272,85,9861
15000US060379200391,586,16,6,9,0,12,6,9,580,19,120,43,460,43,9862
15000US060379200401,1018,48,83,57,0,12,83,57,935,69,285,85,650,110,9863
15000US060379200411,874,55,38,28,15,23,23,17,836,59,158,44,678,72,9864
15000US060379200421,500,133,0,12,0,12,0,12,500,133,58,45,442,129,9865
15000US060379200422,1491,199,27,33,11,18,16,27,1464,201,240,109,1224,208,9866
15000US060379200423,231,98,11,19,11,19,0,12,220,101,42,53,178,90,9867
15000US060379200424,363,103,0,12,0,12,0,12,363,103,45,41,318,103,9868
15000US060379200431,1886,68,12,18,0,17,12,18,1874,69,398,108,1476,122,9869
15000US060379200441,666,47,0,12,0,12,0,12,666,47,96,40,570,59,9870
15000US060379200442,251,48,4,6,4,6,0,12,247,48,63,40,184,51,9871
15000US060379200451,330,62,8,14,0,12,8,14,322,61,51,42,271,63,9872
15000US060379200452,842,72,37,40,9,14,28,36,805,78,143,54,662,84,9873
15000US060379200453,289,67,18,19,0,12,18,19,271,69,52,56,219,62,9874
15000US060379201021,683,103,93,66,50,49,43,42,590,99,112,76,478,88,9875
15000US060379201022,172,81,0,12,0,12,0,12,172,81,17,19,155,79,9876
15000US060379201023,1069,108,108,70,71,55,37,43,961,111,279,92,682,106,9877
15000US060379201041,880,36,24,19,18,17,6,9,856,39,212,52,644,58,9878
15000US060379201061,898,45,99,45,46,35,53,31,799,52,146,54,653,78,9879
15000US060379201071,1273,69,32,33,0,12,32,33,1241,76,149,56,1092,87,9880
15000US060379201081,1600,60,29,30,19,21,10,16,1571,69,166,72,1405,101,9881
15000US060379201091,1977,91,34,42,9,14,25,38,1943,96,305,74,1638,119,9882
15000US060379201101,1133,66,6,10,0,12,6,10,1127,65,77,46,1050,74,9883
15000US060379201111,529,69,38,52,38,52,0,12,491,79,81,40,410,88,9884
15000US060379201112,450,70,7,11,0,12,7,11,443,70,76,42,367,70,9885
15000US060379201121,451,77,29,21,25,19,4,7,422,79,120,48,302,77,9886
15000US060379201122,570,84,10,11,4,7,6,9,560,85,73,47,487,81,9887
15000US060379201123,467,59,8,12,0,12,8,12,459,61,51,29,408,66,9888
15000US060379201141,2369,113,55,70,0,17,55,70,2314,124,220,101,2094,145,9889
15000US060379201151,388,60,4,7,4,7,0,12,384,61,9,14,375,59,9890
15000US060379201152,1116,93,23,22,0,12,23,22,1093,95,164,58,929,107,9891
15000US060379201161,194,64,0,12,0,12,0,12,194,64,74,52,120,57,9892
15000US060379201162,1443,86,15,20,15,20,0,12,1428,87,315,119,1113,132,9893
15000US060379201181,573,86,0,12,0,12,0,12,573,86,49,29,524,90,9894
15000US060379201182,1223,88,19,30,19,30,0,12,1204,93,120,57,1084,106,9895
15000US060379201191,535,15,5,8,5,8,0,12,530,15,60,29,470,33,9896
15000US060379202001,0,17,0,17,0,17,0,17,0,17,0,17,0,17,9897
15000US060379203031,584,51,3,5,0,12,3,5,581,51,127,52,454,64,9898
15000US060379203121,281,71,25,27,15,22,10,15,256,65,67,39,189,54,9899
15000US060379203122,933,109,56,60,9,14,47,58,877,110,209,75,668,120,9900
15000US060379203123,793,104,95,74,65,60,30,31,698,128,183,84,515,110,9901
15000US060379203131,615,105,22,25,0,12,22,25,593,103,111,58,482,105,9902
15000US060379203132,246,69,43,37,0,12,43,37,203,64,58,36,145,56,9903
15000US060379203133,304,76,0,12,0,12,0,12,304,76,88,52,216,87,9904
15000US060379203134,672,85,0,12,0,12,0,12,672,85,223,86,449,83,9905
15000US060379203141,679,44,4,7,0,12,4,7,675,45,119,31,556,48,9906
15000US060379203142,276,39,0,12,0,12,0,12,276,39,39,18,237,44,9907
15000US060379203221,351,59,0,12,0,12,0,12,351,59,93,42,258,71,9908
15000US060379203222,484,61,0,12,0,12,0,12,484,61,124,46,360,68,9909
15000US060379203223,229,60,11,18,0,12,11,18,218,59,78,42,140,59,9910
15000US060379203261,1345,185,25,29,0,12,25,29,1320,185,320,123,1000,166,9911
15000US060379203262,1269,193,14,24,0,12,14,24,1255,191,122,87,1133,196,9912
15000US060379203281,867,51,6,8,0,12,6,8,861,50,118,39,743,57,9913
15000US060379203291,693,131,0,12,0,12,0,12,693,131,213,116,480,145,9914
15000US060379203292,865,159,12,19,12,19,0,12,853,161,188,78,665,175,9915
15000US060379203293,601,100,0,12,0,12,0,12,601,100,92,59,509,116,9916
15000US060379203301,802,129,32,48,0,12,32,48,770,129,80,64,690,149,9917
15000US060379203302,339,77,0,12,0,12,0,12,339,77,81,50,258,90,9918
15000US060379203303,531,129,0,12,0,12,0,12,531,129,72,53,459,136,9919
15000US060379203304,729,119,0,12,0,12,0,12,729,119,280,130,449,120,9920
15000US060379203311,603,87,0,12,0,12,0,12,603,87,67,38,536,85,9921
15000US060379203312,490,79,27,25,19,21,8,12,463,79,97,52,366,81,9922
15000US060379203313,378,81,12,20,12,20,0,12,366,81,142,70,224,72,9923
15000US060379203321,368,35,24,25,20,25,4,6,344,40,91,38,253,43,9924
15000US060379203322,286,32,0,12,0,12,0,12,286,32,85,31,201,42,9925
15000US060379203341,374,93,0,12,0,12,0,12,374,93,179,79,195,80,9926
15000US060379203342,330,60,0,12,0,12,0,12,330,60,88,53,242,68,9927
15000US060379203343,1032,120,102,87,33,54,69,71,930,150,214,130,716,164,9928
15000US060379203344,559,85,19,30,0,12,19,30,540,87,82,49,458,90,9929
15000US060379203361,318,67,51,38,18,22,33,31,267,77,42,33,225,75,9930
15000US060379203362,376,78,87,64,38,44,49,48,289,73,83,45,206,69,9931
15000US060379203363,548,92,108,69,48,45,60,54,440,100,80,68,360,97,9932
15000US060379203364,451,86,23,36,0,12,23,36,428,89,50,52,378,90,9933
15000US060379203371,592,106,127,75,43,44,84,60,465,115,18,20,447,116,9934
15000US060379203372,446,98,48,49,29,44,19,22,398,103,91,60,307,95,9935
15000US060379203373,543,97,46,35,28,33,18,20,497,92,100,49,397,91,9936
15000US060379203374,397,104,101,71,29,35,72,60,296,108,45,52,251,108,9937
15000US060379203381,1770,19,69,41,37,32,32,29,1701,41,199,88,1502,94,9938
15000US060379203391,2316,96,33,44,0,17,33,44,2283,103,426,156,1857,179,9939
15000US060379301011,41,23,0,12,0,12,0,12,41,23,4,6,37,23,9940
15000US060379302001,87,31,16,19,0,12,16,19,71,27,4,6,67,27,9941
15000US060379302002,87,32,0,12,0,12,0,12,87,32,9,9,78,32,9942
15000US060379303011,96,24,0,12,0,12,0,12,96,24,0,12,96,24,9943
15000US060379303012,110,35,0,12,0,12,0,12,110,35,27,22,83,35,9944
15000US060379800011,0,12,0,12,0,12,0,12,0,12,0,12,0,12,9945
15000US060379800021,0,12,0,12,0,12,0,12,0,12,0,12,0,12,9946
15000US060379800031,0,12,0,12,0,12,0,12,0,12,0,12,0,12,9947
15000US060379800041,0,12,0,12,0,12,0,12,0,12,0,12,0,12,9948
15000US060379800051,0,12,0,12,0,12,0,12,0,12,0,12,0,12,9949
15000US060379800061,0,12,0,12,0,12,0,12,0,12,0,12,0,12,9950
15000US060379800071,0,12,0,12,0,12,0,12,0,12,0,12,0,12,9951
15000US060379800081,24,15,0,12,0,12,0,12,24,15,11,9,13,12,9952
15000US060379800091,0,12,0,12,0,12,0,12,0,12,0,12,0,12,9953
15000US060379800101,60,26,4,6,4,6,0,12,56,26,28,22,28,15,9954
15000US060379800131,0,12,0,12,0,12,0,12,0,12,0,12,0,12,9955
15000US060379800141,0,12,0,12,0,12,0,12,0,12,0,12,0,12,9956
15000US060379800151,172,45,34,31,5,8,29,30,138,57,26,31,112,61,9957
15000US060379800181,0,12,0,12,0,12,0,12,0,12,0,12,0,12,9958
15000US060379800191,76,25,0,12,0,12,0,12,76,25,5,8,71,23,9959
15000US060379800201,0,12,0,12,0,12,0,12,0,12,0,12,0,12,9960
15000US060379800211,0,12,0,12,0,12,0,12,0,12,0,12,0,12,9961
15000US060379800221,0,12,0,12,0,12,0,12,0,12,0,12,0,12,9962
15000US060379800231,5,7,0,12,0,12,0,12,5,7,5,7,0,12,9963
15000US060379800241,73,28,4,6,4,6,0,12,69,30,6,8,63,29,9964
15000US060379800251,0,12,0,12,0,12,0,12,0,12,0,12,0,12,9965
15000US060379800261,8,6,0,12,0,12,0,12,8,6,4,6,4,6,9966
15000US060379800281,0,12,0,12,0,12,0,12,0,12,0,12,0,12,9967
15000US060379800301,0,12,0,12,0,12,0,12,0,12,0,12,0,12,9968
15000US060379800311,27,22,0,12,0,12,0,12,27,22,0,12,27,22,9969
15000US060379800331,0,12,0,12,0,12,0,12,0,12,0,12,0,12,9970
15000US060379901000,0,12,0,12,0,12,0,12,0,12,0,12,0,12,9971
15000US060379902000,0,12,0,12,0,12,0,12,0,12,0,12,0,12,9972
15000US060379903000,0,12,0,12,0,12,0,12,0,12,0,12,0,12,9973
15000US060390001021,310,98,0,12,0,12,0,12,310,98,124,87,186,65,9974
15000US060390001022,291,75,12,21,0,12,12,21,279,73,108,61,171,64,9975
15000US060390001023,801,137,93,53,33,25,60,45,708,133,203,77,505,119,9976
15000US060390001024,321,95,26,41,26,41,0,12,295,90,50,31,245,85,9977
15000US060390001031,466,164,81,128,0,12,81,128,385,112,113,72,272,119,9978
15000US060390001032,456,136,17,28,17,28,0,12,439,134,55,51,384,137,9979
15000US060390001033,527,155,7,19,0,12,7,19,520,157,119,78,401,154,9980
15000US060390001034,654,136,37,30,18,28,19,32,617,134,159,78,458,144,9981
15000US060390001041,323,84,26,29,13,21,13,20,297,86,125,76,172,63,9982
15000US060390001042,640,133,81,66,21,24,60,59,559,128,120,62,439,127,9983
15000US060390001043,257,84,12,19,0,12,12,19,245,84,62,38,183,76,9984
15000US060390001044,453,117,0,12,0,12,0,12,453,117,109,83,344,94,9985
15000US060390001061,977,132,99,77,99,77,0,12,878,129,236,78,642,128,9986
15000US060390001062,974,118,60,45,16,27,44,37,914,113,242,68,672,116,9987
15000US060390001081,977,173,96,78,17,20,79,82,881,174,278,102,603,168,9988
15000US060390001082,862,138,40,40,0,12,40,40,822,139,196,77,626,159,9989
15000US060390001083,859,160,22,26,14,22,8,13,837,166,231,113,606,164,9990
15000US060390001091,632,67,35,34,11,13,24,31,597,70,178,61,419,67,9991
15000US060390001092,257,50,3,5,0,12,3,5,254,49,84,35,170,45,9992
15000US060390002011,54,31,7,12,7,12,0,17,47,31,16,19,31,27,9993
15000US060390002012,405,56,75,39,44,31,31,28,330,65,79,51,251,90,9994
15000US060390002021,590,122,146,86,12,17,134,85,444,93,71,45,373,88,9995
15000US060390002022,218,53,18,23,0,12,18,23,200,48,72,31,128,45,9996
15000US060390002023,275,58,52,38,32,34,20,21,223,68,108,53,115,53,9997
15000US060390002024,710,108,9,16,9,16,0,12,701,108,148,59,553,92,9998
15000US060390003001,424,147,123,104,51,52,72,83,301,122,76,63,225,112,9999
15000US060390003002,270,116,15,25,15,25,0,12,255,118,96,56,159,113,10000
15000US060390003003,380,127,113,110,13,23,100,108,267,94,92,56,175,95,10001
15000US060390003004,276,92,134,96,55,71,79,73,142,75,38,38,104,79,10002
15000US060390003005,103,66,15,25,15,25,0,12,88,66,30,35,58,62,10003
15000US060390003006,1064,184,323,143,91,75,232,125,741,189,235,118,506,149,10004
15000US060390003007,177,77,51,50,11,19,40,47,126,68,38,46,88,66,10005
15000US060390004001,143,40,13,13,4,5,9,12,130,39,37,19,93,33,10006
15000US060390004002,242,41,20,20,9,10,11,17,222,43,59,20,163,44,10007
15000US060390005021,224,130,74,83,12,20,62,82,150,106,0,12,150,106,10008
15000US060390005022,727,164,114,97,65,78,49,59,613,159,84,64,529,162,10009
15000US060390005023,1223,198,202,99,60,52,142,88,1021,200,312,160,709,187,10010
15000US060390005024,687,150,247,126,41,33,206,122,440,140,112,66,328,133,10011
15000US060390005031,1559,242,152,96,90,63,62,65,1407,239,274,141,1133,236,10012
15000US060390005032,973,211,38,47,16,27,22,38,935,223,226,137,709,208,10013
15000US060390005033,333,141,15,23,0,12,15,23,318,145,69,73,249,133,10014
15000US060390005061,452,115,186,97,129,77,57,59,266,81,91,46,175,74,10015
15000US060390005062,629,108,93,79,60,65,33,45,536,115,129,57,407,110,10016
15000US060390005063,605,107,46,51,7,10,39,50,559,115,134,54,425,116,10017
15000US060390005071,315,138,23,28,12,19,11,21,292,136,82,71,210,117,10018
15000US060390005072,784,189,91,89,15,25,76,83,693,188,253,139,440,163,10019
15000US060390005073,780,206,468,207,144,113,324,184,312,108,197,98,115,74,10020
15000US060390005074,872,170,39,45,23,34,16,27,833,166,107,62,726,165,10021
15000US060390005081,506,86,68,49,23,27,45,42,438,86,145,54,293,74,10022
15000US060390005082,624,109,269,112,113,67,156,84,355,95,153,70,202,75,10023
15000US060390005083,603,92,53,43,24,29,29,33,550,90,154,58,396,79,10024
15000US060390005091,1022,96,96,59,43,47,53,34,926,100,205,58,721,117,10025
15000US060390005092,516,90,16,17,0,12,16,17,500,92,179,74,321,87,10026
15000US060390005093,362,84,22,24,22,24,0,12,340,84,109,65,231,74,10027
15000US060390006021,458,99,37,32,13,14,24,30,421,102,187,68,234,90,10028
15000US060390006022,437,106,113,79,11,19,102,75,324,100,72,39,252,91,10029
15000US060390006023,380,99,183,82,41,39,142,83,197,83,75,43,122,77,10030
15000US060390006031,906,108,276,93,126,73,150,65,630,135,200,88,430,129,10031
15000US060390006032,521,79,280,89,70,49,210,75,241,70,68,49,173,65,10032
15000US060390006041,746,115,398,112,143,70,255,109,348,86,98,54,250,76,10033
15000US060390006042,493,106,137,65,36,35,101,60,356,103,127,71,229,88,10034
15000US060390007001,222,76,40,45,0,12,40,45,182,73,106,87,76,46,10035
15000US060390007002,1496,231,87,89,21,27,66,83,1409,244,413,167,996,242,10036
15000US060390007003,1047,168,43,40,15,25,28,32,1004,170,366,133,638,152,10037
15000US060390007004,445,126,17,31,0,12,17,31,428,128,132,58,296,131,10038
15000US060390007005,389,113,92,101,53,81,39,60,297,129,107,75,190,113,10039
15000US060390007006,307,129,66,67,28,32,38,60,241,122,24,28,217,124,10040
15000US060390008001,207,82,82,59,17,27,65,51,125,60,60,55,65,44,10041
15000US060390008002,386,93,158,70,55,54,103,61,228,77,139,62,89,57,10042
15000US060390008003,229,86,108,65,44,44,64,45,121,64,21,24,100,60,10043
15000US060390008004,198,76,73,66,0,12,73,66,125,61,23,29,102,53,10044
15000US060390008005,350,88,74,58,0,12,74,58,276,78,108,47,168,78,10045
15000US060390008006,479,100,102,59,19,23,83,54,377,98,137,59,240,79,10046
15000US060390009001,794,158,337,155,89,88,248,129,457,146,161,88,296,126,10047
15000US060390009002,592,143,263,127,120,97,143,98,329,117,147,88,182,87,10048
15000US060390009003,731,156,255,108,20,24,235,106,476,170,126,83,350,151,10049
15000US060390010001,311,79,76,66,16,24,60,63,235,79,76,44,159,76,10050
15000US060390010002,713,104,33,39,0,12,33,39,680,102,170,61,510,100,10051
15000US060390010003,323,84,70,68,10,18,60,65,253,82,69,54,184,66,10052
15000US060390010004,250,72,64,59,36,48,28,34,186,72,46,25,140,70,10053
15000US060411011001,1064,67,8,13,8,13,0,12,1056,68,242,72,814,81,10054
15000US060411012001,1122,50,37,44,0,12,37,44,1085,68,226,66,859,94,10055
15000US060411021001,342,58,7,15,7,15,0,12,335,56,20,14,315,59,10056
15000US060411021002,643,54,7,10,0,12,7,10,636,56,128,37,508,59,10057
15000US060411022021,230,92,38,57,38,57,0,12,192,83,36,39,156,86,10058
15000US060411022022,343,60,15,24,0,12,15,24,328,61,31,35,297,66,10059
15000US060411022023,664,112,27,41,27,41,0,12,637,113,131,62,506,102,10060
15000US060411022024,333,90,0,12,0,12,0,12,333,90,84,51,249,94,10061
15000US060411022025,665,96,17,30,17,30,0,12,648,99,87,60,561,113,10062
15000US060411022031,851,104,92,85,9,14,83,84,759,135,163,84,596,129,10063
15000US060411022032,617,90,9,14,0,12,9,14,608,89,126,58,482,86,10064
15000US060411022033,720,95,26,24,17,19,9,14,694,98,154,67,540,108,10065
15000US060411031001,887,131,21,34,21,34,0,12,866,141,135,72,731,153,10066
15000US060411031002,717,97,0,12,0,12,0,12,717,97,118,67,599,105,10067
15000US060411031003,691,106,0,12,0,12,0,12,691,106,81,56,610,117,10068
15000US060411031004,586,111,18,30,0,12,18,30,568,114,12,19,556,115,10069
15000US060411032001,545,142,17,27,0,12,17,27,528,144,130,61,398,142,10070
15000US060411032002,1162,174,100,74,52,54,48,51,1062,175,209,94,853,169,10071
15000US060411032003,1067,155,13,20,0,12,13,20,1054,160,381,125,673,165,10072
15000US060411041011,722,131,68,75,39,60,29,47,654,117,157,73,497,129,10073
15000US060411041012,545,91,0,12,0,12,0,12,545,91,137,81,408,111,10074
15000US060411041013,847,133,0,12,0,12,0,12,847,133,157,90,690,131,10075
15000US060411041014,1032,171,66,52,24,29,42,47,966,183,172,78,794,179,10076
15000US060411041021,829,147,7,17,0,12,7,17,822,151,101,75,721,122,10077
15000US060411041022,1318,137,119,101,105,101,14,23,1199,164,231,117,968,174,10078
15000US060411042001,725,143,0,12,0,12,0,12,725,143,120,70,605,149,10079
15000US060411042002,896,138,32,38,0,12,32,38,864,139,107,71,757,148,10080
15000US060411042003,907,118,0,12,0,12,0,12,907,118,163,77,744,134,10081
15000US060411043001,684,46,10,9,6,9,4,6,674,47,97,40,577,55,10082
15000US060411050001,1190,150,94,86,16,26,78,83,1096,150,141,70,955,157,10083
15000US060411050002,1495,149,90,81,0,12,90,81,1405,156,154,75,1251,153,10084
15000US060411060011,205,72,10,18,0,12,10,18,195,75,29,34,166,75,10085
15000US060411060012,1087,159,0,12,0,12,0,12,1087,159,172,81,915,169,10086
15000US060411060013,826,109,13,23,13,23,0,12,813,112,293,101,520,110,10087
15000US060411060021,931,136,22,34,0,12,22,34,909,144,150,91,759,162,10088
15000US060411060022,739,153,0,12,0,12,0,12,739,153,235,118,504,142,10089
15000US060411060023,457,119,0,12,0,12,0,12,457,119,80,64,377,110,10090
15000US060411070001,579,85,23,35,23,35,0,12,556,89,74,54,482,102,10091
15000US060411070002,325,79,0,12,0,12,0,12,325,79,30,32,295,82,10092
15000US060411070003,333,65,0,12,0,12,0,12,333,65,70,51,263,75,10093
15000US060411070004,548,86,0,12,0,12,0,12,548,86,168,99,380,81,10094
15000US060411070005,608,92,64,54,50,48,14,23,544,98,131,74,413,105,10095
15000US060411081001,1174,122,15,25,15,25,0,12,1159,124,214,96,945,153,10096
15000US060411081002,348,77,24,28,24,28,0,12,324,76,47,42,277,75,10097
15000US060411081003,542,108,0,12,0,12,0,12,542,108,52,51,490,114,10098
15000US060411081004,675,105,12,18,12,18,0,12,663,103,79,57,584,104,10099
15000US060411082001,550,93,13,21,13,21,0,12,537,95,105,59,432,99,10100
15000US060411082002,1301,191,40,58,0,12,40,58,1261,186,511,168,750,170,10101
15000US060411082003,775,136,22,28,8,16,14,23,753,134,249,102,504,126,10102
15000US060411082004,252,78,0,12,0,12,0,12,252,78,53,41,199,84,10103
15000US060411090011,466,88,54,43,0,12,54,43,412,89,103,54,309,84,10104
15000US060411090012,482,96,35,39,0,12,35,39,447,100,75,47,372,102,10105
15000US060411090013,778,110,0,12,0,12,0,12,778,110,163,76,615,108,10106
15000US060411090021,615,81,0,12,0,12,0,12,615,81,117,61,498,80,10107
15000US060411090022,826,106,21,19,6,12,15,16,805,108,111,55,694,104,10108
15000US060411090023,362,84,5,8,0,12,5,8,357,84,29,25,328,85,10109
15000US060411101001,734,133,18,29,18,29,0,12,716,136,194,118,522,142,10110
15000US060411101002,741,127,60,88,60,88,0,12,681,119,163,91,518,105,10111
15000US060411101003,883,158,0,12,0,12,0,12,883,158,163,102,720,181,10112
15000US060411102001,1029,122,19,32,19,32,0,12,1010,120,258,95,752,130,10113
15000US060411102002,402,83,0,12,0,12,0,12,402,83,79,57,323,93,10114
15000US060411102003,732,93,0,12,0,12,0,12,732,93,111,65,621,116,10115
15000US060411110001,745,193,99,107,0,12,99,107,646,194,95,67,551,196,10116
15000US060411110002,317,97,44,52,0,12,44,52,273,87,58,48,215,83,10117
15000US060411110003,754,139,0,12,0,12,0,12,754,139,58,54,696,133,10118
15000US060411110004,927,140,27,39,0,12,27,39,900,143,232,136,668,134,10119
15000US060411121001,620,90,109,60,0,12,109,60,511,93,84,52,427,100,10120
15000US060411121002,374,52,15,17,8,13,7,12,359,53,80,39,279,53,10121
15000US060411121003,438,74,7,11,7,11,0,12,431,74,61,36,370,78,10122
15000US060411121004,418,68,10,17,10,17,0,12,408,68,60,35,348,68,10123
15000US060411122011,1106,148,270,111,81,63,189,88,836,152,162,77,674,156,10124
15000US060411122012,574,126,92,77,8,15,84,78,482,126,43,39,439,119,10125
15000US060411122021,1107,90,132,68,22,24,110,64,975,98,165,55,810,113,10126
15000US060411122022,160,68,31,38,0,12,31,38,129,59,29,24,100,59,10127
15000US060411130001,359,92,18,21,0,12,18,21,341,95,42,43,299,89,10128
15000US060411130002,588,118,10,15,10,15,0,12,578,119,84,63,494,116,10129
15000US060411130003,350,95,0,12,0,12,0,12,350,95,21,35,329,91,10130
15000US060411130004,296,103,0,12,0,12,0,12,296,103,120,73,176,92,10131
15000US060411141001,765,120,0,12,0,12,0,12,765,120,97,63,668,128,10132
15000US060411141002,702,118,22,35,0,12,22,35,680,118,120,78,560,120,10133
15000US060411141003,744,129,17,27,0,12,17,27,727,128,107,60,620,123,10134
15000US060411142001,888,92,81,64,0,12,81,64,807,103,126,58,681,98,10135
15000US060411142002,488,81,9,14,0,12,9,14,479,83,74,47,405,79,10136
15000US060411150001,1035,145,0,12,0,12,0,12,1035,145,89,53,946,140,10137
15000US060411150002,506,76,0,12,0,12,0,12,506,76,110,59,396,78,10138
15000US060411150003,704,121,22,30,9,17,13,23,682,122,54,43,628,130,10139
15000US060411150004,551,134,0,12,0,12,0,12,551,134,72,48,479,136,10140
15000US060411160001,760,87,33,41,33,41,0,12,727,94,85,33,642,100,10141
15000US060411160002,517,64,0,12,0,12,0,12,517,64,51,35,466,72,10142
15000US060411170001,518,98,35,42,18,28,17,29,483,103,59,52,424,105,10143
15000US060411170002,293,74,0,12,0,12,0,12,293,74,60,49,233,80,10144
15000US060411170003,585,110,19,30,0,12,19,30,566,112,171,101,395,112,10145
15000US060411170004,652,131,0,12,0,12,0,12,652,131,136,75,516,132,10146
15000US060411181001,277,46,0,12,0,12,0,12,277,46,55,29,222,47,10147
15000US060411181002,495,56,0,12,0,12,0,12,495,56,57,29,438,56,10148
15000US060411191001,299,61,0,12,0,12,0,12,299,61,14,16,285,66,10149
15000US060411191002,392,62,0,12,0,12,0,12,392,62,67,41,325,70,10150
15000US060411191003,419,74,0,12,0,12,0,12,419,74,77,51,342,79,10151
15000US060411191004,497,79,30,47,0,12,30,47,467,76,104,44,363,78,10152
15000US060411191005,380,52,0,12,0,12,0,12,380,52,65,38,315,50,10153
15000US060411192011,703,75,30,29,10,16,20,24,673,78,135,58,538,102,10154
15000US060411192012,280,71,8,13,0,12,8,13,272,71,29,23,243,75,10155
15000US060411192013,905,97,22,20,0,12,22,20,883,99,155,64,728,113,10156
15000US060411192021,619,72,0,12,0,12,0,12,619,72,110,49,509,78,10157
15000US060411192022,602,62,8,13,8,13,0,12,594,65,30,25,564,64,10158
15000US060411200001,363,65,0,12,0,12,0,12,363,65,64,44,299,69,10159
15000US060411200002,398,82,12,19,0,12,12,19,386,82,40,37,346,93,10160
15000US060411200003,839,117,0,12,0,12,0,12,839,117,133,62,706,126,10161
15000US060411200004,721,116,0,12,0,12,0,12,721,116,119,107,602,106,10162
15000US060411200005,517,91,0,12,0,12,0,12,517,91,45,38,472,93,10163
15000US060411211001,484,81,0,12,0,12,0,12,484,81,31,35,453,84,10164
15000US060411211002,319,73,0,12,0,12,0,12,319,73,19,31,300,70,10165
15000US060411211003,632,105,49,38,0,12,49,38,583,110,176,109,407,109,10166
15000US060411211004,397,82,21,25,12,19,9,15,376,86,25,29,351,89,10167
15000US060411211005,268,61,0,12,0,12,0,12,268,61,51,33,217,56,10168
15000US060411212001,454,89,0,12,0,12,0,12,454,89,74,51,380,98,10169
15000US060411212002,972,150,13,20,0,12,13,20,959,151,172,74,787,144,10170
15000US060411212003,731,105,11,18,0,12,11,18,720,109,188,76,532,99,10171
15000US060411212004,288,83,0,12,0,12,0,12,288,83,12,22,276,90,10172
15000US060411220001,0,12,0,12,0,12,0,12,0,12,0,12,0,12,10173
15000US060411230001,331,47,0,12,0,12,0,12,331,47,96,34,235,47,10174
15000US060411230002,588,51,5,8,0,12,5,8,583,50,109,29,474,53,10175
15000US060411241001,620,124,50,63,50,63,0,12,570,138,142,72,428,121,10176
15000US060411241002,416,99,0,12,0,12,0,12,416,99,61,55,355,95,10177
15000US060411241003,256,88,17,28,0,12,17,28,239,88,42,48,197,86,10178
15000US060411241004,922,136,0,12,0,12,0,12,922,136,59,47,863,150,10179
15000US060411242001,0,12,0,12,0,12,0,12,0,12,0,12,0,12,10180
15000US060411242002,577,100,0,12,0,12,0,12,577,100,79,67,498,96,10181
15000US060411242003,633,123,0,12,0,12,0,12,633,123,129,97,504,132,10182
15000US060411242004,601,100,0,12,0,12,0,12,601,100,76,43,525,107,10183
15000US060411242005,739,108,29,26,10,17,19,22,710,105,98,60,612,118,10184
15000US060411250001,573,82,0,12,0,12,0,12,573,82,61,33,512,89,10185
15000US060411250002,654,97,21,18,0,12,21,18,633,96,58,34,575,102,10186
15000US060411250003,798,90,35,43,0,12,35,43,763,89,130,56,633,93,10187
15000US060411261001,607,107,0,12,0,12,0,12,607,107,127,66,480,120,10188
15000US060411261002,542,96,27,41,27,41,0,12,515,98,37,41,478,96,10189
15000US060411261003,443,102,17,27,0,12,17,27,426,104,39,61,387,90,10190
15000US060411261004,359,69,0,12,0,12,0,12,359,69,52,50,307,77,10191
15000US060411261005,321,59,17,28,0,12,17,28,304,55,79,58,225,67,10192
15000US060411262001,801,100,0,12,0,12,0,12,801,100,134,77,667,98,10193
15000US060411262002,960,113,12,19,0,12,12,19,948,114,219,80,729,119,10194
15000US060411262003,191,68,10,17,10,17,0,12,181,69,0,12,181,69,10195
15000US060411270001,551,118,0,12,0,12,0,12,551,118,77,57,474,125,10196
15000US060411270002,387,98,0,12,0,12,0,12,387,98,46,39,341,107,10197
15000US060411270003,287,83,0,12,0,12,0,12,287,83,30,34,257,87,10198
15000US060411270004,381,72,0,12,0,12,0,12,381,72,33,35,348,78,10199
15000US060411270005,501,90,0,12,0,12,0,12,501,90,62,50,439,99,10200
15000US060411281001,894,124,24,28,0,12,24,28,870,127,115,68,755,137,10201
15000US060411281002,637,100,9,15,0,12,9,15,628,101,96,63,532,109,10202
15000US060411281003,1206,140,17,31,17,31,0,12,1189,138,219,88,970,141,10203
15000US060411282001,310,64,0,12,0,12,0,12,310,64,116,71,194,51,10204
15000US060411282002,818,90,0,12,0,12,0,12,818,90,126,56,692,83,10205
15000US060411282003,730,71,8,13,0,12,8,13,722,73,126,51,596,73,10206
15000US060411290001,518,81,182,73,101,53,81,52,336,82,115,52,221,74,10207
15000US060411290002,557,96,122,64,58,36,64,53,435,98,77,68,358,83,10208
15000US060411302011,677,100,24,26,24,26,0,12,653,105,102,53,551,110,10209
15000US060411302012,614,81,0,12,0,12,0,12,614,81,52,38,562,88,10210
15000US060411302013,653,93,0,12,0,12,0,12,653,93,107,52,546,96,10211
15000US060411302021,324,73,18,31,0,12,18,31,306,71,26,22,280,72,10212
15000US060411302022,608,133,0,12,0,12,0,12,608,133,43,41,565,140,10213
15000US060411302023,889,153,25,35,0,12,25,35,864,149,80,59,784,152,10214
15000US060411302024,606,122,0,12,0,12,0,12,606,122,54,43,552,124,10215
15000US060411311001,22,20,0,12,0,12,0,12,22,20,0,12,22,20,10216
15000US060411311002,227,43,13,21,0,12,13,21,214,42,58,26,156,42,10217
15000US060411311003,158,39,8,11,8,11,0,12,150,41,25,19,125,44,10218
15000US060411321001,324,102,0,12,0,12,0,12,324,102,0,12,324,102,10219
15000US060411321002,544,107,40,39,0,12,40,39,504,107,44,24,460,107,10220
15000US060411322001,323,70,0,12,0,12,0,12,323,70,58,41,265,61,10221
15000US060411322002,344,73,0,12,0,12,0,12,344,73,89,43,255,72,10222
15000US060411322003,193,54,13,20,0,12,13,20,180,56,73,47,107,43,10223
15000US060411330001,404,74,29,31,21,30,8,9,375,66,74,39,301,61,10224
15000US060411330002,272,48,0,12,0,12,0,12,272,48,43,22,229,46,10225
15000US060411330003,336,77,7,10,0,12,7,10,329,78,51,37,278,79,10226
15000US060411330004,337,86,0,12,0,12,0,12,337,86,104,58,233,89,10227
15000US060419901000,0,12,0,12,0,12,0,12,0,12,0,12,0,12,10228
15000US060430001011,378,119,87,81,41,56,46,57,291,93,38,46,253,79,10229
15000US060430001012,450,128,44,30,26,25,18,20,406,126,93,70,313,111,10230
15000US060430001013,594,120,156,72,121,64,35,37,438,134,148,82,290,107,10231
15000US060430001014,248,73,10,15,10,15,0,12,238,73,114,62,124,44,10232
15000US060430001021,605,113,56,37,22,24,34,29,549,107,176,69,373,104,10233
15000US060430001022,628,107,31,37,23,35,8,14,597,111,89,46,508,104,10234
15000US060430002001,793,145,71,53,26,41,45,46,722,148,258,82,464,140,10235
15000US060430002002,273,85,7,12,7,12,0,12,266,86,118,63,148,64,10236
15000US060430002003,253,86,16,20,16,20,0,12,237,83,76,56,161,72,10237
15000US060430003011,260,61,16,19,16,19,0,12,244,58,45,32,199,55,10238
15000US060430003012,765,133,106,67,62,60,44,35,659,131,315,106,344,85,10239
15000US060430003013,384,87,71,49,35,32,36,39,313,83,71,61,242,75,10240
15000US060430003021,274,80,28,36,23,36,5,8,246,81,58,53,188,69,10241
15000US060430003022,423,78,33,33,16,19,17,24,390,83,124,55,266,90,10242
15000US060430003023,407,85,46,49,39,47,7,11,361,77,138,47,223,72,10243
15000US060430004001,366,80,0,12,0,12,0,12,366,80,51,43,315,84,10244
15000US060430004002,154,41,48,12,4,7,44,10,106,40,16,25,90,29,10245
15000US060450101001,192,51,5,7,0,12,5,7,187,52,23,20,164,49,10246
15000US060450101002,428,94,61,47,11,11,50,46,367,91,210,78,157,49,10247
15000US060450101003,325,71,27,28,4,5,23,27,298,70,77,38,221,71,10248
15000US060450102001,292,116,25,41,0,12,25,41,267,113,91,59,176,99,10249
15000US060450102002,331,87,27,19,14,15,13,11,304,86,127,67,177,81,10250
15000US060450102003,222,88,2,5,2,5,0,12,220,88,37,47,183,81,10251
15000US060450102004,339,106,9,12,9,12,0,12,330,105,110,72,220,78,10252
15000US060450102005,523,118,107,64,46,28,61,59,416,116,155,84,261,95,10253
15000US060450103001,267,90,52,57,0,12,52,57,215,76,60,28,155,74,10254
15000US060450103002,839,135,134,96,34,47,100,83,705,129,268,88,437,108,10255
15000US060450103003,271,61,31,32,17,20,14,23,240,57,80,40,160,64,10256
15000US060450103004,337,76,25,40,25,40,0,12,312,75,67,51,245,63,10257
15000US060450104001,182,61,27,24,11,16,16,21,155,62,84,53,71,42,10258
15000US060450104002,239,72,21,24,8,13,13,22,218,65,93,51,125,47,10259
15000US060450104003,397,102,102,69,13,19,89,66,295,102,60,45,235,99,10260
15000US060450104004,516,111,53,49,31,51,22,21,463,97,180,70,283,85,10261
15000US060450105001,504,112,108,57,24,25,84,58,396,110,135,62,261,96,10262
15000US060450105002,289,73,31,32,16,26,15,17,258,68,116,69,142,61,10263
15000US060450105003,457,78,23,19,23,19,0,12,434,82,123,55,311,82,10264
15000US060450105004,535,120,135,75,47,36,88,64,400,102,242,89,158,79,10265
15000US060450106001,379,110,14,24,0,12,14,24,365,110,36,28,329,109,10266
15000US060450106002,1401,228,230,119,67,64,163,105,1171,232,264,120,907,230,10267
15000US060450106003,285,115,26,29,14,21,12,19,259,116,142,99,117,83,10268
15000US060450106004,757,175,48,62,0,12,48,62,709,179,259,117,450,149,10269
15000US060450107001,200,80,35,37,35,37,0,12,165,81,94,67,71,48,10270
15000US060450107002,472,129,26,29,26,29,0,12,446,125,199,86,247,101,10271
15000US060450107003,395,104,86,68,42,44,44,55,309,104,101,64,208,95,10272
15000US060450107004,253,98,44,67,44,67,0,12,209,89,82,50,127,87,10273
15000US060450107005,471,133,157,111,71,84,86,77,314,115,97,83,217,89,10274
15000US060450107006,534,149,45,74,45,74,0,12,489,161,300,141,189,124,10275
15000US060450107007,288,110,27,33,13,22,14,24,261,109,199,111,62,50,10276
15000US060450108011,291,114,22,32,1,3,21,32,269,113,30,24,239,117,10277
15000US060450108012,509,109,44,41,38,40,6,11,465,112,121,89,344,105,10278
15000US060450108013,654,159,75,83,10,18,65,82,579,151,106,63,473,154,10279
15000US060450108014,678,186,27,23,23,23,4,9,651,186,211,96,440,177,10280
15000US060450108021,235,54,9,12,0,12,9,12,226,53,24,18,202,53,10281
15000US060450108022,460,51,29,30,17,26,12,14,431,49,111,52,320,58,10282
15000US060450109001,290,71,13,22,0,12,13,22,277,71,50,36,227,75,10283
15000US060450109002,143,49,39,41,28,39,11,16,104,48,45,26,59,43,10284
15000US060450109003,902,96,208,83,92,61,116,67,694,112,288,81,406,94,10285
15000US060450109004,327,71,37,40,37,40,0,12,290,73,35,26,255,77,10286
15000US060450110011,870,106,77,52,52,44,25,29,793,113,317,89,476,119,10287
15000US060450110021,441,132,88,80,34,39,54,68,353,144,123,96,230,122,10288
15000US060450110022,329,128,32,39,13,22,19,30,297,134,87,91,210,101,10289
15000US060450110023,577,166,0,12,0,12,0,12,577,166,289,135,288,140,10290
15000US060450110024,360,149,0,12,0,12,0,12,360,149,0,12,360,149,10291
15000US060450110025,923,193,83,54,37,39,46,44,840,191,211,112,629,177,10292
15000US060450111021,301,58,13,15,0,12,13,15,288,61,61,31,227,55,10293
15000US060450111022,619,96,132,57,46,43,86,56,487,83,143,44,344,75,10294
15000US060450111023,911,159,8,13,8,13,0,12,903,159,240,93,663,149,10295
15000US060450112001,467,85,51,37,6,7,45,36,416,83,132,53,284,77,10296
15000US060450112002,355,69,60,42,9,14,51,45,295,64,94,45,201,61,10297
15000US060450112003,284,64,16,18,0,12,16,18,268,64,68,36,200,63,10298
15000US060450113001,817,181,258,157,81,55,177,145,559,180,140,92,419,170,10299
15000US060450113002,861,160,191,102,72,65,119,70,670,137,222,89,448,130,10300
15000US060450113003,347,100,43,48,21,37,22,28,304,100,96,86,208,77,10301
15000US060450114001,160,48,0,12,0,12,0,12,160,48,20,22,140,48,10302
15000US060450114002,411,93,32,27,0,12,32,27,379,93,90,56,289,98,10303
15000US060450114003,336,83,27,25,10,16,17,20,309,86,26,25,283,85,10304
15000US060450114004,193,50,12,24,0,12,12,24,181,47,17,15,164,45,10305
15000US060450114005,336,65,0,12,0,12,0,12,336,65,165,68,171,64,10306
15000US060450114006,240,63,46,43,27,37,19,25,194,60,46,33,148,51,10307
15000US060450115001,467,133,214,114,77,60,137,97,253,95,126,69,127,72,10308
15000US060450115002,846,156,91,85,0,12,91,85,755,150,220,104,535,151,10309
15000US060450115003,438,143,62,98,0,12,62,98,376,102,125,81,251,90,10310
15000US060450115004,193,92,33,41,18,31,15,25,160,89,66,81,94,60,10311
15000US060450115005,460,151,92,83,77,80,15,24,368,134,67,51,301,137,10312
15000US060450116001,516,126,24,28,12,20,12,20,492,125,135,87,357,107,10313
15000US060450116002,698,117,113,89,0,12,113,89,585,118,227,111,358,101,10314
15000US060450116003,339,138,48,43,0,12,48,43,291,134,13,22,278,132,10315
15000US060450116004,767,123,143,90,45,52,98,80,624,140,347,121,277,118,10316
15000US060450117001,342,72,11,19,0,12,11,19,331,72,77,38,254,80,10317
15000US060450117002,353,66,5,7,1,2,4,6,348,67,81,45,267,64,10318
15000US060450117003,311,77,3,9,0,12,3,9,308,75,76,64,232,69,10319
15000US060450117004,346,95,40,31,20,22,20,23,306,100,106,73,200,105,10320
15000US060450117005,152,67,20,25,20,25,0,12,132,69,20,21,112,72,10321
15000US060450118001,520,65,35,25,9,9,26,23,485,67,125,52,360,68,10322
15000US060450118002,299,46,52,30,19,16,33,28,247,52,68,37,179,49,10323
15000US060459901000,0,12,0,12,0,12,0,12,0,12,0,12,0,12,10324
15000US060470002011,866,86,190,74,45,37,145,79,676,91,173,56,503,94,10325
15000US060470002012,219,51,43,31,34,29,9,14,176,43,69,33,107,39,10326
15000US060470002021,521,52,85,34,46,31,39,27,436,63,160,58,276,60,10327
15000US060470002031,554,144,43,46,25,33,18,31,511,142,105,59,406,143,10328
15000US060470002032,976,170,174,105,159,105,15,25,802,169,277,132,525,151,10329
15000US060470002033,300,105,126,96,96,90,30,32,174,95,94,92,80,92,10330
15000US060470002034,205,80,0,12,0,12,0,12,205,80,94,62,111,76,10331
15000US060470002035,468,138,82,88,0,12,82,88,386,136,96,88,290,121,10332
15000US060470003011,397,94,108,76,82,69,26,41,289,89,117,59,172,79,10333
15000US060470003012,260,80,25,40,0,12,25,40,235,82,95,61,140,80,10334
15000US060470003013,666,133,60,42,9,15,51,39,606,133,201,90,405,125,10335
15000US060470003031,401,65,81,49,28,27,53,43,320,63,63,27,257,65,10336
15000US060470003032,252,50,21,24,0,12,21,24,231,49,50,24,181,51,10337
15000US060470003041,473,156,115,83,115,83,0,12,358,153,140,95,218,129,10338
15000US060470003042,212,94,69,49,14,22,55,57,143,80,48,50,95,64,10339
15000US060470003043,162,95,88,80,10,16,78,86,74,62,23,29,51,55,10340
15000US060470003044,446,144,45,42,32,40,13,23,401,137,126,93,275,127,10341
15000US060470003045,1021,167,86,63,18,29,68,58,935,169,310,131,625,177,10342
15000US060470004011,478,68,77,46,38,35,39,33,401,79,136,50,265,70,10343
15000US060470004021,441,119,39,45,24,38,15,24,402,117,69,55,333,114,10344
15000US060470004022,490,144,106,100,47,71,59,71,384,128,38,30,346,129,10345
15000US060470004023,1078,196,0,12,0,12,0,12,1078,196,508,193,570,157,10346
15000US060470004024,844,156,71,68,41,62,30,36,773,158,218,132,555,138,10347
15000US060470005031,621,55,89,37,39,27,50,29,532,58,160,43,372,56,10348
15000US060470005041,524,113,112,71,95,65,17,29,412,112,208,96,204,75,10349
15000US060470005042,460,101,118,59,75,53,43,41,342,102,129,70,213,85,10350
15000US060470005043,774,137,179,76,83,66,96,42,595,130,251,100,344,99,10351
15000US060470005051,620,105,80,61,69,60,11,13,540,103,108,43,432,109,10352
15000US060470005052,253,75,59,43,41,38,18,21,194,76,68,63,126,58,10353
15000US060470005053,823,120,195,75,91,66,104,68,628,111,209,92,419,116,10354
15000US060470006011,417,100,60,57,60,57,0,12,357,99,167,73,190,71,10355
15000US060470006012,422,102,73,59,0,12,73,59,349,114,86,61,263,107,10356
15000US060470006013,493,120,195,93,54,53,141,80,298,112,150,82,148,82,10357
15000US060470006014,355,80,40,38,15,18,25,39,315,73,65,45,250,73,10358
15000US060470006021,584,82,214,73,117,50,97,56,370,78,91,48,279,76,10359
15000US060470006022,511,85,191,84,52,42,139,69,320,79,90,44,230,67,10360
15000US060470006031,467,93,8,13,8,13,0,12,459,91,134,79,325,89,10361
15000US060470006032,315,81,0,12,0,12,0,12,315,81,91,60,224,72,10362
15000US060470006033,479,93,95,66,0,12,95,66,384,104,104,55,280,96,10363
15000US060470006034,454,113,208,75,46,38,162,75,246,106,55,59,191,93,10364
15000US060470006035,282,98,73,57,32,35,41,43,209,95,69,64,140,74,10365
15000US060470007011,561,91,226,72,135,65,91,45,335,80,152,61,183,66,10366
15000US060470007012,424,61,154,52,47,29,107,47,270,62,89,35,181,49,10367
15000US060470007021,492,76,42,48,13,15,29,45,450,81,155,70,295,77,10368
15000US060470007022,541,96,13,21,0,12,13,21,528,97,118,56,410,98,10369
15000US060470007023,645,111,63,36,13,16,50,34,582,110,145,63,437,112,10370
15000US060470008011,1087,102,170,68,66,40,104,60,917,107,419,109,498,117,10371
15000US060470008012,539,84,176,75,41,31,135,69,363,81,144,59,219,75,10372
15000US060470008021,702,95,120,69,42,39,78,59,582,102,305,90,277,75,10373
15000US060470008022,710,100,107,61,23,25,84,58,603,96,102,58,501,101,10374
15000US060470009011,359,86,25,21,18,19,7,10,334,86,37,25,297,89,10375
15000US060470009012,341,64,38,24,6,10,32,22,303,65,28,20,275,65,10376
15000US060470009013,285,79,13,14,0,12,13,14,272,77,65,56,207,73,10377
15000US060470009021,642,122,28,33,15,24,13,21,614,124,236,107,378,125,10378
15000US060470009022,804,177,277,140,205,130,72,51,527,148,224,96,303,139,10379
15000US060470009023,619,165,140,85,28,34,112,78,479,162,342,152,137,85,10380
15000US060470009024,573,157,132,104,16,25,116,100,441,135,148,103,293,124,10381
15000US060470010021,2408,286,258,162,76,91,182,145,2150,291,563,238,1587,293,10382
15000US060470010022,605,179,65,79,65,79,0,12,540,175,123,121,417,155,10383
15000US060470010023,608,159,92,86,0,12,92,86,516,150,289,136,227,151,10384
15000US060470010024,725,181,124,125,0,12,124,125,601,169,206,131,395,191,10385
15000US060470010031,267,68,33,43,26,41,7,13,234,66,63,36,171,61,10386
15000US060470010032,616,94,253,68,140,67,113,70,363,99,121,62,242,85,10387
15000US060470010033,545,73,294,68,73,51,221,66,251,71,126,57,125,61,10388
15000US060470010041,632,129,114,59,59,40,55,44,518,123,234,95,284,102,10389
15000US060470010042,372,85,6,10,6,10,0,12,366,85,100,53,266,74,10390
15000US060470010043,793,104,106,58,67,46,39,43,687,102,267,90,420,89,10391
15000US060470010051,825,73,230,61,150,55,80,44,595,83,206,60,389,77,10392
15000US060470011011,546,113,114,70,114,70,0,12,432,109,98,65,334,109,10393
15000US060470011012,647,148,177,128,127,126,50,41,470,140,306,147,164,94,10394
15000US060470011013,425,112,72,90,55,86,17,26,353,97,138,95,215,90,10395
15000US060470011014,446,117,0,12,0,12,0,12,446,117,86,61,360,119,10396
15000US060470012001,463,110,133,74,64,58,69,49,330,91,95,42,235,89,10397
15000US060470012002,446,91,103,60,70,52,33,29,343,85,162,71,181,64,10398
15000US060470012003,291,90,72,61,12,18,60,57,219,69,67,40,152,62,10399
15000US060470012004,708,84,10,19,10,19,0,12,698,86,174,70,524,96,10400
15000US060470013011,226,80,109,70,20,23,89,66,117,57,32,22,85,56,10401
15000US060470013012,590,107,129,77,67,58,62,54,461,108,85,48,376,106,10402
15000US060470013013,382,89,106,59,58,41,48,45,276,77,195,73,81,54,10403
15000US060470013021,271,67,139,71,113,66,26,26,132,49,68,31,64,41,10404
15000US060470013022,393,96,94,55,54,41,40,46,299,87,104,55,195,82,10405
15000US060470013023,476,97,273,106,144,82,129,80,203,71,77,37,126,61,10406
15000US060470014011,787,96,219,94,142,74,77,61,568,115,211,88,357,92,10407
15000US060470014012,703,116,442,121,292,111,150,70,261,70,83,56,178,68,10408
15000US060470014021,543,92,251,97,190,96,61,47,292,91,120,62,172,79,10409
15000US060470014022,220,56,40,54,0,12,40,54,180,58,78,43,102,50,10410
15000US060470014023,386,62,49,33,33,24,16,23,337,64,114,47,223,69,10411
15000US060470014024,412,89,76,48,48,38,28,28,336,92,112,64,224,73,10412
15000US060470015011,744,32,107,48,71,43,36,20,637,51,158,48,479,55,10413
15000US060470015021,316,67,121,40,65,31,56,36,195,60,85,39,110,46,10414
15000US060470015022,410,69,211,62,162,61,49,31,199,64,63,36,136,60,10415
15000US060470015031,316,71,201,61,108,53,93,47,115,54,73,39,42,37,10416
15000US060470015032,388,84,173,67,143,67,30,29,215,64,88,48,127,52,10417
15000US060470015033,488,78,270,68,181,65,89,48,218,76,60,34,158,72,10418
15000US060470016011,469,109,305,114,137,84,168,85,164,73,72,67,92,56,10419
15000US060470016012,238,100,123,67,16,26,107,67,115,73,31,25,84,70,10420
15000US060470016013,290,96,113,73,50,45,63,56,177,93,33,43,144,84,10421
15000US060470016021,910,104,294,80,167,69,127,52,616,113,257,87,359,103,10422
15000US060470016022,850,115,266,95,172,89,94,48,584,120,270,91,314,93,10423
15000US060470017001,1187,117,585,108,292,100,293,86,602,109,285,82,317,105,10424
15000US060470017002,388,79,65,47,47,43,18,20,323,66,211,73,112,45,10425
15000US060470017003,306,67,87,44,32,31,55,43,219,60,76,40,143,62,10426
15000US060470018011,1111,39,23,23,4,10,19,20,1088,43,198,81,890,90,10427
15000US060470019011,511,86,156,63,64,42,92,58,355,79,140,52,215,70,10428
15000US060470019012,252,69,61,35,30,34,31,27,191,70,51,40,140,70,10429
15000US060470019013,412,100,96,60,32,38,64,48,316,91,183,83,133,60,10430
15000US060470019014,393,73,112,55,65,48,47,43,281,72,63,41,218,65,10431
15000US060470019021,487,48,159,45,39,19,120,43,328,51,119,38,209,45,10432
15000US060470019022,255,49,29,18,13,10,16,16,226,47,73,32,153,42,10433
15000US060470020001,502,148,54,69,0,12,54,69,448,141,150,103,298,111,10434
15000US060470020002,340,134,14,23,14,23,0,12,326,133,30,32,296,134,10435
15000US060470020003,473,105,136,85,13,21,123,84,337,95,96,65,241,86,10436
15000US060470020004,385,110,11,19,0,12,11,19,374,114,78,67,296,110,10437
15000US060470020005,492,112,0,12,0,12,0,12,492,112,197,89,295,118,10438
15000US060470020006,357,90,30,33,17,26,13,20,327,86,105,58,222,67,10439
15000US060470021001,480,135,119,105,54,67,65,78,361,113,146,85,215,83,10440
15000US060470021002,192,94,9,14,0,12,9,14,183,94,19,22,164,95,10441
15000US060470021003,606,112,140,77,16,19,124,78,466,102,152,81,314,111,10442
15000US060470022011,211,57,29,34,9,15,20,31,182,59,62,46,120,62,10443
15000US060470022012,424,92,198,71,20,30,178,64,226,74,83,49,143,66,10444
15000US060470022013,383,98,118,61,25,33,93,57,265,89,89,53,176,73,10445
15000US060470022014,379,85,98,56,0,12,98,56,281,83,95,53,186,73,10446
15000US060470022015,546,113,125,66,9,16,116,65,421,94,94,54,327,95,10447
15000US060470022021,754,143,134,90,48,41,86,80,620,142,120,68,500,143,10448
15000US060470022022,468,138,51,58,0,12,51,58,417,139,116,75,301,121,10449
15000US060470022023,353,118,122,71,51,70,71,63,231,103,118,95,113,59,10450
15000US060470022024,138,75,80,70,14,24,66,68,58,37,47,44,11,17,10451
15000US060470022025,943,169,79,82,28,47,51,63,864,165,220,103,644,173,10452
15000US060470023011,1232,148,92,66,32,37,60,53,1140,161,222,94,918,164,10453
15000US060470023012,586,125,71,88,55,86,16,25,515,116,193,78,322,133,10454
15000US060470023013,410,110,0,12,0,12,0,12,410,110,6,16,404,108,10455
15000US060470023021,248,106,6,11,6,11,0,12,242,106,77,44,165,110,10456
15000US060470023022,2170,215,467,160,178,86,289,148,1703,235,315,108,1388,226,10457
15000US060470023023,766,153,150,89,52,48,98,73,616,153,140,74,476,171,10458
15000US060470023024,815,171,256,129,86,78,170,111,559,151,104,64,455,153,10459
15000US060470024011,569,56,67,26,22,16,45,23,502,55,113,49,389,53,10460
15000US060470024021,462,119,97,74,49,59,48,54,365,126,161,99,204,94,10461
15000US060470024022,566,139,113,71,32,39,81,61,453,133,169,67,284,122,10462
15000US060470024023,519,117,42,42,12,22,30,34,477,121,146,67,331,103,10463
15000US060470024024,734,156,128,73,16,29,112,65,606,167,101,75,505,148,10464
15000US060470025001,315,48,60,28,37,24,23,19,255,51,93,31,162,39,10465
15000US060470025002,428,59,19,20,19,20,0,12,409,59,196,54,213,53,10466
15000US060470026001,672,107,67,36,16,20,51,31,605,114,258,111,347,96,10467
15000US060470026002,966,103,95,72,0,12,95,72,871,119,218,70,653,120,10468
15000US060490001001,413,110,27,30,0,12,27,30,386,108,100,64,286,98,10469
15000US060490001002,331,94,74,58,65,55,9,14,257,81,128,76,129,61,10470
15000US060490001003,197,78,24,28,24,28,0,12,173,74,56,45,117,70,10471
15000US060490001004,124,46,14,24,14,24,0,12,110,45,22,25,88,45,10472
15000US060490001005,564,116,28,37,19,33,9,17,536,120,181,93,355,111,10473
15000US060490002001,316,75,15,22,0,12,15,22,301,73,151,47,150,57,10474
15000US060490002002,295,65,0,12,0,12,0,12,295,65,73,31,222,67,10475
15000US060490003001,287,103,0,12,0,12,0,12,287,103,126,72,161,89,10476
15000US060490003002,286,93,10,17,10,17,0,12,276,97,77,58,199,89,10477
15000US060490003003,345,113,34,23,0,12,34,23,311,110,86,64,225,102,10478
15000US060490004001,325,57,15,14,5,5,10,12,310,56,102,40,208,63,10479
15000US060490004002,187,44,5,8,0,12,5,8,182,43,48,28,134,40,10480
15000US060510001011,453,115,39,30,8,13,31,28,414,110,134,67,280,107,10481
15000US060510001012,186,99,0,12,0,12,0,12,186,99,0,12,186,99,10482
15000US060510001013,205,48,0,12,0,12,0,12,205,48,28,17,177,48,10483
15000US060510001014,405,133,6,11,0,12,6,11,399,133,55,52,344,113,10484
15000US060510001021,163,73,25,27,0,12,25,27,138,68,19,24,119,64,10485
15000US060510001022,334,97,17,23,0,12,17,23,317,96,88,55,229,94,10486
15000US060510001023,266,96,1,2,0,12,1,2,265,95,74,74,191,93,10487
15000US060510001024,147,83,11,19,0,12,11,19,136,81,0,12,136,81,10488
15000US060510002001,650,222,0,12,0,12,0,12,650,222,54,61,596,218,10489
15000US060510002002,308,152,54,60,28,46,26,42,254,152,0,12,254,152,10490
15000US060510002003,191,119,0,12,0,12,0,12,191,119,26,44,165,112,10491
15000US060510002004,272,137,0,12,0,12,0,12,272,137,0,12,272,137,10492
15000US060510002005,453,172,28,46,0,12,28,46,425,169,0,12,425,169,10493
15000US060510002006,252,136,0,12,0,12,0,12,252,136,25,43,227,131,10494
15000US060510002007,360,171,0,12,0,12,0,12,360,171,38,57,322,160,10495
15000US060510002008,305,162,0,12,0,12,0,12,305,162,16,27,289,159,10496
15000US060510002009,0,12,0,12,0,12,0,12,0,12,0,12,0,12,10497
15000US060530001011,322,58,43,41,0,12,43,41,279,61,84,41,195,60,10498
15000US060530001012,248,61,12,13,0,12,12,13,236,59,58,29,178,59,10499
15000US060530001021,629,165,95,71,47,50,48,55,534,158,146,78,388,156,10500
15000US060530001022,788,162,93,63,0,12,93,63,695,170,193,99,502,130,10501
15000US060530001023,869,149,14,22,14,22,0,12,855,151,143,80,712,148,10502
15000US060530001031,717,101,63,43,51,43,12,13,654,106,270,78,384,97,10503
15000US060530001032,635,102,21,19,21,19,0,12,614,101,31,27,583,103,10504
15000US060530001041,179,43,16,13,9,11,7,8,163,44,55,30,108,42,10505
15000US060530001042,799,50,56,44,24,33,32,28,743,62,74,38,669,58,10506
15000US060530002001,663,128,69,46,43,34,26,32,594,124,123,62,471,120,10507
15000US060530002002,363,105,35,47,0,12,35,47,328,102,115,61,213,93,10508
15000US060530002003,440,106,16,28,16,28,0,12,424,107,107,58,317,116,10509
15000US060530002004,300,99,17,27,0,12,17,27,283,102,95,66,188,88,10510
15000US060530003001,655,97,47,31,0,12,47,31,608,96,148,57,460,97,10511
15000US060530003002,673,98,54,44,43,40,11,18,619,108,161,57,458,112,10512
15000US060530004001,804,177,61,65,48,61,13,23,743,173,191,82,552,165,10513
15000US060530004002,925,167,106,102,0,12,106,102,819,143,240,107,579,139,10514
15000US060530004003,566,151,68,51,32,45,36,42,498,142,56,45,442,141,10515
15000US060530005011,539,78,81,58,51,47,30,35,458,83,132,64,326,85,10516
15000US060530005012,489,92,162,71,48,40,114,63,327,99,47,33,280,104,10517
15000US060530005021,497,65,46,29,8,9,38,28,451,66,105,36,346,64,10518
15000US060530005022,461,62,23,17,5,8,18,15,438,59,109,41,329,56,10519
15000US060530006001,338,73,45,38,20,27,25,28,293,69,84,48,209,75,10520
15000US060530006002,313,77,17,24,0,12,17,24,296,77,61,47,235,70,10521
15000US060530006003,556,97,123,70,0,12,123,70,433,94,53,44,380,92,10522
15000US060530006004,252,79,43,38,0,12,43,38,209,76,81,55,128,55,10523
15000US060530007011,435,86,69,46,0,12,69,46,366,82,72,43,294,83,10524
15000US060530007012,418,78,101,63,37,39,64,50,317,82,68,50,249,76,10525
15000US060530007013,370,80,15,16,15,16,0,12,355,82,71,53,284,78,10526
15000US060530007021,459,90,65,42,16,25,49,32,394,92,67,42,327,87,10527
15000US060530007022,383,76,91,50,19,30,72,43,292,75,29,29,263,73,10528
15000US060530007023,394,83,92,46,8,13,84,43,302,87,48,42,254,88,10529
15000US060530008001,461,84,53,38,19,21,34,38,408,82,76,48,332,88,10530
15000US060530008002,352,82,47,34,17,21,30,27,305,84,30,20,275,87,10531
15000US060530008003,349,81,13,15,6,9,7,11,336,82,87,50,249,76,10532
15000US060530009001,236,74,0,12,0,12,0,12,236,74,79,43,157,72,10533
15000US060530009002,264,98,43,47,0,12,43,47,221,95,5,8,216,95,10534
15000US060530009003,704,104,120,68,45,36,75,64,584,99,55,46,529,93,10535
15000US060530012001,696,87,49,34,16,18,33,28,647,92,178,58,469,93,10536
15000US060530012002,473,77,44,47,12,20,32,42,429,74,155,52,274,62,10537
15000US060530013001,888,61,149,48,35,20,114,46,739,70,121,41,618,81,10538
15000US060530014001,503,92,32,39,9,15,23,38,471,95,64,40,407,98,10539
15000US060530014002,518,85,21,24,0,12,21,24,497,89,77,39,420,99,10540
15000US060530015001,1083,156,8,14,0,12,8,14,1075,160,299,132,776,156,10541
15000US060530015002,466,111,33,43,0,12,33,43,433,105,72,55,361,111,10542
15000US060530015003,943,143,33,36,33,36,0,12,910,151,160,73,750,154,10543
15000US060530016001,582,59,15,13,7,8,8,11,567,59,116,33,451,66,10544
15000US060530016002,364,52,14,13,0,12,14,13,350,54,122,39,228,54,10545
15000US060530017001,728,80,52,42,22,23,30,35,676,83,178,73,498,83,10546
15000US060530017002,532,83,31,26,13,14,18,21,501,85,124,59,377,82,10547
15000US060530018011,481,85,56,54,23,29,33,41,425,103,148,97,277,110,10548
15000US060530018012,671,91,41,34,21,24,20,32,630,98,106,60,524,83,10549
15000US060530018021,605,86,39,40,25,38,14,16,566,84,68,39,498,94,10550
15000US060530018022,406,100,51,41,0,12,51,41,355,100,73,38,282,99,10551
15000US060530018023,521,81,28,42,28,42,0,12,493,75,132,54,361,75,10552
15000US060530101011,436,65,53,38,9,15,44,35,383,68,71,52,312,73,10553
15000US060530101012,565,63,201,80,84,55,117,65,364,78,88,55,276,90,10554
15000US060530101021,472,98,61,64,0,12,61,64,411,98,152,76,259,74,10555
15000US060530101022,525,86,0,12,0,12,0,12,525,86,95,41,430,87,10556
15000US060530102021,294,80,11,18,0,12,11,18,283,81,70,43,213,87,10557
15000US060530102022,575,90,10,16,10,16,0,12,565,92,85,46,480,100,10558
15000US060530102023,442,96,46,53,8,14,38,48,396,106,157,74,239,89,10559
15000US060530103051,589,96,35,32,16,18,19,27,554,94,105,56,449,101,10560
15000US060530103052,684,90,21,34,0,12,21,34,663,91,126,56,537,100,10561
15000US060530103053,230,56,72,52,35,37,37,41,158,53,41,34,117,51,10562
15000US060530103061,516,59,28,32,0,12,28,32,488,62,149,50,339,66,10563
15000US060530104001,411,97,72,49,10,15,62,50,339,95,111,58,228,90,10564
15000US060530104002,444,98,28,46,0,12,28,46,416,87,131,54,285,95,10565
15000US060530104003,414,84,67,60,0,12,67,60,347,94,97,82,250,98,10566
15000US060530104004,243,75,14,19,14,19,0,12,229,76,66,43,163,72,10567
15000US060530105011,332,125,0,12,0,12,0,12,332,125,91,56,241,116,10568
15000US060530105012,966,186,22,32,20,31,2,4,944,180,188,104,756,159,10569
15000US060530105013,393,102,10,17,0,12,10,17,383,102,103,86,280,100,10570
15000US060530105014,373,155,0,12,0,12,0,12,373,155,0,12,373,155,10571
15000US060530105041,601,108,29,42,29,42,0,12,572,102,124,65,448,97,10572
15000US060530105042,827,107,103,70,33,25,70,60,724,98,88,34,636,103,10573
15000US060530105051,546,97,39,33,9,16,30,28,507,100,133,70,374,99,10574
15000US060530105052,939,110,170,94,32,41,138,80,769,130,228,98,541,133,10575
15000US060530105061,749,105,98,52,22,24,76,47,651,116,67,47,584,122,10576
15000US060530105062,519,94,61,47,12,15,49,44,458,101,146,64,312,89,10577
15000US060530106031,1133,178,34,40,34,40,0,12,1099,179,89,58,1010,177,10578
15000US060530106032,870,181,5,14,5,14,0,12,865,182,116,87,749,184,10579
15000US060530106041,603,85,38,30,0,12,38,30,565,87,94,52,471,96,10580
15000US060530106042,719,94,69,49,25,18,44,46,650,97,227,79,423,98,10581
15000US060530106051,918,30,121,60,0,12,121,60,797,70,84,37,713,74,10582
15000US060530106061,655,101,17,14,8,12,9,15,638,101,185,56,453,93,10583
15000US060530106062,969,90,32,37,11,17,21,33,937,94,113,47,824,99,10584
15000US060530106071,427,53,65,37,20,19,45,31,362,59,84,31,278,59,10585
15000US060530106072,418,54,91,43,30,29,61,37,327,63,57,37,270,59,10586
15000US060530106081,128,40,0,12,0,12,0,12,128,40,21,18,107,38,10587
15000US060530106082,207,47,35,24,11,12,24,20,172,48,29,24,143,47,10588
15000US060530106083,188,43,31,26,0,12,31,26,157,45,16,16,141,47,10589
15000US060530107011,464,105,12,20,0,12,12,20,452,104,108,60,344,91,10590
15000US060530107012,1166,122,15,24,0,12,15,24,1151,124,86,63,1065,132,10591
15000US060530107013,504,95,0,12,0,12,0,12,504,95,27,32,477,95,10592
15000US060530107014,268,91,0,12,0,12,0,12,268,91,60,48,208,96,10593
15000US060530107021,798,92,0,12,0,12,0,12,798,92,150,59,648,100,10594
15000US060530107022,713,88,0,12,0,12,0,12,713,88,118,51,595,93,10595
15000US060530108041,319,100,0,12,0,12,0,12,319,100,34,35,285,97,10596
15000US060530108042,404,102,24,35,0,12,24,35,380,104,43,32,337,103,10597
15000US060530108043,633,116,71,59,33,38,38,44,562,123,42,35,520,123,10598
15000US060530109001,46,21,21,21,21,21,0,17,25,17,0,17,25,17,10599
15000US060530110001,506,127,0,12,0,12,0,12,506,127,97,60,409,127,10600
15000US060530110002,388,103,0,12,0,12,0,12,388,103,40,33,348,105,10601
15000US060530110003,654,114,0,12,0,12,0,12,654,114,89,57,565,122,10602
15000US060530110004,446,126,19,29,0,12,19,29,427,126,162,77,265,118,10603
15000US060530110005,470,149,24,37,0,12,24,37,446,149,86,50,360,147,10604
15000US060530111011,264,73,31,23,19,20,12,12,233,72,16,10,217,71,10605
15000US060530111012,271,77,63,51,10,15,53,53,208,77,55,35,153,79,10606
15000US060530111013,743,120,117,59,38,31,79,56,626,134,139,72,487,135,10607
15000US060530111021,859,190,34,39,23,36,11,17,825,191,194,118,631,186,10608
15000US060530111022,880,220,80,73,16,26,64,66,800,216,85,60,715,213,10609
15000US060530111023,1239,209,99,102,22,35,77,97,1140,201,304,145,836,203,10610
15000US060530112021,297,93,55,41,12,17,43,39,242,93,25,20,217,89,10611
15000US060530112022,727,108,46,30,0,12,46,30,681,109,104,48,577,105,10612
15000US060530112023,577,109,105,58,33,34,72,56,472,105,114,54,358,96,10613
15000US060530112031,309,95,75,54,17,18,58,55,234,93,7,11,227,95,10614
15000US060530112032,664,106,86,56,20,30,66,48,578,106,117,63,461,115,10615
15000US060530112033,588,106,50,45,30,34,20,33,538,107,160,66,378,104,10616
15000US060530112041,304,70,57,54,0,12,57,54,247,61,40,31,207,59,10617
15000US060530112042,532,79,54,36,13,22,41,28,478,82,54,32,424,79,10618
15000US060530113021,552,117,73,66,40,51,33,41,479,122,104,73,375,118,10619
15000US060530113022,349,90,153,78,8,13,145,77,196,69,65,39,131,59,10620
15000US060530113023,537,107,16,18,9,13,7,11,521,109,157,93,364,112,10621
15000US060530113031,900,107,41,31,23,22,18,23,859,112,247,82,612,125,10622
15000US060530113032,314,78,66,66,0,12,66,66,248,85,144,65,104,67,10623
15000US060530113041,238,82,32,39,4,7,28,39,206,78,80,51,126,55,10624
15000US060530113042,595,99,58,48,9,14,49,46,537,112,90,66,447,117,10625
15000US060530113043,643,125,82,65,13,17,69,62,561,123,144,80,417,120,10626
15000US060530114001,728,78,60,29,19,11,41,28,668,84,109,34,559,90,10627
15000US060530114002,490,73,43,28,11,9,32,26,447,73,93,34,354,76,10628
15000US060530115021,629,84,7,12,0,12,7,12,622,86,79,49,543,80,10629
15000US060530116021,653,136,0,12,0,12,0,12,653,136,155,89,498,127,10630
15000US060530116022,683,135,36,41,0,12,36,41,647,146,268,129,379,108,10631
15000US060530116023,379,93,0,12,0,12,0,12,379,93,78,72,301,82,10632
15000US060530116024,787,124,0,12,0,12,0,12,787,124,236,115,551,126,10633
15000US060530116041,983,105,0,12,0,12,0,12,983,105,275,80,708,101,10634
15000US060530117001,506,87,9,14,9,14,0,12,497,84,127,63,370,85,10635
15000US060530117002,639,88,0,12,0,12,0,12,639,88,140,66,499,84,10636
15000US060530117003,534,101,0,12,0,12,0,12,534,101,151,66,383,93,10637
15000US060530118011,655,132,25,40,0,12,25,40,630,126,162,64,468,119,10638
15000US060530118012,242,80,8,13,8,13,0,12,234,79,41,50,193,78,10639
15000US060530118021,330,91,9,13,0,12,9,13,321,92,64,59,257,78,10640
15000US060530118022,469,100,0,12,0,12,0,12,469,100,191,78,278,87,10641
15000US060530119001,411,72,0,12,0,12,0,12,411,72,138,63,273,57,10642
15000US060530119002,627,122,16,19,8,13,8,12,611,121,136,75,475,115,10643
15000US060530119003,281,57,0,12,0,12,0,12,281,57,49,44,232,56,10644
15000US060530119004,418,74,0,12,0,12,0,12,418,74,119,57,299,67,10645
15000US060530120001,797,93,34,35,22,32,12,19,763,88,202,76,561,95,10646
15000US060530120002,723,89,16,19,10,16,6,11,707,94,174,69,533,97,10647
15000US060530121001,415,44,5,8,0,12,5,8,410,46,56,25,354,49,10648
15000US060530121002,461,53,0,12,0,12,0,12,461,53,127,40,334,57,10649
15000US060530122001,266,60,11,18,0,12,11,18,255,62,33,28,222,67,10650
15000US060530122002,978,91,0,12,0,12,0,12,978,91,151,54,827,93,10651
15000US060530123021,941,73,23,18,8,12,15,15,918,74,138,55,780,80,10652
15000US060530124011,564,84,23,16,6,11,17,12,541,80,134,46,407,70,10653
15000US060530124012,266,51,5,8,5,8,0,12,261,52,44,34,217,47,10654
15000US060530124021,539,95,0,12,0,12,0,12,539,95,135,64,404,89,10655
15000US060530124022,284,70,44,57,0,12,44,57,240,59,22,24,218,61,10656
15000US060530124023,594,78,22,24,10,16,12,18,572,79,167,52,405,85,10657
15000US060530125021,684,133,39,44,39,44,0,12,645,140,34,40,611,144,10658
15000US060530125022,506,131,0,12,0,12,0,12,506,131,57,50,449,125,10659
15000US060530125023,477,98,12,19,0,12,12,19,465,103,96,56,369,103,10660
15000US060530125024,413,110,0,12,0,12,0,12,413,110,73,60,340,110,10661
15000US060530125025,284,107,0,12,0,12,0,12,284,107,40,48,244,98,10662
15000US060530126001,71,21,0,12,0,12,0,12,71,21,12,14,59,19,10663
15000US060530127001,449,100,57,54,10,16,47,51,392,104,83,71,309,100,10664
15000US060530127002,254,63,40,30,20,21,20,24,214,65,71,39,143,62,10665
15000US060530127003,444,94,0,12,0,12,0,12,444,94,96,57,348,95,10666
15000US060530127004,503,103,9,15,9,15,0,12,494,101,54,40,440,98,10667
15000US060530128001,490,98,0,12,0,12,0,12,490,98,133,72,357,106,10668
15000US060530128002,786,141,0,12,0,12,0,12,786,141,92,83,694,143,10669
15000US060530128003,382,86,19,29,0,12,19,29,363,87,16,26,347,90,10670
15000US060530128004,417,97,20,29,20,29,0,12,397,103,72,39,325,100,10671
15000US060530128005,297,88,0,12,0,12,0,12,297,88,60,71,237,67,10672
15000US060530130001,981,107,0,12,0,12,0,12,981,107,304,75,677,114,10673
15000US060530130002,335,67,30,27,9,13,21,24,305,70,19,19,286,72,10674
15000US060530130003,542,94,49,50,10,16,39,47,493,90,29,28,464,93,10675
15000US060530131001,519,65,0,12,0,12,0,12,519,65,6,9,513,65,10676
15000US060530132001,779,79,0,12,0,12,0,12,779,79,141,53,638,79,10677
15000US060530132002,920,83,24,34,0,12,24,34,896,83,153,62,743,107,10678
15000US060530133001,772,139,0,12,0,12,0,12,772,139,193,99,579,137,10679
15000US060530133002,577,112,0,12,0,12,0,12,577,112,156,71,421,109,10680
15000US060530133003,873,143,27,29,14,21,13,20,846,143,168,82,678,151,10681
15000US060530133004,347,120,0,12,0,12,0,12,347,120,42,39,305,124,10682
15000US060530134001,645,45,39,29,10,8,29,26,606,50,138,32,468,48,10683
15000US060530135001,429,96,47,36,32,34,15,19,382,96,138,52,244,94,10684
15000US060530135002,502,76,0,12,0,12,0,12,502,76,176,65,326,70,10685
15000US060530135003,795,108,55,41,55,41,0,12,740,118,180,64,560,123,10686
15000US060530136001,762,101,86,59,7,11,79,58,676,104,76,38,600,104,10687
15000US060530136002,572,92,36,43,8,14,28,40,536,88,129,57,407,88,10688
15000US060530137001,471,83,24,25,10,15,14,21,447,82,85,49,362,77,10689
15000US060530137002,587,84,65,54,34,39,31,31,522,84,99,56,423,96,10690
15000US060530137003,316,77,99,60,57,42,42,39,217,72,46,39,171,66,10691
15000US060530138001,453,79,9,15,9,15,0,12,444,82,95,44,349,85,10692
15000US060530138002,813,111,123,84,30,28,93,78,690,121,170,67,520,121,10693
15000US060530138003,379,81,25,29,16,24,9,16,354,82,107,47,247,85,10694
15000US060530139001,508,73,39,38,34,38,5,7,469,70,91,34,378,75,10695
15000US060530139002,403,61,93,57,37,45,56,42,310,57,100,38,210,62,10696
15000US060530140001,832,57,85,33,51,28,34,19,747,60,159,47,588,65,10697
15000US060530141021,620,77,96,54,49,33,47,37,524,85,148,62,376,81,10698
15000US060530141022,69,45,43,38,19,24,24,30,26,23,0,12,26,23,10699
15000US060530141041,0,12,0,12,0,12,0,12,0,12,0,12,0,12,10700
15000US060530141042,0,12,0,12,0,12,0,12,0,12,0,12,0,12,10701
15000US060530141043,0,12,0,12,0,12,0,12,0,12,0,12,0,12,10702
15000US060530141051,1187,114,98,65,15,22,83,61,1089,117,152,59,937,120,10703
15000US060530141071,968,165,77,72,18,29,59,67,891,169,198,93,693,180,10704
15000US060530141072,755,129,14,23,14,23,0,12,741,129,25,30,716,130,10705
15000US060530141073,679,124,54,48,39,42,15,25,625,117,107,75,518,123,10706
15000US060530142011,392,81,0,12,0,12,0,12,392,81,91,38,301,78,10707
15000US060530142012,508,94,8,13,8,13,0,12,500,94,148,77,352,89,10708
15000US060530142013,1054,109,77,44,16,19,61,43,977,114,389,115,588,116,10709
15000US060530142021,486,92,89,61,40,36,49,52,397,87,106,59,291,93,10710
15000US060530142022,1262,136,73,66,73,66,0,12,1189,146,346,108,843,145,10711
15000US060530143011,906,100,45,40,34,38,11,16,861,104,147,68,714,103,10712
15000US060530143012,498,71,15,15,6,9,9,16,483,68,214,58,269,72,10713
15000US060530143021,679,105,46,43,28,31,18,28,633,112,170,81,463,102,10714
15000US060530143022,1041,154,18,20,9,14,9,14,1023,153,188,70,835,174,10715
15000US060530145001,344,101,84,61,0,12,84,61,260,99,81,54,179,88,10716
15000US060530145002,760,94,28,25,11,16,17,18,732,97,96,45,636,96,10717
15000US060530145003,403,77,0,12,0,12,0,12,403,77,69,34,334,82,10718
15000US060530146011,426,84,38,36,0,12,38,36,388,77,63,34,325,74,10719
15000US060530146012,478,91,25,35,25,35,0,12,453,95,82,44,371,100,10720
15000US060530146013,351,80,38,32,6,9,32,32,313,85,88,66,225,81,10721
15000US060530147001,222,70,15,22,15,22,0,12,207,71,71,50,136,64,10722
15000US060530147002,632,95,12,20,0,12,12,20,620,97,201,87,419,108,10723
15000US060530147003,445,127,19,27,0,12,19,27,426,126,73,53,353,128,10724
15000US060530147004,701,135,0,12,0,12,0,12,701,135,287,124,414,138,10725
15000US060530148001,340,65,19,25,4,8,15,24,321,64,39,25,282,65,10726
15000US060530148002,235,49,6,10,0,12,6,10,229,48,31,23,198,46,10727
15000US060530148003,844,83,46,32,20,20,26,26,798,91,147,63,651,97,10728
15000US060539800001,4,8,0,12,0,12,0,12,4,8,0,12,4,8,10729
15000US060539900000,0,12,0,12,0,12,0,12,0,12,0,12,0,12,10730
15000US060552002011,450,89,8,12,0,12,8,12,442,89,113,46,329,85,10731
15000US060552002012,488,105,10,17,0,12,10,17,478,105,89,45,389,103,10732
15000US060552002013,370,75,21,30,21,30,0,12,349,69,43,26,306,73,10733
15000US060552002021,389,69,35,41,23,35,12,21,354,74,106,57,248,63,10734
15000US060552002022,170,49,13,20,0,12,13,20,157,53,19,17,138,52,10735
15000US060552002023,684,88,104,73,47,48,57,53,580,96,91,57,489,101,10736
15000US060552002031,405,65,13,13,6,8,7,10,392,64,72,27,320,62,10737
15000US060552002032,446,74,31,39,3,7,28,38,415,66,135,49,280,64,10738
15000US060552003011,602,94,107,77,83,84,24,27,495,86,118,57,377,78,10739
15000US060552003012,508,106,94,73,7,12,87,73,414,89,135,90,279,88,10740
15000US060552003013,620,121,69,62,4,7,65,62,551,117,173,64,378,106,10741
15000US060552003021,505,75,41,34,41,34,0,12,464,79,60,32,404,79,10742
15000US060552003022,431,73,32,28,13,20,19,19,399,71,125,45,274,64,10743
15000US060552004001,591,74,0,12,0,12,0,12,591,74,129,74,462,80,10744
15000US060552004002,529,72,6,9,0,12,6,9,523,73,122,54,401,74,10745
15000US060552004003,432,69,0,12,0,12,0,12,432,69,76,43,356,73,10746
15000US060552005011,507,114,56,54,9,16,47,52,451,108,92,55,359,99,10747
15000US060552005012,407,106,59,52,0,12,59,52,348,99,78,45,270,92,10748
15000US060552005013,737,124,64,65,0,12,64,65,673,125,68,44,605,121,10749
15000US060552005031,476,56,13,13,0,12,13,13,463,58,169,59,294,55,10750
15000US060552005032,202,45,15,13,10,11,5,7,187,46,15,13,172,45,10751
15000US060552005041,573,131,49,42,11,19,38,38,524,130,117,88,407,127,10752
15000US060552005042,1270,151,47,56,0,12,47,56,1223,160,259,101,964,161,10753
15000US060552005043,324,94,0,12,0,12,0,12,324,94,0,12,324,94,10754
15000US060552005051,667,83,35,36,14,22,21,29,632,86,83,44,549,92,10755
15000US060552005052,391,67,17,14,10,11,7,11,374,68,89,46,285,68,10756
15000US060552006011,477,67,9,14,0,12,9,14,468,69,138,57,330,74,10757
15000US060552006012,399,68,16,22,16,22,0,12,383,71,89,40,294,79,10758
15000US060552006013,411,87,29,25,19,19,10,16,382,90,76,55,306,76,10759
15000US060552006014,309,59,0,12,0,12,0,12,309,59,78,36,231,72,10760
15000US060552006021,1067,90,35,35,0,12,35,35,1032,97,299,79,733,116,10761
15000US060552006022,323,55,20,24,0,12,20,24,303,64,99,44,204,63,10762
15000US060552006023,377,75,19,32,19,32,0,12,358,70,54,37,304,73,10763
15000US060552007031,773,82,9,15,0,12,9,15,764,82,157,51,607,74,10764
15000US060552007032,284,64,0,12,0,12,0,12,284,64,85,56,199,54,10765
15000US060552007041,703,100,11,13,0,12,11,13,692,97,233,75,459,93,10766
15000US060552007042,518,73,74,59,60,57,14,20,444,63,94,54,350,69,10767
15000US060552007043,422,67,39,34,0,12,39,34,383,80,146,72,237,72,10768
15000US060552007051,613,60,15,13,4,7,11,11,598,60,187,53,411,66,10769
15000US060552007052,349,47,29,26,11,12,18,22,320,51,49,28,271,57,10770
15000US060552007061,372,51,8,12,0,12,8,12,364,54,44,34,320,56,10771
15000US060552007062,436,51,21,20,9,14,12,17,415,52,160,71,255,55,10772
15000US060552007063,329,56,0,12,0,12,0,12,329,56,68,46,261,61,10773
15000US060552007071,826,89,28,29,14,17,14,24,798,89,237,73,561,103,10774
15000US060552007072,461,87,21,23,21,23,0,12,440,88,56,37,384,94,10775
15000US060552008021,264,79,0,12,0,12,0,12,264,79,36,53,228,82,10776
15000US060552008022,499,122,0,12,0,12,0,12,499,122,75,56,424,118,10777
15000US060552008023,1436,160,10,16,0,12,10,16,1426,158,209,91,1217,157,10778
15000US060552008031,372,47,39,31,15,16,24,30,333,50,106,47,227,54,10779
15000US060552008032,477,41,0,12,0,12,0,12,477,41,72,30,405,44,10780
15000US060552008041,452,95,35,32,27,29,8,13,417,94,50,36,367,96,10781
15000US060552008042,528,123,62,59,9,14,53,59,466,118,145,60,321,114,10782
15000US060552008043,302,100,27,32,12,21,15,22,275,93,28,27,247,93,10783
15000US060552008044,421,97,32,31,8,15,24,28,389,97,67,49,322,108,10784
15000US060552009001,45,36,0,12,0,12,0,12,45,36,0,12,45,36,10785
15000US060552010031,326,82,18,21,9,14,9,15,308,83,111,62,197,90,10786
15000US060552010032,1114,109,59,51,26,42,33,31,1055,110,254,87,801,109,10787
15000US060552010041,1040,115,93,60,11,17,82,58,947,105,308,100,639,99,10788
15000US060552010042,919,102,72,64,0,12,72,64,847,101,265,94,582,101,10789
15000US060552010051,257,57,0,12,0,12,0,12,257,57,89,45,168,53,10790
15000US060552010052,379,60,34,33,0,12,34,33,345,58,82,39,263,53,10791
15000US060552010061,571,70,15,15,10,12,5,7,556,69,195,57,361,76,10792
15000US060552010062,341,56,19,14,5,8,14,12,322,57,88,35,234,55,10793
15000US060552010071,659,72,11,16,0,12,11,16,648,74,171,53,477,78,10794
15000US060552010072,431,75,43,31,30,22,13,21,388,74,112,41,276,75,10795
15000US060552011011,472,40,0,12,0,12,0,12,472,40,74,22,398,43,10796
15000US060552011012,322,40,0,12,0,12,0,12,322,40,57,33,265,46,10797
15000US060552011021,493,86,7,9,7,9,0,12,486,85,132,50,354,75,10798
15000US060552011022,263,55,2,4,0,12,2,4,261,55,41,24,220,60,10799
15000US060552012001,259,79,6,12,6,12,0,12,253,80,58,39,195,77,10800
15000US060552012002,416,67,37,28,37,28,0,12,379,70,143,49,236,69,10801
15000US060552012003,804,85,39,31,7,11,32,29,765,87,210,60,555,89,10802
15000US060552012004,489,76,0,12,0,12,0,12,489,76,100,46,389,77,10803
15000US060552013001,714,132,0,12,0,12,0,12,714,132,96,59,618,127,10804
15000US060552013002,658,97,22,35,0,12,22,35,636,88,237,59,399,82,10805
15000US060552013003,0,12,0,12,0,12,0,12,0,12,0,12,0,12,10806
15000US060552014011,416,82,0,12,0,12,0,12,416,82,102,61,314,80,10807
15000US060552014012,493,88,9,14,0,12,9,14,484,88,90,41,394,94,10808
15000US060552014013,348,65,19,22,11,19,8,13,329,63,46,29,283,66,10809
15000US060552014021,328,65,0,12,0,12,0,12,328,65,55,36,273,71,10810
15000US060552014022,327,62,10,16,10,16,0,12,317,58,82,44,235,56,10811
15000US060552014023,535,77,0,12,0,12,0,12,535,77,112,44,423,84,10812
15000US060552014031,153,38,9,10,0,12,9,10,144,36,10,11,134,36,10813
15000US060552014032,111,37,7,11,0,12,7,11,104,37,8,7,96,37,10814
15000US060552015001,484,70,30,28,11,11,19,29,454,70,79,25,375,71,10815
15000US060552015002,314,65,5,7,0,12,5,7,309,65,79,40,230,59,10816
15000US060552016011,450,72,0,12,0,12,0,12,450,72,113,36,337,67,10817
15000US060552016012,566,70,36,42,0,12,36,42,530,70,94,40,436,75,10818
15000US060552016021,489,95,0,12,0,12,0,12,489,95,87,40,402,101,10819
15000US060552016022,266,80,0,12,0,12,0,12,266,80,65,38,201,84,10820
15000US060552016023,143,45,0,12,0,12,0,12,143,45,0,12,143,45,10821
15000US060552016024,622,98,62,73,0,12,62,73,560,93,146,59,414,98,10822
15000US060552017001,259,53,0,12,0,12,0,12,259,53,12,10,247,53,10823
15000US060552017002,377,67,4,8,0,12,4,8,373,66,82,33,291,69,10824
15000US060552017003,312,56,0,12,0,12,0,12,312,56,56,29,256,59,10825
15000US060552017004,361,62,3,6,0,12,3,6,358,62,70,34,288,65,10826
15000US060552017005,237,63,6,11,6,11,0,12,231,63,84,55,147,54,10827
15000US060552017006,152,48,8,13,0,12,8,13,144,47,15,17,129,49,10828
15000US060552018001,353,52,14,13,2,4,12,13,339,52,83,30,256,49,10829
15000US060552018002,388,50,18,16,12,12,6,9,370,51,102,35,268,45,10830
15000US060552019001,282,63,6,9,6,9,0,12,276,63,56,22,220,63,10831
15000US060552019002,256,46,0,12,0,12,0,12,256,46,73,30,183,43,10832
15000US060552020001,535,149,0,12,0,12,0,12,535,149,295,128,240,132,10833
15000US060552020002,316,92,0,12,0,12,0,12,316,92,133,77,183,70,10834
15000US060552020003,581,121,0,12,0,12,0,12,581,121,161,79,420,121,10835
15000US060552020004,575,146,12,19,0,12,12,19,563,145,116,80,447,145,10836
15000US060570001021,628,107,0,12,0,12,0,12,628,107,161,67,467,133,10837
15000US060570001022,693,89,58,40,36,31,22,26,635,91,171,82,464,102,10838
15000US060570001023,822,116,0,12,0,12,0,12,822,116,217,80,605,127,10839
15000US060570001024,619,103,18,28,0,12,18,28,601,103,213,99,388,109,10840
15000US060570001031,347,96,0,12,0,12,0,12,347,96,78,55,269,91,10841
15000US060570001032,487,93,0,12,0,12,0,12,487,93,132,67,355,107,10842
15000US060570001033,299,103,23,34,23,34,0,12,276,101,60,49,216,101,10843
15000US060570001034,216,86,0,12,0,12,0,12,216,86,56,44,160,84,10844
15000US060570001035,637,115,0,12,0,12,0,12,637,115,200,99,437,109,10845
15000US060570001036,342,86,29,33,15,24,14,23,313,89,112,71,201,83,10846
15000US060570001037,678,107,15,24,0,12,15,24,663,108,158,76,505,136,10847
15000US060570001041,321,69,24,22,10,16,14,14,297,69,83,55,214,62,10848
15000US060570001042,752,84,45,32,15,16,30,27,707,81,328,77,379,83,10849
15000US060570001043,483,74,24,28,12,19,12,20,459,73,106,58,353,83,10850
15000US060570001051,311,71,24,24,17,20,7,13,287,69,92,44,195,70,10851
15000US060570001052,252,80,21,33,21,33,0,12,231,78,55,33,176,78,10852
15000US060570001053,536,79,28,24,28,24,0,12,508,78,107,49,401,76,10853
15000US060570002001,396,94,5,7,0,12,5,7,391,95,59,24,332,94,10854
15000US060570002002,473,72,22,21,16,20,6,9,451,65,87,39,364,63,10855
15000US060570003001,256,39,14,18,4,6,10,17,242,38,42,20,200,40,10856
15000US060570003002,706,50,74,41,64,40,10,10,632,54,115,35,517,60,10857
15000US060570004011,271,88,59,81,9,17,50,81,212,62,92,58,120,68,10858
15000US060570004012,767,139,53,72,0,12,53,72,714,141,58,48,656,142,10859
15000US060570004013,743,114,37,36,23,28,14,22,706,112,245,76,461,110,10860
15000US060570004014,778,137,0,12,0,12,0,12,778,137,248,93,530,124,10861
15000US060570004021,595,173,71,77,24,32,47,70,524,170,253,137,271,120,10862
15000US060570004022,689,170,25,38,25,38,0,12,664,171,218,139,446,147,10863
15000US060570004023,786,175,70,75,43,65,27,31,716,174,292,145,424,163,10864
15000US060570004024,355,95,8,16,0,12,8,16,347,97,65,49,282,97,10865
15000US060570005011,519,153,45,43,9,19,36,38,474,152,146,87,328,139,10866
15000US060570005012,890,163,166,101,104,76,62,77,724,187,467,172,257,115,10867
15000US060570005013,546,111,0,12,0,12,0,12,546,111,78,58,468,111,10868
15000US060570005014,537,128,75,56,30,37,45,45,462,126,219,105,243,112,10869
15000US060570005015,216,82,98,70,54,51,44,53,118,63,25,30,93,59,10870
15000US060570005021,337,128,35,44,25,41,10,16,302,124,169,106,133,71,10871
15000US060570005022,573,110,107,85,55,65,52,66,466,103,99,71,367,114,10872
15000US060570005023,664,117,68,59,33,38,35,48,596,114,215,77,381,121,10873
15000US060570005024,504,111,115,115,115,115,0,12,389,107,225,94,164,87,10874
15000US060570006001,694,142,182,95,93,80,89,66,512,137,307,132,205,100,10875
15000US060570006002,558,162,176,114,138,106,38,43,382,147,80,55,302,143,10876
15000US060570006003,710,122,18,23,18,23,0,12,692,121,189,84,503,98,10877
15000US060570006004,354,123,49,47,37,45,12,13,305,115,39,38,266,106,10878
15000US060570006005,722,139,93,61,0,12,93,61,629,125,323,128,306,109,10879
15000US060570007011,347,131,43,48,19,31,24,36,304,122,76,59,228,117,10880
15000US060570007012,727,125,24,29,0,12,24,29,703,129,158,85,545,117,10881
15000US060570007013,434,113,0,12,0,12,0,12,434,113,149,99,285,87,10882
15000US060570007014,316,95,15,23,15,23,0,12,301,91,72,42,229,97,10883
15000US060570007015,658,103,21,32,21,32,0,12,637,112,196,84,441,110,10884
15000US060570007016,602,118,6,10,0,12,6,10,596,119,191,94,405,93,10885
15000US060570007021,906,81,37,26,4,6,33,25,869,84,165,59,704,88,10886
15000US060570007022,715,91,54,32,19,19,35,29,661,87,241,81,420,75,10887
15000US060570008011,615,118,100,73,0,12,100,73,515,112,106,54,409,127,10888
15000US060570008012,720,131,68,90,51,84,17,28,652,122,150,78,502,124,10889
15000US060570008013,821,112,16,24,16,24,0,12,805,106,124,64,681,116,10890
15000US060570008021,528,134,0,12,0,12,0,12,528,134,17,29,511,134,10891
15000US060570008022,947,149,87,64,14,23,73,54,860,156,198,119,662,152,10892
15000US060570008023,384,103,0,12,0,12,0,12,384,103,40,39,344,116,10893
15000US060570008024,1002,132,18,28,0,12,18,28,984,136,220,124,764,137,10894
15000US060570009001,501,83,26,17,5,7,21,16,475,83,95,53,380,71,10895
15000US060570009002,799,123,50,39,10,11,40,37,749,125,241,74,508,109,10896
15000US060570009003,273,97,0,12,0,12,0,12,273,97,90,66,183,76,10897
15000US060570012031,379,143,0,12,0,12,0,12,379,143,33,31,346,145,10898
15000US060570012032,311,106,29,46,29,46,0,12,282,102,34,28,248,105,10899
15000US060570012033,356,100,0,12,0,12,0,12,356,100,30,29,326,91,10900
15000US060570012041,391,135,0,12,0,12,0,12,391,135,35,26,356,133,10901
15000US060570012042,481,157,0,12,0,12,0,12,481,157,73,44,408,143,10902
15000US060570012043,322,115,0,12,0,12,0,12,322,115,58,64,264,99,10903
15000US060570012051,777,143,8,13,0,12,8,13,769,142,111,59,658,135,10904
15000US060570012052,778,117,29,36,9,15,20,32,749,114,110,50,639,112,10905
15000US060570012053,190,74,0,12,0,12,0,12,190,74,9,13,181,73,10906
15000US060570012061,290,153,0,12,0,12,0,12,290,153,119,106,171,123,10907
15000US060570012062,439,158,0,12,0,12,0,12,439,158,0,12,439,158,10908
15000US060570012063,662,137,0,12,0,12,0,12,662,137,135,80,527,151,10909
15000US060570012064,337,123,23,35,0,12,23,35,314,119,51,56,263,117,10910
15000US060570012065,517,183,57,56,0,12,57,56,460,175,26,40,434,173,10911
15000US060590011011,505,86,41,29,8,14,33,24,464,92,134,64,330,80,10912
15000US060590011012,285,74,10,14,0,12,10,14,275,73,77,59,198,58,10913
15000US060590011013,411,72,0,12,0,12,0,12,411,72,90,43,321,85,10914
15000US060590011014,254,54,0,12,0,12,0,12,254,54,60,39,194,51,10915
15000US060590011021,386,60,57,55,9,14,48,52,329,71,78,43,251,73,10916
15000US060590011022,296,56,17,20,0,12,17,20,279,56,70,35,209,59,10917
15000US060590011023,348,57,0,12,0,12,0,12,348,57,30,28,318,58,10918
15000US060590011031,486,110,148,93,36,53,112,81,338,89,71,58,267,83,10919
15000US060590011032,590,109,34,40,0,12,34,40,556,113,136,76,420,104,10920
15000US060590011033,340,84,22,22,0,12,22,22,318,84,64,46,254,82,10921
15000US060590012011,479,101,43,49,19,29,24,39,436,87,133,63,303,92,10922
15000US060590012012,468,88,138,66,0,12,138,66,330,87,57,37,273,84,10923
15000US060590012013,467,102,55,45,6,10,49,44,412,100,170,73,242,83,10924
15000US060590012021,377,54,21,16,0,12,21,16,356,55,78,40,278,57,10925
15000US060590012022,262,43,16,17,5,9,11,14,246,44,93,41,153,46,10926
15000US060590012023,296,58,59,47,42,41,17,27,237,59,64,34,173,54,10927
15000US060590013011,519,87,15,23,0,12,15,23,504,88,78,63,426,83,10928
15000US060590013012,272,59,0,12,0,12,0,12,272,59,55,39,217,66,10929
15000US060590013013,353,74,0,12,0,12,0,12,353,74,104,46,249,76,10930
15000US060590013014,466,121,56,68,0,12,56,68,410,121,139,90,271,98,10931
15000US060590013015,1000,126,0,12,0,12,0,12,1000,126,45,40,955,134,10932
15000US060590013031,732,77,91,38,16,17,75,36,641,82,43,27,598,87,10933
15000US060590013032,704,96,40,27,24,22,16,19,664,93,80,51,584,104,10934
15000US060590013033,387,79,23,25,9,14,14,21,364,78,130,57,234,87,10935
15000US060590013041,182,50,28,41,0,12,28,41,154,46,50,28,104,41,10936
15000US060590013042,865,88,98,63,50,42,48,44,767,89,292,82,475,100,10937
15000US060590014011,453,102,71,60,37,41,34,43,382,78,36,29,346,83,10938
15000US060590014012,301,58,10,15,10,15,0,12,291,60,113,48,178,58,10939
15000US060590014013,346,83,39,32,27,30,12,18,307,77,100,68,207,61,10940
15000US060590014014,595,118,40,54,32,52,8,13,555,109,207,85,348,95,10941
15000US060590014021,1096,73,200,97,71,64,129,86,896,115,209,90,687,104,10942
15000US060590014022,447,71,9,15,9,15,0,12,438,69,107,47,331,76,10943
15000US060590014031,470,79,12,14,12,14,0,12,458,81,118,58,340,86,10944
15000US060590014032,609,77,5,10,0,12,5,10,604,80,200,84,404,90,10945
15000US060590014041,353,50,31,30,0,12,31,30,322,47,64,38,258,52,10946
15000US060590014042,255,60,28,35,8,12,20,33,227,62,90,50,137,62,10947
15000US060590014043,383,68,149,66,74,58,75,57,234,56,51,29,183,55,10948
15000US060590015011,892,111,75,83,41,60,34,55,817,98,237,87,580,111,10949
15000US060590015012,786,125,10,17,10,17,0,12,776,125,87,80,689,118,10950
15000US060590015013,662,100,0,12,0,12,0,12,662,100,181,104,481,108,10951
15000US060590015031,675,89,34,38,8,12,26,37,641,89,76,38,565,85,10952
15000US060590015032,315,62,0,12,0,12,0,12,315,62,76,35,239,67,10953
15000US060590015033,507,92,48,46,0,12,48,46,459,99,52,31,407,97,10954
15000US060590015034,302,47,0,12,0,12,0,12,302,47,79,41,223,49,10955
15000US060590015041,373,79,0,12,0,12,0,12,373,79,91,58,282,95,10956
15000US060590015042,448,98,14,21,14,21,0,12,434,97,59,34,375,100,10957
15000US060590015043,400,93,25,31,8,13,17,27,375,93,88,46,287,83,10958
15000US060590015044,520,94,19,21,11,17,8,12,501,95,119,60,382,90,10959
15000US060590015051,411,96,17,27,17,27,0,12,394,96,74,49,320,112,10960
15000US060590015052,980,111,23,38,0,12,23,38,957,117,84,64,873,128,10961
15000US060590015053,635,92,19,31,0,12,19,31,616,95,93,56,523,104,10962
15000US060590015054,357,113,0,12,0,12,0,12,357,113,113,60,244,113,10963
15000US060590015061,843,97,58,41,16,17,42,36,785,102,138,57,647,102,10964
15000US060590015062,778,102,0,12,0,12,0,12,778,102,124,56,654,105,10965
15000US060590015071,767,106,40,26,26,21,14,17,727,112,82,57,645,103,10966
15000US060590015072,345,89,9,17,0,12,9,17,336,92,12,14,324,95,10967
15000US060590015073,728,80,0,12,0,12,0,12,728,80,87,51,641,88,10968
15000US060590016011,246,72,90,62,16,25,74,57,156,62,71,51,85,49,10969
15000US060590016012,313,83,0,12,0,12,0,12,313,83,84,50,229,94,10970
15000US060590016013,263,93,0,12,0,12,0,12,263,93,83,40,180,99,10971
15000US060590016014,242,85,0,12,0,12,0,12,242,85,38,35,204,83,10972
15000US060590016015,1099,165,11,19,11,19,0,12,1088,170,294,94,794,169,10973
15000US060590016016,523,82,0,12,0,12,0,12,523,82,44,40,479,88,10974
15000US060590016021,320,60,0,12,0,12,0,12,320,60,100,41,220,60,10975
15000US060590016022,353,52,0,12,0,12,0,12,353,52,128,47,225,55,10976
15000US060590016023,316,48,0,12,0,12,0,12,316,48,80,39,236,54,10977
15000US060590016024,537,62,0,12,0,12,0,12,537,62,48,30,489,65,10978
15000US060590016025,256,59,0,12,0,12,0,12,256,59,53,38,203,64,10979
15000US060590017041,1373,123,0,12,0,12,0,12,1373,123,102,70,1271,146,10980
15000US060590017042,470,114,18,30,0,12,18,30,452,114,194,96,258,103,10981
15000US060590017043,588,115,0,12,0,12,0,12,588,115,52,45,536,121,10982
15000US060590017051,752,88,69,56,10,15,59,53,683,89,105,44,578,89,10983
15000US060590017052,296,55,67,35,19,30,48,47,229,45,70,31,159,45,10984
15000US060590017053,350,50,0,12,0,12,0,12,350,50,153,53,197,50,10985
15000US060590017061,371,72,0,12,0,12,0,12,371,72,113,46,258,79,10986
15000US060590017062,331,67,0,12,0,12,0,12,331,67,128,57,203,61,10987
15000US060590017063,366,67,0,12,0,12,0,12,366,67,123,50,243,75,10988
15000US060590017064,266,52,0,12,0,12,0,12,266,52,68,52,198,53,10989
15000US060590017071,818,125,0,12,0,12,0,12,818,125,71,58,747,131,10990
15000US060590017072,589,122,61,74,48,69,13,21,528,111,11,20,517,112,10991
15000US060590017073,516,121,15,22,15,22,0,12,501,124,129,92,372,107,10992
15000US060590017074,542,104,0,12,0,12,0,12,542,104,123,57,419,106,10993
15000US060590017081,398,60,13,16,13,16,0,12,385,59,33,31,352,58,10994
15000US060590017082,345,67,0,12,0,12,0,12,345,67,104,44,241,61,10995
15000US060590017083,463,68,8,14,8,14,0,12,455,69,106,48,349,67,10996
15000US060590018011,587,111,139,86,66,69,73,54,448,112,39,32,409,111,10997
15000US060590018012,316,93,168,87,50,55,118,76,148,63,41,40,107,52,10998
15000US060590018013,272,74,37,45,0,12,37,45,235,72,77,68,158,66,10999
15000US060590018014,322,90,42,52,7,12,35,51,280,93,19,27,261,92,11000
15000US060590018021,399,131,24,32,0,12,24,32,375,140,70,63,305,139,11001
15000US060590018022,418,133,21,24,0,12,21,24,397,133,75,57,322,127,11002
15000US060590018023,497,130,41,54,0,12,41,54,456,126,183,108,273,114,11003
15000US060590018024,326,130,93,85,0,12,93,85,233,108,71,61,162,91,11004
15000US060590018025,474,136,154,91,54,53,100,78,320,154,121,101,199,135,11005
15000US060590019011,433,54,15,15,7,10,8,11,418,56,58,24,360,62,11006
15000US060590019012,366,51,14,13,12,12,2,4,352,52,61,33,291,60,11007
15000US060590019021,375,56,15,14,10,11,5,8,360,59,96,32,264,64,11008
15000US060590019022,390,48,8,10,5,8,3,6,382,50,50,26,332,55,11009
15000US060590019031,440,55,50,24,0,12,50,24,390,58,114,42,276,62,11010
15000US060590019032,440,60,47,34,5,7,42,33,393,63,83,39,310,66,11011
15000US060590110001,463,112,47,38,18,28,29,25,416,118,60,41,356,118,11012
15000US060590110002,369,114,0,12,0,12,0,12,369,114,83,74,286,117,11013
15000US060590110003,256,74,0,12,0,12,0,12,256,74,110,51,146,74,11014
15000US060590110004,533,108,60,90,0,12,60,90,473,90,100,50,373,97,11015
15000US060590110005,328,112,52,71,0,12,52,71,276,85,28,32,248,86,11016
15000US060590110006,492,117,0,12,0,12,0,12,492,117,131,66,361,125,11017
15000US060590111011,873,109,165,85,40,43,125,75,708,121,118,57,590,129,11018
15000US060590111012,421,92,36,40,17,23,19,31,385,100,66,44,319,97,11019
15000US060590111021,331,64,19,21,9,13,10,15,312,67,107,53,205,64,11020
15000US060590111022,299,70,0,12,0,12,0,12,299,70,75,43,224,71,11021
15000US060590111023,542,93,75,45,20,25,55,45,467,95,90,52,377,95,11022
15000US060590112001,540,103,7,12,7,12,0,12,533,103,233,93,300,81,11023
15000US060590112002,316,66,0,12,0,12,0,12,316,66,51,33,265,64,11024
15000US060590112003,242,58,9,14,9,14,0,12,233,60,32,24,201,57,11025
15000US060590112004,428,91,90,65,50,48,40,43,338,84,66,32,272,84,11026
15000US060590113001,1022,159,75,80,30,36,45,72,947,162,216,114,731,144,11027
15000US060590113002,488,118,21,35,0,12,21,35,467,121,22,32,445,119,11028
15000US060590113003,469,129,25,47,25,47,0,12,444,129,41,41,403,132,11029
15000US060590114011,259,45,21,19,10,15,11,12,238,44,17,15,221,44,11030
15000US060590114012,475,42,5,7,0,12,5,7,470,44,113,34,357,50,11031
15000US060590114021,348,43,4,6,0,12,4,6,344,44,84,33,260,47,11032
15000US060590114022,445,44,0,12,0,12,0,12,445,44,126,43,319,52,11033
15000US060590114031,187,53,8,14,0,12,8,14,179,51,35,21,144,56,11034
15000US060590114032,275,64,18,20,10,16,8,13,257,65,116,73,141,71,11035
15000US060590114033,688,118,26,26,15,20,11,18,662,120,172,90,490,112,11036
15000US060590114034,288,76,67,52,0,12,67,52,221,72,31,22,190,72,11037
15000US060590114035,464,89,64,55,14,17,50,52,400,82,50,41,350,81,11038
15000US060590115021,375,70,48,40,6,12,42,38,327,75,46,39,281,71,11039
15000US060590115022,522,71,58,40,24,30,34,30,464,73,51,30,413,73,11040
15000US060590115023,456,75,29,27,0,12,29,27,427,74,124,51,303,58,11041
15000US060590115031,273,34,0,12,0,12,0,12,273,34,69,27,204,36,11042
15000US060590115032,249,30,18,22,4,7,14,21,231,33,62,35,169,38,11043
15000US060590115041,332,100,35,39,35,39,0,12,297,96,20,24,277,99,11044
15000US060590115042,241,73,0,12,0,12,0,12,241,73,16,24,225,72,11045
15000US060590115043,483,103,29,36,15,25,14,23,454,109,13,22,441,109,11046
15000US060590115044,592,110,9,17,0,12,9,17,583,109,41,48,542,117,11047
15000US060590115045,385,109,26,30,13,20,13,22,359,110,13,21,346,109,11048
15000US060590116011,280,75,37,47,0,12,37,47,243,83,50,39,193,92,11049
15000US060590116012,623,117,180,79,0,12,180,79,443,114,56,69,387,118,11050
15000US060590116013,300,110,0,12,0,12,0,12,300,110,0,12,300,110,11051
15000US060590116014,327,121,16,24,0,12,16,24,311,126,18,24,293,127,11052
15000US060590116015,315,123,88,86,51,59,37,61,227,93,32,36,195,91,11053
15000US060590116016,419,145,51,61,0,12,51,61,368,138,24,41,344,131,11054
15000US060590116021,437,114,111,65,32,40,79,53,326,98,73,65,253,92,11055
15000US060590116022,728,117,114,89,0,12,114,89,614,123,256,89,358,111,11056
15000US060590116023,311,67,38,40,38,40,0,12,273,71,102,55,171,61,11057
15000US060590117071,1260,141,17,27,17,27,0,12,1243,147,288,99,955,166,11058
15000US060590117072,349,84,0,12,0,12,0,12,349,84,57,36,292,83,11059
15000US060590117073,806,125,17,22,0,12,17,22,789,130,48,44,741,142,11060
15000US060590117081,603,101,44,28,17,18,27,25,559,101,34,22,525,100,11061
15000US060590117082,628,105,35,41,35,41,0,12,593,107,29,38,564,107,11062
15000US060590117083,338,45,0,12,0,12,0,12,338,45,79,32,259,51,11063
15000US060590117091,450,57,28,23,10,16,18,21,422,58,45,32,377,64,11064
15000US060590117092,399,64,0,12,0,12,0,12,399,64,61,33,338,74,11065
15000US060590117093,606,67,0,12,0,12,0,12,606,67,109,49,497,74,11066
15000US060590117101,400,65,6,12,0,12,6,12,394,64,111,47,283,66,11067
15000US060590117102,808,63,17,20,8,13,9,13,791,63,141,60,650,83,11068
15000US060590117111,464,92,14,22,0,12,14,22,450,92,169,68,281,81,11069
15000US060590117112,756,136,65,83,0,12,65,83,691,129,60,44,631,125,11070
15000US060590117113,464,116,37,42,0,12,37,42,427,116,70,69,357,124,11071
15000US060590117114,381,103,49,60,32,50,17,33,332,91,13,22,319,89,11072
15000US060590117115,562,142,113,113,0,12,113,113,449,135,81,68,368,146,11073
15000US060590117121,341,77,20,26,20,26,0,12,321,79,59,40,262,84,11074
15000US060590117122,596,94,21,23,11,16,10,17,575,96,62,35,513,103,11075
15000US060590117123,629,86,12,17,12,17,0,12,617,86,59,38,558,94,11076
15000US060590117141,383,20,18,13,12,14,6,8,365,22,22,15,343,27,11077
15000US060590117151,577,97,21,33,0,12,21,33,556,98,108,54,448,110,11078
15000US060590117152,1297,119,19,29,19,29,0,12,1278,126,424,119,854,154,11079
15000US060590117153,485,89,0,12,0,12,0,12,485,89,70,41,415,90,11080
15000US060590117161,597,76,35,44,0,12,35,44,562,71,99,44,463,81,11081
15000US060590117162,1016,82,0,12,0,12,0,12,1016,82,132,54,884,105,11082
15000US060590117171,777,55,20,17,7,10,13,13,757,57,122,38,635,60,11083
15000US060590117172,275,44,4,7,0,12,4,7,271,46,65,25,206,48,11084
15000US060590117181,464,65,8,13,0,12,8,13,456,64,105,54,351,70,11085
15000US060590117182,615,72,9,15,0,12,9,15,606,74,111,45,495,83,11086
15000US060590117201,498,77,236,71,49,41,187,66,262,72,45,32,217,73,11087
15000US060590117202,620,87,219,83,86,49,133,73,401,76,122,49,279,81,11088
15000US060590117203,332,71,142,63,51,39,91,52,190,67,15,25,175,64,11089
15000US060590117211,376,82,105,55,0,12,105,55,271,82,73,43,198,75,11090
15000US060590117212,475,89,89,50,0,12,89,50,386,91,91,50,295,85,11091
15000US060590117213,676,88,53,44,8,11,45,43,623,90,51,38,572,91,11092
15000US060590117221,367,76,5,9,5,9,0,12,362,76,104,51,258,88,11093
15000US060590117222,379,51,62,45,35,43,27,24,317,55,170,39,147,55,11094
15000US060590117223,240,70,38,33,38,33,0,12,202,79,59,35,143,71,11095
15000US060590218021,703,141,31,36,18,28,13,21,672,145,285,122,387,143,11096
15000US060590218022,369,81,39,58,0,12,39,58,330,86,13,22,317,86,11097
15000US060590218023,471,98,66,70,18,28,48,69,405,90,74,41,331,92,11098
15000US060590218024,355,81,68,55,0,12,68,55,287,73,108,61,179,67,11099
15000US060590218025,632,129,0,12,0,12,0,12,632,129,157,97,475,131,11100
15000US060590218071,676,70,67,46,23,24,44,36,609,81,144,77,465,92,11101
15000US060590218072,653,62,11,17,11,17,0,12,642,64,152,62,490,73,11102
15000US060590218091,640,52,6,9,6,9,0,12,634,53,107,48,527,57,11103
15000US060590218092,403,50,9,13,9,13,0,12,394,48,147,49,247,55,11104
15000US060590218101,347,55,0,12,0,12,0,12,347,55,149,65,198,62,11105
15000US060590218102,530,57,13,20,0,12,13,20,517,60,117,46,400,69,11106
15000US060590218103,296,56,0,12,0,12,0,12,296,56,28,18,268,56,11107
15000US060590218121,227,82,0,12,0,12,0,12,227,82,21,27,206,82,11108
15000US060590218122,732,116,0,12,0,12,0,12,732,116,147,87,585,125,11109
15000US060590218123,411,111,0,12,0,12,0,12,411,111,39,46,372,112,11110
15000US060590218124,680,154,59,95,59,95,0,12,621,136,73,49,548,134,11111
15000US060590218131,37,38,0,12,0,12,0,12,37,38,0,12,37,38,11112
15000US060590218141,678,115,16,26,0,12,16,26,662,117,198,114,464,95,11113
15000US060590218142,1176,137,12,19,0,12,12,19,1164,144,208,129,956,180,11114
15000US060590218143,346,93,0,12,0,12,0,12,346,93,51,40,295,98,11115
15000US060590218144,384,70,12,19,0,12,12,19,372,72,73,49,299,82,11116
15000US060590218151,1000,148,49,59,14,22,35,54,951,153,147,94,804,148,11117
15000US060590218152,266,94,0,12,0,12,0,12,266,94,29,33,237,96,11118
15000US060590218153,1499,143,17,25,0,12,17,25,1482,149,165,81,1317,175,11119
15000US060590218161,416,80,0,12,0,12,0,12,416,80,81,36,335,86,11120
15000US060590218162,632,81,0,12,0,12,0,12,632,81,95,48,537,85,11121
15000US060590218163,720,100,27,26,13,19,14,16,693,103,182,71,511,105,11122
15000US060590218171,1022,70,49,44,29,30,20,31,973,81,171,55,802,92,11123
15000US060590218172,228,58,0,12,0,12,0,12,228,58,34,24,194,61,11124
15000US060590218201,343,63,5,8,0,12,5,8,338,62,113,43,225,61,11125
15000US060590218202,1082,63,0,12,0,12,0,12,1082,63,193,71,889,79,11126
15000US060590218211,790,142,42,63,42,63,0,12,748,146,181,95,567,164,11127
15000US060590218212,996,170,17,28,17,28,0,12,979,176,150,117,829,167,11128
15000US060590218213,636,148,49,76,0,12,49,76,587,146,49,45,538,143,11129
15000US060590218221,372,71,0,12,0,12,0,12,372,71,29,32,343,78,11130
15000US060590218222,1177,173,0,12,0,12,0,12,1177,173,186,79,991,185,11131
15000US060590218223,494,78,0,12,0,12,0,12,494,78,32,37,462,84,11132
15000US060590218224,721,128,41,60,0,12,41,60,680,134,95,56,585,138,11133
15000US060590218231,1155,48,16,19,0,12,16,19,1139,52,201,69,938,79,11134
15000US060590218241,375,36,0,12,0,12,0,12,375,36,89,42,286,50,11135
15000US060590218242,478,39,0,12,0,12,0,12,478,39,77,33,401,49,11136
15000US060590218251,635,75,0,12,0,12,0,12,635,75,80,45,555,77,11137
15000US060590218252,441,65,0,12,0,12,0,12,441,65,58,36,383,73,11138
15000US060590218261,610,76,15,23,0,12,15,23,595,75,89,45,506,82,11139
15000US060590218262,404,76,0,12,0,12,0,12,404,76,56,36,348,82,11140
15000US060590218271,497,74,0,12,0,12,0,12,497,74,125,57,372,72,11141
15000US060590218272,547,63,34,26,0,12,34,26,513,68,47,37,466,70,11142
15000US060590218281,363,68,0,12,0,12,0,12,363,68,33,23,330,70,11143
15000US060590218282,415,70,0,12,0,12,0,12,415,70,46,42,369,73,11144
15000US060590218283,561,62,0,12,0,12,0,12,561,62,108,51,453,73,11145
15000US060590218291,676,74,9,13,9,13,0,12,667,75,106,47,561,86,11146
15000US060590218292,454,65,0,12,0,12,0,12,454,65,115,48,339,74,11147
15000US060590218293,583,67,0,12,0,12,0,12,583,67,123,50,460,81,11148
15000US060590218301,312,67,39,60,0,12,39,60,273,67,62,40,211,66,11149
15000US060590218302,469,94,0,12,0,12,0,12,469,94,47,43,422,109,11150
15000US060590218303,643,105,14,24,0,12,14,24,629,105,144,74,485,121,11151
15000US060590218304,499,103,0,12,0,12,0,12,499,103,121,76,378,104,11152
15000US060590219031,423,74,32,44,32,44,0,12,391,70,19,21,372,73,11153
15000US060590219032,325,66,0,12,0,12,0,12,325,66,32,23,293,65,11154
15000US060590219033,419,83,11,14,6,9,5,10,408,86,115,49,293,98,11155
15000US060590219051,666,82,52,47,0,12,52,47,614,91,123,64,491,97,11156
15000US060590219052,683,84,20,22,0,12,20,22,663,87,79,40,584,86,11157
15000US060590219053,415,73,10,15,10,15,0,12,405,72,27,26,378,71,11158
15000US060590219121,558,65,0,12,0,12,0,12,558,65,73,39,485,69,11159
15000US060590219122,518,60,0,12,0,12,0,12,518,60,106,52,412,65,11160
15000US060590219123,379,60,0,12,0,12,0,12,379,60,83,49,296,62,11161
15000US060590219131,244,54,0,12,0,12,0,12,244,54,11,17,233,59,11162
15000US060590219132,459,76,35,31,18,21,17,26,424,74,48,32,376,84,11163
15000US060590219133,526,93,10,15,10,15,0,12,516,93,77,41,439,92,11164
15000US060590219134,682,92,122,60,55,53,67,38,560,101,121,57,439,100,11165
15000US060590219141,900,102,64,57,0,12,64,57,836,109,164,66,672,119,11166
15000US060590219142,443,76,12,21,4,11,8,15,431,76,87,45,344,79,11167
15000US060590219151,640,73,0,12,0,12,0,12,640,73,167,55,473,79,11168
15000US060590219152,766,75,0,12,0,12,0,12,766,75,150,64,616,83,11169
15000US060590219161,663,82,0,12,0,12,0,12,663,82,168,72,495,83,11170
15000US060590219162,668,71,0,12,0,12,0,12,668,71,130,70,538,71,11171
15000US060590219171,580,71,14,21,14,21,0,12,566,73,65,55,501,81,11172
15000US060590219172,297,57,0,12,0,12,0,12,297,57,87,41,210,64,11173
15000US060590219173,319,59,0,12,0,12,0,12,319,59,73,41,246,75,11174
15000US060590219181,522,78,0,12,0,12,0,12,522,78,136,68,386,90,11175
15000US060590219182,951,90,0,12,0,12,0,12,951,90,129,55,822,108,11176
15000US060590219183,271,47,19,20,19,20,0,12,252,50,68,34,184,57,11177
15000US060590219191,478,54,0,12,0,12,0,12,478,54,79,29,399,56,11178
15000US060590219192,447,60,25,26,9,10,16,25,422,61,72,27,350,65,11179
15000US060590219201,252,92,26,42,0,12,26,42,226,92,47,43,179,80,11180
15000US060590219202,487,99,16,25,16,25,0,12,471,98,106,84,365,114,11181
15000US060590219203,382,75,0,12,0,12,0,12,382,75,118,65,264,83,11182
15000US060590219204,1341,131,0,12,0,12,0,12,1341,131,288,99,1053,140,11183
15000US060590219211,329,70,0,12,0,12,0,12,329,70,50,32,279,73,11184
15000US060590219212,1088,68,0,12,0,12,0,12,1088,68,65,44,1023,75,11185
15000US060590219221,808,122,0,12,0,12,0,12,808,122,126,63,682,142,11186
15000US060590219222,361,109,0,12,0,12,0,12,361,109,25,29,336,105,11187
15000US060590219223,316,101,0,12,0,12,0,12,316,101,41,39,275,101,11188
15000US060590219224,735,123,0,12,0,12,0,12,735,123,64,49,671,122,11189
15000US060590219231,990,137,0,12,0,12,0,12,990,137,65,48,925,135,11190
15000US060590219232,473,95,42,48,16,27,26,41,431,93,17,26,414,93,11191
15000US060590219233,586,102,0,12,0,12,0,12,586,102,113,81,473,113,11192
15000US060590219234,312,95,0,12,0,12,0,12,312,95,44,34,268,100,11193
15000US060590219241,0,12,0,12,0,12,0,12,0,12,0,12,0,12,11194
15000US060590219242,385,76,0,12,0,12,0,12,385,76,51,38,334,79,11195
15000US060590219243,1013,78,12,20,0,12,12,20,1001,83,113,47,888,90,11196
15000US060590320021,275,62,0,12,0,12,0,12,275,62,72,46,203,80,11197
15000US060590320022,576,107,15,25,15,25,0,12,561,112,129,78,432,121,11198
15000US060590320023,813,135,0,12,0,12,0,12,813,135,141,92,672,153,11199
15000US060590320024,436,109,0,12,0,12,0,12,436,109,73,53,363,113,11200
15000US060590320031,559,81,8,13,0,12,8,13,551,81,133,57,418,72,11201
15000US060590320032,475,81,20,21,0,12,20,21,455,83,134,62,321,81,11202
15000US060590320033,477,78,0,12,0,12,0,12,477,78,70,36,407,87,11203
15000US060590320111,399,59,17,28,0,12,17,28,382,61,87,48,295,62,11204
15000US060590320112,274,52,0,12,0,12,0,12,274,52,33,25,241,52,11205
15000US060590320121,508,58,9,14,9,14,0,12,499,59,81,48,418,65,11206
15000US060590320122,491,63,0,12,0,12,0,12,491,63,58,37,433,63,11207
15000US060590320123,287,76,10,15,0,12,10,15,277,76,41,31,236,76,11208
15000US060590320131,1071,160,0,12,0,12,0,12,1071,160,182,88,889,167,11209
15000US060590320132,440,119,0,12,0,12,0,12,440,119,172,72,268,129,11210
15000US060590320133,527,125,0,12,0,12,0,12,527,125,273,95,254,110,11211
15000US060590320141,844,97,17,20,9,14,8,15,827,99,203,54,624,102,11212
15000US060590320142,1132,110,43,32,34,25,9,14,1089,116,369,89,720,123,11213
15000US060590320151,583,80,0,12,0,12,0,12,583,80,177,63,406,76,11214
15000US060590320152,465,78,9,15,0,12,9,15,456,77,144,72,312,69,11215
15000US060590320153,403,84,0,12,0,12,0,12,403,84,153,70,250,68,11216
15000US060590320154,455,67,19,23,19,23,0,12,436,71,100,49,336,75,11217
15000US060590320201,703,73,0,12,0,12,0,12,703,73,98,59,605,78,11218
15000US060590320202,796,78,11,18,11,18,0,12,785,75,114,52,671,88,11219
15000US060590320203,389,80,0,12,0,12,0,12,389,80,64,51,325,81,11220
15000US060590320221,724,112,14,23,0,12,14,23,710,117,64,54,646,132,11221
15000US060590320222,636,148,0,12,0,12,0,12,636,148,44,41,592,149,11222
15000US060590320223,935,175,99,84,81,82,18,30,836,183,197,110,639,193,11223
15000US060590320231,2550,225,68,84,0,17,68,84,2482,219,116,99,2366,210,11224
15000US060590320232,1131,188,0,12,0,12,0,12,1131,188,143,99,988,217,11225
15000US060590320233,729,177,0,12,0,12,0,12,729,177,127,96,602,174,11226
15000US060590320271,1085,105,114,62,17,18,97,60,971,116,96,64,875,118,11227
15000US060590320272,1038,109,34,42,9,16,25,38,1004,116,179,69,825,122,11228
15000US060590320281,326,66,7,11,0,12,7,11,319,65,53,35,266,71,11229
15000US060590320282,957,85,8,12,0,12,8,12,949,85,181,87,768,112,11230
15000US060590320291,409,77,0,12,0,12,0,12,409,77,83,53,326,84,11231
15000US060590320292,513,72,7,11,7,11,0,12,506,72,130,59,376,81,11232
15000US060590320293,554,81,11,17,11,17,0,12,543,82,29,25,514,88,11233
15000US060590320301,375,72,6,15,6,15,0,12,369,69,81,37,288,71,11234
15000US060590320302,910,74,0,12,0,12,0,12,910,74,225,62,685,94,11235
15000US060590320311,480,68,0,12,0,12,0,12,480,68,45,31,435,71,11236
15000US060590320312,689,65,0,12,0,12,0,12,689,65,85,46,604,77,11237
15000US060590320321,425,62,9,14,9,14,0,12,416,62,74,41,342,69,11238
15000US060590320322,606,63,0,12,0,12,0,12,606,63,76,34,530,70,11239
15000US060590320331,709,105,50,41,10,16,40,37,659,111,111,59,548,116,11240
15000US060590320332,413,71,0,12,0,12,0,12,413,71,9,14,404,71,11241
15000US060590320333,357,75,0,12,0,12,0,12,357,75,59,44,298,85,11242
15000US060590320341,471,62,0,12,0,12,0,12,471,62,73,36,398,62,11243
15000US060590320342,1053,79,0,12,0,12,0,12,1053,79,110,54,943,95,11244
15000US060590320343,329,58,8,12,0,12,8,12,321,57,62,33,259,63,11245
15000US060590320351,562,57,0,12,0,12,0,12,562,57,118,41,444,63,11246
15000US060590320352,470,53,7,10,0,12,7,10,463,54,84,36,379,60,11247
15000US060590320361,424,70,18,20,9,15,9,14,406,75,71,61,335,82,11248
15000US060590320362,857,82,9,14,0,12,9,14,848,81,217,86,631,105,11249
15000US060590320371,1249,110,13,21,13,21,0,12,1236,108,350,113,886,139,11250
15000US060590320372,598,115,28,37,28,37,0,12,570,140,26,39,544,144,11251
15000US060590320373,764,89,0,12,0,12,0,12,764,89,374,100,390,107,11252
15000US060590320381,1061,107,0,12,0,12,0,12,1061,107,251,90,810,135,11253
15000US060590320382,285,71,0,12,0,12,0,12,285,71,29,31,256,79,11254
15000US060590320383,826,122,0,12,0,12,0,12,826,122,110,62,716,136,11255
15000US060590320391,311,71,0,12,0,12,0,12,311,71,14,22,297,75,11256
15000US060590320392,891,116,0,12,0,12,0,12,891,116,231,93,660,127,11257
15000US060590320393,520,134,62,58,44,49,18,29,458,129,69,68,389,113,11258
15000US060590320394,451,109,19,32,19,32,0,12,432,113,199,125,233,76,11259
15000US060590320401,502,39,5,7,0,12,5,7,497,41,88,36,409,46,11260
15000US060590320402,395,36,0,12,0,12,0,12,395,36,88,30,307,42,11261
15000US060590320411,371,29,9,15,0,12,9,15,362,31,59,37,303,40,11262
15000US060590320421,1023,81,8,13,8,13,0,12,1015,81,107,52,908,94,11263
15000US060590320422,334,65,34,35,7,12,27,32,300,71,36,36,264,71,11264
15000US060590320423,465,64,0,12,0,12,0,12,465,64,62,39,403,74,11265
15000US060590320431,759,72,0,12,0,12,0,12,759,72,75,37,684,80,11266
15000US060590320432,493,68,0,12,0,12,0,12,493,68,64,46,429,75,11267
15000US060590320441,565,83,10,15,10,15,0,12,555,85,86,57,469,81,11268
15000US060590320442,488,73,0,12,0,12,0,12,488,73,70,35,418,79,11269
15000US060590320443,309,53,0,12,0,12,0,12,309,53,18,22,291,56,11270
15000US060590320444,688,83,0,12,0,12,0,12,688,83,129,46,559,92,11271
15000US060590320451,371,36,0,12,0,12,0,12,371,36,52,24,319,39,11272
15000US060590320452,591,35,0,12,0,12,0,12,591,35,46,26,545,42,11273
15000US060590320461,296,76,0,12,0,12,0,12,296,76,27,24,269,77,11274
15000US060590320462,458,78,0,12,0,12,0,12,458,78,102,53,356,74,11275
15000US060590320463,625,102,0,12,0,12,0,12,625,102,72,39,553,101,11276
15000US060590320464,432,77,0,12,0,12,0,12,432,77,35,30,397,79,11277
15000US060590320471,544,80,13,15,0,12,13,15,531,80,30,21,501,82,11278
15000US060590320472,332,70,0,12,0,12,0,12,332,70,40,33,292,72,11279
15000US060590320473,301,80,0,12,0,12,0,12,301,80,16,18,285,81,11280
15000US060590320474,657,91,0,12,0,12,0,12,657,91,95,50,562,98,11281
15000US060590320481,359,69,0,12,0,12,0,12,359,69,53,46,306,72,11282
15000US060590320482,906,78,0,12,0,12,0,12,906,78,382,111,524,113,11283
15000US060590320483,439,95,0,12,0,12,0,12,439,95,40,53,399,93,11284
15000US060590320484,463,75,0,12,0,12,0,12,463,75,40,47,423,81,11285
15000US060590320491,1378,142,40,43,0,12,40,43,1338,144,87,52,1251,152,11286
15000US060590320492,188,106,0,12,0,12,0,12,188,106,0,12,188,106,11287
15000US060590320493,865,161,60,55,40,46,20,33,805,160,33,38,772,155,11288
15000US060590320494,626,104,0,12,0,12,0,12,626,104,98,68,528,101,11289
15000US060590320501,219,44,8,12,0,12,8,12,211,46,46,30,165,52,11290
15000US060590320502,608,93,33,24,9,13,24,24,575,92,75,43,500,94,11291
15000US060590320503,935,98,26,35,26,35,0,12,909,106,102,49,807,114,11292
15000US060590320511,348,90,24,24,4,7,20,23,324,94,24,22,300,93,11293
15000US060590320512,463,82,8,13,0,12,8,13,455,83,23,26,432,81,11294
15000US060590320513,685,110,29,28,10,17,19,23,656,111,80,68,576,112,11295
15000US060590320514,429,100,14,20,0,12,14,20,415,100,91,67,324,100,11296
15000US060590320531,1165,129,59,50,27,38,32,36,1106,134,140,95,966,163,11297
15000US060590320532,652,154,0,12,0,12,0,12,652,154,138,122,514,109,11298
15000US060590320533,538,105,35,40,0,12,35,40,503,109,100,81,403,106,11299
15000US060590320534,699,151,0,12,0,12,0,12,699,151,65,52,634,154,11300
15000US060590320541,976,129,14,23,14,23,0,12,962,126,279,101,683,132,11301
15000US060590320542,287,95,0,12,0,12,0,12,287,95,0,12,287,95,11302
15000US060590320543,376,121,0,12,0,12,0,12,376,121,72,64,304,125,11303
15000US060590320544,592,119,22,36,0,12,22,36,570,124,15,25,555,122,11304
15000US060590320551,222,51,12,19,12,19,0,12,210,53,70,40,140,56,11305
15000US060590320552,543,83,114,89,33,36,81,85,429,111,77,44,352,109,11306
15000US060590320553,245,52,0,12,0,12,0,12,245,52,39,31,206,54,11307
15000US060590320554,413,70,0,12,0,12,0,12,413,70,102,63,311,76,11308
15000US060590320561,440,88,24,38,0,12,24,38,416,91,48,44,368,94,11309
15000US060590320562,311,88,41,46,0,12,41,46,270,84,13,20,257,85,11310
15000US060590320563,643,104,0,12,0,12,0,12,643,104,15,20,628,105,11311
15000US060590320564,412,103,71,76,0,12,71,76,341,117,33,57,308,122,11312
15000US060590320565,556,101,0,12,0,12,0,12,556,101,58,51,498,102,11313
15000US060590320571,1094,126,0,12,0,12,0,12,1094,126,230,107,864,168,11314
15000US060590320572,1197,168,0,12,0,12,0,12,1197,168,125,87,1072,159,11315
15000US060590320573,254,143,0,12,0,12,0,12,254,143,11,19,243,145,11316
15000US060590320581,926,120,7,11,7,11,0,12,919,120,79,55,840,116,11317
15000US060590320582,1246,142,0,12,0,12,0,12,1246,142,35,26,1211,139,11318
15000US060590320591,639,130,0,12,0,12,0,12,639,130,17,26,622,130,11319
15000US060590320592,695,148,17,27,0,12,17,27,678,153,65,82,613,142,11320
15000US060590320593,430,112,0,12,0,12,0,12,430,112,16,24,414,112,11321
15000US060590320594,749,164,16,27,0,12,16,27,733,166,44,47,689,169,11322
15000US060590320595,497,135,0,12,0,12,0,12,497,135,115,80,382,132,11323
15000US060590320611,1327,111,8,13,0,12,8,13,1319,110,361,86,958,116,11324
15000US060590320612,128,70,0,12,0,12,0,12,128,70,0,12,128,70,11325
15000US060590421031,919,186,43,67,0,12,43,67,876,190,139,93,737,196,11326
15000US060590421032,309,104,0,12,0,12,0,12,309,104,99,76,210,105,11327
15000US060590421033,794,156,0,12,0,12,0,12,794,156,72,45,722,158,11328
15000US060590421034,507,124,39,46,13,21,26,40,468,128,98,71,370,132,11329
15000US060590421035,463,108,0,12,0,12,0,12,463,108,67,41,396,121,11330
15000US060590421061,274,40,15,20,15,20,0,12,259,45,65,26,194,45,11331
15000US060590421062,313,50,0,12,0,12,0,12,313,50,94,35,219,57,11332
15000US060590421071,534,96,0,12,0,12,0,12,534,96,34,26,500,95,11333
15000US060590421072,960,110,91,82,43,64,48,49,869,99,156,54,713,111,11334
15000US060590421081,546,175,81,111,0,12,81,111,465,180,78,83,387,168,11335
15000US060590421082,384,158,75,100,10,18,65,101,309,142,36,40,273,137,11336
15000US060590421083,624,194,15,24,0,12,15,24,609,192,88,98,521,177,11337
15000US060590421084,677,163,94,85,19,28,75,79,583,183,35,33,548,188,11338
15000US060590421085,302,130,0,12,0,12,0,12,302,130,19,29,283,131,11339
15000US060590421091,801,138,19,31,0,12,19,31,782,146,158,101,624,144,11340
15000US060590421092,499,102,0,12,0,12,0,12,499,102,65,48,434,105,11341
15000US060590421093,472,98,0,12,0,12,0,12,472,98,102,79,370,114,11342
15000US060590421094,355,77,0,12,0,12,0,12,355,77,82,52,273,79,11343
15000US060590421111,348,67,23,30,0,12,23,30,325,68,85,59,240,74,11344
15000US060590421112,604,108,0,12,0,12,0,12,604,108,104,55,500,121,11345
15000US060590421113,298,82,55,77,55,77,0,12,243,77,57,66,186,62,11346
15000US060590421114,921,109,30,41,0,12,30,41,891,120,129,69,762,141,11347
15000US060590421121,1074,148,15,25,0,12,15,25,1059,146,205,90,854,153,11348
15000US060590421122,516,94,13,22,0,12,13,22,503,94,86,57,417,95,11349
15000US060590421123,697,141,0,12,0,12,0,12,697,141,99,81,598,126,11350
15000US060590421131,362,67,0,12,0,12,0,12,362,67,87,44,275,69,11351
15000US060590421132,493,75,9,14,9,14,0,12,484,76,74,40,410,81,11352
15000US060590421133,454,94,10,15,10,15,0,12,444,91,72,52,372,86,11353
15000US060590421134,476,79,19,21,19,21,0,12,457,81,78,33,379,80,11354
15000US060590421141,602,110,24,26,14,21,10,16,578,113,69,39,509,112,11355
15000US060590421142,468,77,33,49,0,12,33,49,435,76,127,50,308,79,11356
15000US060590421143,524,83,0,12,0,12,0,12,524,83,133,54,391,103,11357
15000US060590422011,480,122,65,82,0,12,65,82,415,109,160,59,255,113,11358
15000US060590422012,202,87,0,12,0,12,0,12,202,87,13,22,189,84,11359
15000US060590422013,869,177,0,12,0,12,0,12,869,177,81,61,788,175,11360
15000US060590422014,430,94,0,12,0,12,0,12,430,94,77,51,353,102,11361
15000US060590422015,425,144,0,12,0,12,0,12,425,144,67,29,358,141,11362
15000US060590422031,604,128,0,12,0,12,0,12,604,128,46,44,558,127,11363
15000US060590422032,582,125,0,12,0,12,0,12,582,125,278,104,304,115,11364
15000US060590422033,536,118,0,12,0,12,0,12,536,118,141,64,395,123,11365
15000US060590422034,349,87,0,12,0,12,0,12,349,87,84,52,265,101,11366
15000US060590422035,416,110,59,53,0,12,59,53,357,101,62,51,295,100,11367
15000US060590422036,515,102,0,12,0,12,0,12,515,102,80,50,435,107,11368
15000US060590422051,567,106,0,12,0,12,0,12,567,106,47,42,520,110,11369
15000US060590422052,1177,151,30,40,0,12,30,40,1147,147,296,119,851,169,11370
15000US060590422053,435,92,0,12,0,12,0,12,435,92,25,38,410,97,11371
15000US060590422054,427,119,18,28,0,12,18,28,409,125,16,24,393,128,11372
15000US060590422061,586,98,13,20,0,12,13,20,573,98,120,80,453,98,11373
15000US060590422062,793,111,10,16,10,16,0,12,783,112,181,69,602,113,11374
15000US060590423051,606,99,5,10,5,10,0,12,601,98,114,58,487,96,11375
15000US060590423052,484,79,0,12,0,12,0,12,484,79,92,61,392,72,11376
15000US060590423053,373,62,8,12,0,12,8,12,365,61,37,26,328,60,11377
15000US060590423071,602,93,33,36,33,36,0,12,569,98,111,56,458,110,11378
15000US060590423072,469,102,0,12,0,12,0,12,469,102,105,64,364,102,11379
15000US060590423073,311,93,0,12,0,12,0,12,311,93,26,33,285,99,11380
15000US060590423074,356,113,13,19,0,12,13,19,343,114,52,37,291,117,11381
15000US060590423075,409,106,0,12,0,12,0,12,409,106,53,42,356,114,11382
15000US060590423101,475,134,19,32,0,12,19,32,456,134,116,112,340,103,11383
15000US060590423102,316,83,0,12,0,12,0,12,316,83,61,44,255,82,11384
15000US060590423103,591,145,20,34,0,12,20,34,571,146,101,67,470,154,11385
15000US060590423104,851,173,80,97,80,97,0,12,771,175,292,130,479,175,11386
15000US060590423105,661,144,39,63,0,12,39,63,622,142,232,123,390,115,11387
15000US060590423106,301,72,0,12,0,12,0,12,301,72,113,69,188,66,11388
15000US060590423111,455,138,0,12,0,12,0,12,455,138,53,67,402,121,11389
15000US060590423112,365,108,16,26,16,26,0,12,349,100,190,83,159,66,11390
15000US060590423113,534,126,15,24,0,12,15,24,519,128,158,96,361,123,11391
15000US060590423114,817,116,43,59,17,28,26,50,774,111,271,126,503,128,11392
15000US060590423121,752,173,96,101,22,33,74,103,656,148,79,57,577,155,11393
15000US060590423122,706,149,19,30,0,12,19,30,687,149,327,131,360,103,11394
15000US060590423123,559,143,124,116,71,90,53,81,435,137,57,49,378,130,11395
15000US060590423124,403,122,51,80,0,12,51,80,352,115,45,42,307,113,11396
15000US060590423131,510,116,0,12,0,12,0,12,510,116,156,90,354,127,11397
15000US060590423132,540,110,0,12,0,12,0,12,540,110,33,39,507,120,11398
15000US060590423133,748,132,96,96,33,52,63,77,652,145,36,39,616,144,11399
15000US060590423134,608,135,14,23,0,12,14,23,594,141,15,25,579,140,11400
15000US060590423135,796,168,0,12,0,12,0,12,796,168,50,48,746,160,11401
15000US060590423151,412,116,0,12,0,12,0,12,412,116,34,40,378,118,11402
15000US060590423152,397,100,33,38,0,12,33,38,364,103,32,37,332,105,11403
15000US060590423153,511,127,18,27,18,27,0,12,493,129,114,71,379,128,11404
15000US060590423154,479,119,0,12,0,12,0,12,479,119,78,49,401,113,11405
15000US060590423155,619,159,0,12,0,12,0,12,619,159,82,83,537,165,11406
15000US060590423171,307,72,0,12,0,12,0,12,307,72,23,21,284,73,11407
15000US060590423172,275,46,0,12,0,12,0,12,275,46,85,47,190,50,11408
15000US060590423173,651,78,8,14,8,14,0,12,643,77,103,51,540,80,11409
15000US060590423191,726,57,0,12,0,12,0,12,726,57,73,39,653,68,11410
15000US060590423192,403,59,0,12,0,12,0,12,403,59,19,21,384,60,11411
15000US060590423201,784,149,29,34,12,19,17,27,755,145,140,89,615,149,11412
15000US060590423202,240,58,15,26,15,26,0,12,225,60,61,49,164,59,11413
15000US060590423203,472,112,34,39,16,26,18,29,438,112,25,28,413,116,11414
15000US060590423204,782,147,10,21,0,12,10,21,772,149,40,41,732,151,11415
15000US060590423231,518,109,35,54,35,54,0,12,483,113,65,63,418,106,11416
15000US060590423232,508,124,0,12,0,12,0,12,508,124,50,45,458,121,11417
15000US060590423233,535,155,0,12,0,12,0,12,535,155,43,36,492,153,11418
15000US060590423234,509,137,14,24,0,12,14,24,495,143,53,46,442,147,11419
15000US060590423241,459,124,0,12,0,12,0,12,459,124,103,68,356,117,11420
15000US060590423242,428,138,86,96,0,12,86,96,342,128,43,66,299,118,11421
15000US060590423243,541,104,61,70,0,12,61,70,480,113,94,68,386,118,11422
15000US060590423244,655,125,26,40,0,12,26,40,629,130,132,69,497,119,11423
15000US060590423251,812,75,0,12,0,12,0,12,812,75,72,38,740,79,11424
15000US060590423252,724,94,14,18,9,14,5,10,710,95,71,35,639,97,11425
15000US060590423261,613,100,61,43,38,35,23,27,552,101,114,58,438,97,11426
15000US060590423262,1166,91,62,43,20,25,42,37,1104,92,237,59,867,109,11427
15000US060590423271,628,62,7,11,7,11,0,12,621,60,39,26,582,59,11428
15000US060590423272,304,62,0,12,0,12,0,12,304,62,28,24,276,63,11429
15000US060590423273,681,89,0,12,0,12,0,12,681,89,139,48,542,95,11430
15000US060590423281,453,48,0,12,0,12,0,12,453,48,62,30,391,51,11431
15000US060590423282,299,45,0,12,0,12,0,12,299,45,53,28,246,42,11432
15000US060590423291,458,68,9,14,9,14,0,12,449,71,85,53,364,73,11433
15000US060590423292,476,60,0,12,0,12,0,12,476,60,73,33,403,68,11434
15000US060590423293,527,72,0,12,0,12,0,12,527,72,47,32,480,66,11435
15000US060590423301,715,149,10,20,10,20,0,12,705,152,111,80,594,152,11436
15000US060590423302,278,110,0,12,0,12,0,12,278,110,41,50,237,117,11437
15000US060590423303,1198,191,102,109,92,107,10,19,1096,218,141,81,955,219,11438
15000US060590423311,831,130,0,12,0,12,0,12,831,130,141,77,690,135,11439
15000US060590423312,745,148,53,82,0,12,53,82,692,157,40,43,652,167,11440
15000US060590423313,612,107,0,12,0,12,0,12,612,107,48,42,564,112,11441
15000US060590423321,422,86,17,28,0,12,17,28,405,88,27,32,378,86,11442
15000US060590423322,638,118,17,26,0,12,17,26,621,117,44,43,577,117,11443
15000US060590423323,1034,143,0,12,0,12,0,12,1034,143,116,72,918,145,11444
15000US060590423331,552,90,0,12,0,12,0,12,552,90,58,42,494,89,11445
15000US060590423332,678,82,12,20,12,20,0,12,666,81,122,46,544,87,11446
15000US060590423341,570,144,0,12,0,12,0,12,570,144,123,79,447,141,11447
15000US060590423342,537,142,50,68,50,68,0,12,487,144,77,63,410,146,11448
15000US060590423343,552,135,15,26,0,12,15,26,537,136,105,76,432,147,11449
15000US060590423344,466,89,0,12,0,12,0,12,466,89,47,36,419,90,11450
15000US060590423351,605,188,0,12,0,12,0,12,605,188,17,27,588,190,11451
15000US060590423352,1912,203,71,71,18,35,53,64,1841,208,226,135,1615,241,11452
15000US060590423361,1141,70,0,12,0,12,0,12,1141,70,84,49,1057,96,11453
15000US060590423362,461,69,0,12,0,12,0,12,461,69,35,32,426,73,11454
15000US060590423371,429,70,0,12,0,12,0,12,429,70,129,74,300,72,11455
15000US060590423372,515,71,12,19,0,12,12,19,503,70,83,48,420,77,11456
15000US060590423373,418,73,11,19,0,12,11,19,407,74,79,41,328,79,11457
15000US060590423381,1128,108,8,13,0,12,8,13,1120,105,183,51,937,107,11458
15000US060590423382,894,87,9,14,9,14,0,12,885,90,172,66,713,91,11459
15000US060590423391,489,76,10,15,10,15,0,12,479,79,61,41,418,84,11460
15000US060590423392,654,97,18,29,18,29,0,12,636,101,98,53,538,110,11461
15000US060590423393,422,84,0,12,0,12,0,12,422,84,94,52,328,88,11462
15000US060590524041,92,64,0,12,0,12,0,12,92,64,0,12,92,64,11463
15000US060590524081,439,95,0,12,0,12,0,12,439,95,8,16,431,98,11464
15000US060590524082,685,98,10,21,0,12,10,21,675,102,154,77,521,113,11465
15000US060590524083,566,106,0,12,0,12,0,12,566,106,120,69,446,117,11466
15000US060590524084,486,104,0,12,0,12,0,12,486,104,131,75,355,107,11467
15000US060590524101,454,104,12,24,0,12,12,24,442,112,27,33,415,114,11468
15000US060590524102,483,95,20,32,0,12,20,32,463,98,83,61,380,110,11469
15000US060590524103,711,139,51,54,28,43,23,36,660,140,87,62,573,149,11470
15000US060590524104,416,88,0,12,0,12,0,12,416,88,154,80,262,77,11471
15000US060590524111,549,98,0,12,0,12,0,12,549,98,88,43,461,110,11472
15000US060590524112,420,87,23,33,0,12,23,33,397,81,91,44,306,86,11473
15000US060590524113,414,71,0,12,0,12,0,12,414,71,75,38,339,82,11474
15000US060590524151,669,68,0,12,0,12,0,12,669,68,86,47,583,87,11475
15000US060590524152,632,68,8,12,0,12,8,12,624,67,97,49,527,78,11476
15000US060590524161,249,68,11,18,11,18,0,12,238,67,8,14,230,66,11477
15000US060590524162,587,83,38,40,0,12,38,40,549,87,55,38,494,91,11478
15000US060590524163,414,64,0,12,0,12,0,12,414,64,93,61,321,62,11479
15000US060590524171,1898,149,50,62,37,59,13,21,1848,148,220,105,1628,143,11480
15000US060590524172,489,90,0,12,0,12,0,12,489,90,222,87,267,84,11481
15000US060590524173,1054,131,34,37,15,23,19,29,1020,132,152,86,868,140,11482
15000US060590524174,343,57,19,30,0,12,19,30,324,63,51,46,273,66,11483
15000US060590524181,744,192,85,125,85,125,0,12,659,159,71,72,588,176,11484
15000US060590524182,1968,336,0,12,0,12,0,12,1968,336,182,133,1786,325,11485
15000US060590524183,2064,289,0,17,0,17,0,17,2064,289,200,145,1864,281,11486
15000US060590524184,2269,331,89,82,0,17,89,82,2180,333,321,193,1859,358,11487
15000US060590524191,590,78,0,12,0,12,0,12,590,78,68,42,522,75,11488
15000US060590524192,549,79,0,12,0,12,0,12,549,79,38,34,511,83,11489
15000US060590524201,1642,300,0,12,0,12,0,12,1642,300,152,149,1490,321,11490
15000US060590524202,2098,391,147,241,0,17,147,241,1951,404,207,274,1744,375,11491
15000US060590524203,2381,378,0,17,0,17,0,17,2381,378,83,100,2298,398,11492
15000US060590524204,1143,285,0,12,0,12,0,12,1143,285,55,88,1088,285,11493
15000US060590524211,623,90,0,12,0,12,0,12,623,90,65,50,558,83,11494
15000US060590524212,334,49,0,12,0,12,0,12,334,49,53,29,281,50,11495
15000US060590524213,516,82,0,12,0,12,0,12,516,82,42,27,474,83,11496
15000US060590524214,593,82,55,38,21,23,34,33,538,85,17,15,521,87,11497
15000US060590524221,634,84,0,12,0,12,0,12,634,84,79,34,555,95,11498
15000US060590524222,634,112,0,12,0,12,0,12,634,112,79,52,555,116,11499
15000US060590524223,347,60,9,14,9,14,0,12,338,60,18,20,320,62,11500
15000US060590524231,586,132,0,12,0,12,0,12,586,132,158,113,428,121,11501
15000US060590524232,1079,180,190,126,0,12,190,126,889,190,75,57,814,193,11502
15000US060590524233,515,142,26,29,9,14,17,27,489,141,47,44,442,143,11503
15000US060590524241,815,91,24,19,8,13,16,19,791,93,54,35,737,98,11504
15000US060590524242,747,101,22,26,16,24,6,10,725,102,73,38,652,101,11505
15000US060590524243,358,60,0,12,0,12,0,12,358,60,57,32,301,61,11506
15000US060590524251,573,121,20,33,0,12,20,33,553,124,112,89,441,127,11507
15000US060590524252,294,92,0,12,0,12,0,12,294,92,36,40,258,89,11508
15000US060590524253,589,125,29,34,29,34,0,12,560,131,182,96,378,141,11509
15000US060590524254,975,128,22,34,22,34,0,12,953,135,91,66,862,130,11510
15000US060590524261,435,97,0,12,0,12,0,12,435,97,80,72,355,90,11511
15000US060590524262,3511,196,53,31,18,30,35,40,3458,197,260,157,3198,239,11512
15000US060590524263,552,95,0,12,0,12,0,12,552,95,118,98,434,88,11513
15000US060590524271,732,83,0,12,0,12,0,12,732,83,81,41,651,90,11514
15000US060590524272,1025,94,65,56,0,12,65,56,960,110,120,58,840,118,11515
15000US060590524281,336,83,0,12,0,12,0,12,336,83,29,34,307,84,11516
15000US060590524282,335,94,25,39,0,12,25,39,310,97,38,44,272,93,11517
15000US060590524283,392,92,0,12,0,12,0,12,392,92,86,60,306,102,11518
15000US060590524284,746,118,0,12,0,12,0,12,746,118,17,26,729,117,11519
15000US060590524285,384,98,0,12,0,12,0,12,384,98,63,52,321,104,11520
15000US060590525021,433,70,0,12,0,12,0,12,433,70,164,70,269,64,11521
15000US060590525022,474,67,7,11,0,12,7,11,467,69,67,35,400,70,11522
15000US060590525023,718,93,49,43,16,17,33,40,669,92,213,67,456,99,11523
15000US060590525024,329,53,9,15,0,12,9,15,320,54,111,49,209,52,11524
15000US060590525051,270,55,0,12,0,12,0,12,270,55,18,20,252,56,11525
15000US060590525052,636,99,16,19,16,19,0,12,620,100,98,54,522,101,11526
15000US060590525053,320,62,0,12,0,12,0,12,320,62,37,29,283,63,11527
15000US060590525054,805,101,66,56,39,32,27,45,739,103,227,88,512,108,11528
15000US060590525061,298,40,5,9,0,12,5,9,293,40,49,27,244,42,11529
15000US060590525062,513,39,0,12,0,12,0,12,513,39,83,30,430,44,11530
15000US060590525111,483,108,0,12,0,12,0,12,483,108,74,50,409,113,11531
15000US060590525112,168,73,0,12,0,12,0,12,168,73,58,52,110,63,11532
15000US060590525113,210,69,0,12,0,12,0,12,210,69,37,32,173,65,11533
15000US060590525114,574,144,0,12,0,12,0,12,574,144,153,102,421,144,11534
15000US060590525115,331,79,19,30,19,30,0,12,312,83,0,12,312,83,11535
15000US060590525116,378,109,0,12,0,12,0,12,378,109,106,78,272,113,11536
15000US060590525131,280,87,0,12,0,12,0,12,280,87,37,29,243,93,11537
15000US060590525132,242,110,32,50,0,12,32,50,210,109,29,30,181,111,11538
15000US060590525133,485,140,58,52,9,16,49,57,427,143,59,73,368,132,11539
15000US060590525134,364,86,0,12,0,12,0,12,364,86,117,80,247,65,11540
15000US060590525135,499,117,0,12,0,12,0,12,499,117,197,94,302,99,11541
15000US060590525136,420,104,74,60,37,44,37,54,346,97,65,52,281,100,11542
15000US060590525141,724,123,15,26,0,12,15,26,709,124,317,129,392,124,11543
15000US060590525142,615,104,19,22,10,17,9,14,596,105,104,67,492,120,11544
15000US060590525143,418,76,0,12,0,12,0,12,418,76,43,48,375,78,11545
15000US060590525144,451,81,10,19,0,12,10,19,441,83,64,44,377,86,11546
15000US060590525151,594,120,17,28,0,12,17,28,577,123,0,12,577,123,11547
15000US060590525152,435,97,0,12,0,12,0,12,435,97,57,48,378,106,11548
15000US060590525153,905,150,0,12,0,12,0,12,905,150,131,86,774,148,11549
15000US060590525154,784,146,14,22,14,22,0,12,770,148,18,29,752,148,11550
15000US060590525155,375,104,0,12,0,12,0,12,375,104,19,29,356,102,11551
15000US060590525171,1203,177,87,79,55,64,32,47,1116,183,95,72,1021,191,11552
15000US060590525172,2569,309,29,48,0,17,29,48,2540,308,81,71,2459,301,11553
15000US060590525173,743,216,0,12,0,12,0,12,743,216,28,59,715,213,11554
15000US060590525181,2758,138,12,18,0,17,12,18,2746,137,86,52,2660,150,11555
15000US060590525191,393,68,42,41,15,25,27,31,351,66,12,20,339,63,11556
15000US060590525192,349,62,0,12,0,12,0,12,349,62,30,28,319,64,11557
15000US060590525193,344,58,0,12,0,12,0,12,344,58,41,33,303,69,11558
15000US060590525194,487,77,38,29,9,15,29,24,449,80,70,43,379,88,11559
15000US060590525201,499,63,0,12,0,12,0,12,499,63,53,33,446,67,11560
15000US060590525202,529,73,35,30,21,23,14,21,494,76,93,53,401,80,11561
15000US060590525203,272,56,0,12,0,12,0,12,272,56,62,35,210,54,11562
15000US060590525211,861,171,14,22,0,12,14,22,847,173,240,95,607,152,11563
15000US060590525212,419,107,49,67,0,12,49,67,370,121,50,45,320,128,11564
15000US060590525213,446,113,35,41,0,12,35,41,411,107,13,21,398,108,11565
15000US060590525214,407,117,55,50,18,29,37,42,352,106,95,87,257,95,11566
15000US060590525221,384,81,0,12,0,12,0,12,384,81,20,23,364,84,11567
15000US060590525222,462,75,0,12,0,12,0,12,462,75,90,40,372,73,11568
15000US060590525223,588,98,46,56,46,56,0,12,542,99,81,53,461,105,11569
15000US060590525231,472,94,34,55,0,12,34,55,438,94,53,64,385,93,11570
15000US060590525232,247,55,0,12,0,12,0,12,247,55,27,25,220,57,11571
15000US060590525233,427,69,0,12,0,12,0,12,427,69,108,48,319,77,11572
15000US060590525234,365,81,0,12,0,12,0,12,365,81,8,13,357,82,11573
15000US060590525241,299,82,0,12,0,12,0,12,299,82,10,18,289,83,11574
15000US060590525242,650,129,0,12,0,12,0,12,650,129,67,51,583,138,11575
15000US060590525243,584,99,0,12,0,12,0,12,584,99,41,30,543,104,11576
15000US060590525244,715,159,53,66,14,23,39,63,662,175,89,81,573,160,11577
15000US060590525245,761,176,47,47,18,32,29,33,714,179,160,96,554,173,11578
15000US060590525251,1146,212,0,12,0,12,0,12,1146,212,95,91,1051,205,11579
15000US060590525252,434,133,0,12,0,12,0,12,434,133,65,52,369,127,11580
15000US060590525253,270,77,0,12,0,12,0,12,270,77,35,56,235,84,11581
15000US060590525254,596,217,66,50,22,36,44,54,530,212,120,97,410,227,11582
15000US060590525255,793,178,0,12,0,12,0,12,793,178,103,94,690,161,11583
15000US060590525256,405,103,0,12,0,12,0,12,405,103,56,66,349,127,11584
15000US060590525257,642,157,0,12,0,12,0,12,642,157,64,61,578,168,11585
15000US060590525258,1512,274,134,133,70,112,64,78,1378,251,54,63,1324,262,11586
15000US060590525259,323,118,0,12,0,12,0,12,323,118,105,90,218,115,11587
15000US060590525261,526,66,0,12,0,12,0,12,526,66,87,53,439,75,11588
15000US060590525262,862,69,15,18,6,10,9,13,847,68,124,60,723,82,11589
15000US060590525271,955,129,0,12,0,12,0,12,955,129,148,82,807,154,11590
15000US060590525272,958,105,18,27,0,12,18,27,940,106,149,82,791,124,11591
15000US060590525273,415,82,42,44,0,12,42,44,373,88,153,76,220,94,11592
15000US060590525274,463,107,0,12,0,12,0,12,463,107,50,62,413,118,11593
15000US060590525281,233,53,0,12,0,12,0,12,233,53,24,27,209,60,11594
15000US060590525282,379,72,0,12,0,12,0,12,379,72,55,55,324,63,11595
15000US060590525283,385,66,0,12,0,12,0,12,385,66,44,31,341,70,11596
15000US060590525284,260,67,20,30,0,12,20,30,240,63,45,44,195,57,11597
15000US060590626041,398,136,0,12,0,12,0,12,398,136,174,158,224,147,11598
15000US060590626042,3779,520,0,17,0,17,0,17,3779,520,114,130,3665,526,11599
15000US060590626043,1006,356,0,12,0,12,0,12,1006,356,0,12,1006,356,11600
15000US060590626044,975,332,0,12,0,12,0,12,975,332,32,60,943,327,11601
15000US060590626045,341,298,0,12,0,12,0,12,341,298,0,12,341,298,11602
15000US060590626051,374,80,49,37,21,16,28,33,325,76,39,38,286,79,11603
15000US060590626052,365,64,25,23,15,17,10,15,340,62,6,11,334,63,11604
15000US060590626053,303,65,7,11,7,11,0,12,296,65,42,27,254,65,11605
15000US060590626054,718,106,0,12,0,12,0,12,718,106,41,27,677,106,11606
15000US060590626101,459,156,0,12,0,12,0,12,459,156,36,40,423,156,11607
15000US060590626102,4174,284,17,28,17,28,0,17,4157,282,361,143,3796,301,11608
15000US060590626111,174,59,20,25,0,12,20,25,154,56,7,12,147,57,11609
15000US060590626112,723,98,9,15,0,12,9,15,714,96,30,24,684,98,11610
15000US060590626113,845,84,29,23,12,13,17,18,816,86,71,33,745,87,11611
15000US060590626121,638,92,0,12,0,12,0,12,638,92,17,28,621,92,11612
15000US060590626122,491,118,0,12,0,12,0,12,491,118,80,50,411,121,11613
15000US060590626123,518,102,32,37,16,27,16,25,486,108,66,47,420,102,11614
15000US060590626124,211,48,0,12,0,12,0,12,211,48,52,46,159,64,11615
15000US060590626125,620,100,10,18,0,12,10,18,610,103,127,54,483,113,11616
15000US060590626126,565,104,0,12,0,12,0,12,565,104,180,86,385,103,11617
15000US060590626141,2011,221,36,59,0,17,36,59,1975,221,122,68,1853,238,11618
15000US060590626142,1155,208,0,12,0,12,0,12,1155,208,0,12,1155,208,11619
15000US060590626143,994,172,33,38,21,33,12,19,961,176,23,36,938,184,11620
15000US060590626191,422,64,0,12,0,12,0,12,422,64,80,40,342,74,11621
15000US060590626192,329,61,0,12,0,12,0,12,329,61,84,45,245,71,11622
15000US060590626193,494,86,9,14,0,12,9,14,485,88,75,38,410,87,11623
15000US060590626194,495,79,0,12,0,12,0,12,495,79,67,43,428,79,11624
15000US060590626201,482,109,29,36,0,12,29,36,453,112,140,58,313,111,11625
15000US060590626202,782,134,14,23,14,23,0,12,768,135,57,46,711,141,11626
15000US060590626203,328,87,0,12,0,12,0,12,328,87,18,27,310,88,11627
15000US060590626204,605,112,0,12,0,12,0,12,605,112,102,53,503,121,11628
15000US060590626211,551,117,40,47,0,12,40,47,511,114,174,75,337,100,11629
15000US060590626212,533,102,31,28,0,12,31,28,502,103,105,60,397,101,11630
15000US060590626213,1882,186,0,12,0,12,0,12,1882,186,261,88,1621,190,11631
15000US060590626221,332,90,0,12,0,12,0,12,332,90,115,61,217,100,11632
15000US060590626222,453,95,27,31,13,21,14,22,426,99,177,87,249,93,11633
15000US060590626223,742,126,12,19,12,19,0,12,730,131,186,77,544,143,11634
15000US060590626224,176,73,0,12,0,12,0,12,176,73,36,47,140,62,11635
15000US060590626225,880,128,12,19,0,12,12,19,868,126,323,107,545,134,11636
15000US060590626251,481,72,27,25,19,21,8,13,454,77,129,48,325,69,11637
15000US060590626252,581,77,0,12,0,12,0,12,581,77,167,57,414,80,11638
15000US060590626253,456,70,0,12,0,12,0,12,456,70,77,40,379,72,11639
15000US060590626254,391,71,55,46,12,15,43,49,336,80,26,33,310,84,11640
15000US060590626261,529,80,0,12,0,12,0,12,529,80,73,46,456,88,11641
15000US060590626262,416,73,50,38,50,38,0,12,366,79,39,28,327,81,11642
15000US060590626271,903,92,7,13,0,12,7,13,896,92,260,82,636,100,11643
15000US060590626272,302,67,29,27,13,17,16,19,273,63,37,30,236,60,11644
15000US060590626273,283,58,8,12,0,12,8,12,275,59,46,34,229,59,11645
15000US060590626281,409,60,6,9,0,12,6,9,403,60,23,21,380,61,11646
15000US060590626282,515,63,9,12,0,12,9,12,506,65,58,30,448,65,11647
15000US060590626291,648,47,6,8,0,12,6,8,642,48,116,33,526,52,11648
15000US060590626292,243,39,16,14,5,8,11,11,227,40,60,34,167,35,11649
15000US060590626301,788,28,0,12,0,12,0,12,788,28,72,36,716,48,11650
15000US060590626311,343,65,0,12,0,12,0,12,343,65,98,44,245,70,11651
15000US060590626312,248,56,0,12,0,12,0,12,248,56,48,32,200,60,11652
15000US060590626313,372,50,0,12,0,12,0,12,372,50,34,29,338,53,11653
15000US060590626314,269,47,0,12,0,12,0,12,269,47,12,18,257,45,11654
15000US060590626321,414,83,0,12,0,12,0,12,414,83,37,34,377,87,11655
15000US060590626322,247,67,8,13,0,12,8,13,239,66,25,23,214,68,11656
15000US060590626323,358,71,0,12,0,12,0,12,358,71,32,26,326,70,11657
15000US060590626324,658,99,9,14,9,14,0,12,649,99,136,53,513,106,11658
15000US060590626331,936,88,21,24,10,15,11,17,915,93,64,38,851,96,11659
15000US060590626332,950,96,0,12,0,12,0,12,950,96,91,48,859,107,11660
15000US060590626341,238,50,0,12,0,12,0,12,238,50,56,46,182,55,11661
15000US060590626342,871,93,0,12,0,12,0,12,871,93,74,38,797,99,11662
15000US060590626343,445,72,0,12,0,12,0,12,445,72,52,33,393,76,11663
15000US060590626344,412,87,0,12,0,12,0,12,412,87,26,24,386,90,11664
15000US060590626351,468,73,0,12,0,12,0,12,468,73,22,25,446,75,11665
15000US060590626352,599,92,0,12,0,12,0,12,599,92,35,33,564,94,11666
15000US060590626353,577,92,10,16,10,16,0,12,567,93,90,66,477,94,11667
15000US060590626361,466,95,17,21,0,12,17,21,449,96,92,44,357,97,11668
15000US060590626362,574,102,55,61,35,52,20,31,519,107,50,40,469,110,11669
15000US060590626363,423,71,10,15,10,15,0,12,413,72,53,38,360,81,11670
15000US060590626371,945,122,16,27,0,12,16,27,929,121,60,56,869,124,11671
15000US060590626372,696,135,47,62,0,12,47,62,649,136,32,40,617,134,11672
15000US060590626373,544,119,14,24,0,12,14,24,530,116,101,59,429,132,11673
15000US060590626381,508,145,0,12,0,12,0,12,508,145,73,93,435,142,11674
15000US060590626382,999,154,0,12,0,12,0,12,999,154,133,68,866,164,11675
15000US060590626383,901,137,0,12,0,12,0,12,901,137,59,46,842,143,11676
15000US060590626391,433,102,0,12,0,12,0,12,433,102,54,44,379,111,11677
15000US060590626392,913,138,61,72,0,12,61,72,852,141,129,77,723,156,11678
15000US060590626393,572,116,0,12,0,12,0,12,572,116,79,58,493,115,11679
15000US060590626394,807,138,45,67,45,67,0,12,762,122,198,67,564,130,11680
15000US060590626401,887,102,96,77,9,14,87,77,791,108,91,72,700,94,11681
15000US060590626402,685,100,8,12,0,12,8,12,677,102,78,41,599,108,11682
15000US060590626411,1045,116,28,38,0,12,28,38,1017,106,279,81,738,105,11683
15000US060590626412,434,88,9,13,9,13,0,12,425,88,55,33,370,86,11684
15000US060590626413,561,96,0,12,0,12,0,12,561,96,236,76,325,101,11685
15000US060590626421,264,52,0,12,0,12,0,12,264,52,63,35,201,54,11686
15000US060590626422,502,71,0,12,0,12,0,12,502,71,147,52,355,66,11687
15000US060590626423,512,81,0,12,0,12,0,12,512,81,96,64,416,75,11688
15000US060590626431,428,112,0,12,0,12,0,12,428,112,72,44,356,117,11689
15000US060590626432,599,154,0,12,0,12,0,12,599,154,0,12,599,154,11690
15000US060590626433,417,108,0,12,0,12,0,12,417,108,69,52,348,114,11691
15000US060590626434,307,91,13,22,0,12,13,22,294,91,64,44,230,82,11692
15000US060590626435,480,133,0,12,0,12,0,12,480,133,0,12,480,133,11693
15000US060590626436,473,113,0,12,0,12,0,12,473,113,31,35,442,122,11694
15000US060590626441,575,99,0,12,0,12,0,12,575,99,90,58,485,118,11695
15000US060590626442,839,146,18,33,18,33,0,12,821,155,101,61,720,167,11696
15000US060590626443,1172,175,0,12,0,12,0,12,1172,175,202,134,970,178,11697
15000US060590626444,578,115,0,12,0,12,0,12,578,115,147,73,431,105,11698
15000US060590626451,666,144,0,12,0,12,0,12,666,144,27,30,639,146,11699
15000US060590626452,292,73,0,12,0,12,0,12,292,73,23,35,269,75,11700
15000US060590626453,551,124,0,12,0,12,0,12,551,124,32,37,519,128,11701
15000US060590626454,359,116,0,12,0,12,0,12,359,116,0,12,359,116,11702
15000US060590626455,704,138,0,12,0,12,0,12,704,138,147,84,557,142,11703
15000US060590626461,464,96,0,12,0,12,0,12,464,96,154,66,310,106,11704
15000US060590626462,630,119,0,12,0,12,0,12,630,119,220,88,410,133,11705
15000US060590626463,1068,144,26,31,0,12,26,31,1042,152,305,114,737,163,11706
15000US060590626464,471,91,0,12,0,12,0,12,471,91,165,83,306,67,11707
15000US060590626471,735,141,46,74,0,12,46,74,689,142,269,99,420,148,11708
15000US060590626472,315,86,0,12,0,12,0,12,315,86,130,76,185,91,11709
15000US060590626473,430,93,17,28,0,12,17,28,413,96,149,69,264,103,11710
15000US060590626474,601,109,0,12,0,12,0,12,601,109,208,92,393,132,11711
15000US060590626481,359,55,15,16,15,16,0,12,344,57,100,40,244,55,11712
15000US060590626482,627,71,7,11,7,11,0,12,620,70,212,68,408,69,11713
15000US060590626483,899,88,8,13,8,13,0,12,891,90,303,85,588,102,11714
15000US060590626491,934,79,8,12,0,12,8,12,926,78,284,70,642,85,11715
15000US060590626492,635,92,0,12,0,12,0,12,635,92,70,63,565,110,11716
15000US060590626493,419,59,9,13,9,13,0,12,410,62,183,57,227,69,11717
15000US060590627011,805,101,27,42,0,12,27,42,778,105,145,65,633,101,11718
15000US060590627012,439,72,0,12,0,12,0,12,439,72,41,25,398,75,11719
15000US060590627021,464,137,0,12,0,12,0,12,464,137,86,75,378,134,11720
15000US060590627022,350,96,17,28,17,28,0,12,333,100,74,48,259,107,11721
15000US060590627023,585,137,0,12,0,12,0,12,585,137,14,22,571,136,11722
15000US060590627024,333,87,28,34,28,34,0,12,305,82,29,34,276,83,11723
15000US060590627025,510,100,39,30,13,20,26,22,471,100,71,51,400,119,11724
15000US060590628001,374,95,41,67,41,67,0,12,333,79,71,51,262,71,11725
15000US060590628002,581,152,0,12,0,12,0,12,581,152,89,55,492,151,11726
15000US060590628003,552,128,13,20,0,12,13,20,539,128,60,42,479,126,11727
15000US060590628004,361,126,0,12,0,12,0,12,361,126,39,30,322,126,11728
15000US060590629001,420,51,6,8,0,12,6,8,414,50,57,26,357,55,11729
15000US060590629002,330,39,0,12,0,12,0,12,330,39,66,29,264,45,11730
15000US060590630041,762,139,21,32,0,12,21,32,741,142,207,84,534,133,11731
15000US060590630042,1093,173,0,12,0,12,0,12,1093,173,72,53,1021,180,11732
15000US060590630043,548,127,0,12,0,12,0,12,548,127,91,48,457,134,11733
15000US060590630044,632,119,0,12,0,12,0,12,632,119,135,81,497,129,11734
15000US060590630051,385,63,0,12,0,12,0,12,385,63,67,24,318,63,11735
15000US060590630052,390,59,0,12,0,12,0,12,390,59,26,17,364,56,11736
15000US060590630061,597,88,0,12,0,12,0,12,597,88,42,29,555,88,11737
15000US060590630062,865,119,8,13,8,13,0,12,857,118,193,65,664,109,11738
15000US060590630071,616,134,15,24,0,12,15,24,601,135,125,83,476,126,11739
15000US060590630072,879,144,0,12,0,12,0,12,879,144,118,70,761,163,11740
15000US060590630073,927,164,5,11,0,12,5,11,922,164,65,54,857,178,11741
15000US060590630074,367,76,0,12,0,12,0,12,367,76,147,67,220,86,11742
15000US060590630081,498,58,0,12,0,12,0,12,498,58,85,39,413,54,11743
15000US060590630091,692,46,4,7,0,12,4,7,688,46,104,45,584,61,11744
15000US060590630101,497,116,0,12,0,12,0,12,497,116,92,55,405,121,11745
15000US060590630102,1204,200,0,12,0,12,0,12,1204,200,93,99,1111,207,11746
15000US060590630103,885,100,0,12,0,12,0,12,885,100,108,53,777,115,11747
15000US060590630104,603,109,0,12,0,12,0,12,603,109,145,69,458,122,11748
15000US060590631011,919,55,55,49,17,27,38,40,864,66,66,39,798,74,11749
15000US060590631012,309,59,22,26,9,14,13,22,287,57,52,33,235,58,11750
15000US060590631021,849,173,0,12,0,12,0,12,849,173,110,90,739,178,11751
15000US060590631022,699,151,62,80,13,21,49,78,637,157,23,34,614,161,11752
15000US060590631023,628,132,16,26,16,26,0,12,612,138,149,98,463,129,11753
15000US060590631024,609,101,0,12,0,12,0,12,609,101,89,64,520,125,11754
15000US060590631031,496,75,7,12,0,12,7,12,489,75,74,38,415,82,11755
15000US060590631032,518,75,11,17,11,17,0,12,507,77,87,48,420,71,11756
15000US060590632011,488,93,7,12,0,12,7,12,481,93,88,52,393,98,11757
15000US060590632012,483,83,0,12,0,12,0,12,483,83,89,57,394,80,11758
15000US060590632013,647,81,43,53,33,52,10,16,604,92,65,41,539,94,11759
15000US060590632021,356,95,0,12,0,12,0,12,356,95,85,73,271,85,11760
15000US060590632022,371,82,22,23,22,23,0,12,349,82,48,33,301,85,11761
15000US060590632023,411,75,0,12,0,12,0,12,411,75,52,40,359,86,11762
15000US060590632024,356,69,40,41,31,38,9,13,316,71,50,29,266,70,11763
15000US060590633011,567,92,34,42,0,12,34,42,533,90,28,21,505,93,11764
15000US060590633012,453,72,20,22,0,12,20,22,433,76,33,25,400,76,11765
15000US060590633013,353,85,9,14,0,12,9,14,344,88,29,40,315,86,11766
15000US060590633021,446,85,0,12,0,12,0,12,446,85,46,36,400,81,11767
15000US060590633022,414,94,10,15,0,12,10,15,404,95,8,13,396,96,11768
15000US060590633023,538,82,28,39,0,12,28,39,510,83,54,32,456,87,11769
15000US060590633024,316,77,13,20,0,12,13,20,303,75,26,29,277,71,11770
15000US060590634001,378,87,0,12,0,12,0,12,378,87,29,22,349,91,11771
15000US060590634002,378,82,0,12,0,12,0,12,378,82,76,42,302,84,11772
15000US060590634003,410,93,0,12,0,12,0,12,410,93,62,45,348,95,11773
15000US060590634004,276,77,18,19,18,19,0,12,258,78,30,26,228,82,11774
15000US060590634005,466,83,0,12,0,12,0,12,466,83,141,75,325,76,11775
15000US060590635001,756,137,38,62,0,12,38,62,718,135,158,89,560,134,11776
15000US060590635002,489,116,0,12,0,12,0,12,489,116,35,39,454,122,11777
15000US060590635003,367,144,48,74,0,12,48,74,319,137,5,10,314,137,11778
15000US060590635004,420,143,0,12,0,12,0,12,420,143,46,56,374,134,11779
15000US060590635005,329,149,0,12,0,12,0,12,329,149,14,23,315,147,11780
15000US060590635006,492,117,17,27,17,27,0,12,475,114,28,30,447,115,11781
15000US060590636011,705,79,6,9,0,12,6,9,699,80,122,73,577,89,11782
15000US060590636012,456,71,0,12,0,12,0,12,456,71,80,49,376,81,11783
15000US060590636013,234,64,6,9,6,9,0,12,228,64,49,58,179,52,11784
15000US060590636031,667,145,0,12,0,12,0,12,667,145,117,75,550,125,11785
15000US060590636032,631,141,0,12,0,12,0,12,631,141,179,111,452,140,11786
15000US060590636033,1144,196,32,38,0,12,32,38,1112,197,128,77,984,204,11787
15000US060590636034,559,136,69,49,11,16,58,47,490,144,92,89,398,132,11788
15000US060590636041,399,98,47,44,8,14,39,42,352,103,99,61,253,96,11789
15000US060590636042,1044,106,78,52,13,17,65,49,966,117,148,69,818,129,11790
15000US060590636051,367,88,50,38,10,14,40,42,317,89,42,47,275,84,11791
15000US060590636052,724,100,55,46,16,17,39,44,669,106,53,44,616,113,11792
15000US060590636053,410,70,102,61,4,8,98,60,308,77,27,32,281,73,11793
15000US060590637011,367,77,37,34,19,27,18,20,330,81,80,36,250,77,11794
15000US060590637012,404,93,35,34,16,17,19,30,369,91,65,49,304,91,11795
15000US060590637013,458,98,74,55,10,16,64,52,384,92,40,42,344,92,11796
15000US060590637014,350,81,56,36,0,12,56,36,294,82,8,13,286,84,11797
15000US060590637021,405,95,31,41,20,33,11,20,374,92,24,23,350,91,11798
15000US060590637022,298,67,12,19,12,19,0,12,286,68,74,42,212,59,11799
15000US060590637023,410,88,19,21,7,10,12,18,391,88,58,36,333,90,11800
15000US060590637024,552,78,56,53,0,12,56,53,496,95,43,35,453,98,11801
15000US060590637025,372,101,0,12,0,12,0,12,372,101,59,55,313,100,11802
15000US060590638021,606,67,33,25,24,21,9,14,573,70,107,46,466,85,11803
15000US060590638022,414,57,16,19,0,12,16,19,398,59,89,42,309,63,11804
15000US060590638031,347,60,0,12,0,12,0,12,347,60,77,39,270,70,11805
15000US060590638032,510,102,38,51,0,12,38,51,472,95,74,44,398,102,11806
15000US060590638033,441,83,11,16,0,12,11,16,430,84,58,35,372,79,11807
15000US060590638034,379,78,25,29,25,29,0,12,354,76,81,48,273,77,11808
15000US060590638051,418,48,23,21,5,8,18,19,395,47,97,39,298,49,11809
15000US060590638052,465,50,9,11,9,11,0,12,456,54,97,39,359,58,11810
15000US060590638061,439,74,21,30,0,12,21,30,418,79,101,50,317,90,11811
15000US060590638062,400,69,9,14,9,14,0,12,391,71,73,38,318,73,11812
15000US060590638063,577,87,0,12,0,12,0,12,577,87,67,34,510,89,11813
15000US060590638071,1231,119,16,19,0,12,16,19,1215,120,177,81,1038,120,11814
15000US060590638072,732,102,79,46,51,61,28,49,653,108,155,76,498,122,11815
15000US060590638081,880,107,160,71,14,17,146,72,720,108,71,42,649,111,11816
15000US060590638082,629,107,9,14,9,14,0,12,620,106,107,56,513,113,11817
15000US060590639021,728,96,25,30,16,25,9,16,703,96,181,104,522,131,11818
15000US060590639022,750,139,21,35,0,12,21,35,729,138,59,68,670,148,11819
15000US060590639023,392,123,92,85,31,51,61,69,300,107,34,53,266,91,11820
15000US060590639024,743,134,69,67,29,44,40,52,674,137,88,64,586,134,11821
15000US060590639031,633,87,25,23,9,14,16,18,608,87,111,46,497,93,11822
15000US060590639032,454,59,32,42,0,12,32,42,422,62,83,39,339,61,11823
15000US060590639041,475,78,11,17,0,12,11,17,464,77,119,48,345,82,11824
15000US060590639042,535,79,15,24,0,12,15,24,520,80,128,46,392,95,11825
15000US060590639043,289,75,16,17,16,17,0,12,273,76,85,73,188,73,11826
15000US060590639051,618,100,8,13,0,12,8,13,610,100,124,52,486,107,11827
15000US060590639052,578,107,24,26,0,12,24,26,554,108,47,49,507,117,11828
15000US060590639053,581,86,23,35,0,12,23,35,558,85,191,69,367,96,11829
15000US060590639061,781,151,25,29,11,19,14,22,756,157,96,63,660,162,11830
15000US060590639062,570,148,77,74,16,25,61,69,493,137,55,49,438,137,11831
15000US060590639063,1003,175,56,68,56,68,0,12,947,159,12,21,935,158,11832
15000US060590639071,1832,224,0,12,0,12,0,12,1832,224,87,84,1745,212,11833
15000US060590639072,859,106,28,32,0,12,28,32,831,109,184,83,647,122,11834
15000US060590639073,835,147,14,22,0,12,14,22,821,146,176,88,645,149,11835
15000US060590639081,355,84,12,20,12,20,0,12,343,83,41,35,302,97,11836
15000US060590639082,860,152,17,29,0,12,17,29,843,150,59,49,784,152,11837
15000US060590639083,376,120,0,12,0,12,0,12,376,120,38,33,338,119,11838
15000US060590639084,864,159,0,12,0,12,0,12,864,159,49,76,815,159,11839
15000US060590740031,1155,60,65,34,32,25,33,29,1090,63,154,47,936,71,11840
15000US060590740041,681,142,83,66,20,30,63,62,598,142,103,87,495,137,11841
15000US060590740042,410,150,62,80,0,12,62,80,348,162,17,29,331,163,11842
15000US060590740043,458,114,36,53,0,12,36,53,422,121,74,68,348,110,11843
15000US060590740044,693,140,0,12,0,12,0,12,693,140,192,105,501,133,11844
15000US060590740051,238,65,72,58,33,37,39,45,166,58,49,30,117,50,11845
15000US060590740052,419,94,31,36,0,12,31,36,388,91,112,44,276,84,11846
15000US060590740053,501,83,126,63,0,12,126,63,375,87,42,30,333,90,11847
15000US060590740054,380,82,0,12,0,12,0,12,380,82,90,47,290,84,11848
15000US060590740061,358,72,8,11,0,12,8,11,350,72,41,32,309,74,11849
15000US060590740062,740,100,45,42,0,12,45,42,695,104,41,28,654,107,11850
15000US060590740063,861,99,116,59,15,18,101,58,745,109,128,53,617,110,11851
15000US060590741021,410,82,79,63,52,58,27,33,331,87,23,28,308,90,11852
15000US060590741022,415,71,53,43,25,31,28,34,362,64,117,46,245,66,11853
15000US060590741023,510,81,103,71,22,33,81,64,407,73,147,62,260,77,11854
15000US060590741031,301,44,18,14,6,8,12,12,283,46,72,35,211,49,11855
15000US060590741032,206,44,12,10,8,9,4,5,194,45,66,36,128,44,11856
15000US060590741033,427,53,42,27,10,10,32,27,385,58,68,39,317,63,11857
15000US060590741061,793,111,41,29,0,12,41,29,752,108,140,59,612,111,11858
15000US060590741062,689,96,64,42,23,31,41,36,625,106,201,89,424,95,11859
15000US060590741063,398,84,37,36,12,18,25,31,361,82,50,36,311,80,11860
15000US060590741071,655,167,94,96,0,12,94,96,561,147,185,104,376,129,11861
15000US060590741072,1165,176,0,12,0,12,0,12,1165,176,159,88,1006,185,11862
15000US060590741073,623,115,64,56,0,12,64,56,559,118,39,34,520,123,11863
15000US060590741081,582,60,145,64,75,47,70,47,437,76,142,55,295,71,11864
15000US060590741082,323,54,52,38,7,10,45,36,271,53,75,35,196,55,11865
15000US060590741091,359,43,58,32,24,21,34,26,301,47,87,27,214,48,11866
15000US060590741092,308,47,127,41,22,27,105,35,181,48,41,25,140,45,11867
15000US060590741101,606,63,46,36,25,26,21,23,560,60,167,57,393,68,11868
15000US060590741102,348,60,4,7,0,12,4,7,344,61,72,31,272,67,11869
15000US060590741111,392,97,23,37,0,12,23,37,369,95,48,35,321,107,11870
15000US060590741112,250,66,19,26,0,12,19,26,231,71,49,47,182,71,11871
15000US060590741113,722,101,90,48,78,47,12,14,632,100,125,65,507,95,11872
15000US060590742001,274,63,22,34,0,12,22,34,252,61,66,41,186,59,11873
15000US060590742002,291,71,76,61,0,12,76,61,215,64,31,24,184,63,11874
15000US060590742003,625,89,96,54,9,14,87,53,529,103,132,78,397,99,11875
15000US060590742004,553,101,179,85,53,44,126,77,374,89,119,65,255,78,11876
15000US060590743001,454,50,88,37,5,8,83,36,366,57,59,32,307,58,11877
15000US060590743002,340,46,42,25,18,17,24,19,298,49,67,32,231,50,11878
15000US060590744031,722,85,146,56,97,55,49,35,576,93,209,91,367,94,11879
15000US060590744032,573,81,271,80,32,34,239,72,302,88,70,57,232,83,11880
15000US060590744051,396,89,144,73,69,57,75,51,252,75,77,54,175,65,11881
15000US060590744052,762,83,162,65,72,39,90,54,600,98,137,66,463,95,11882
15000US060590744053,332,61,60,41,7,11,53,40,272,67,98,59,174,68,11883
15000US060590744061,205,36,32,27,22,22,10,15,173,37,58,33,115,37,11884
15000US060590744062,271,42,52,30,21,19,31,25,219,42,91,37,128,46,11885
15000US060590744063,287,51,53,27,35,22,18,21,234,51,102,35,132,47,11886
15000US060590744071,616,86,200,71,47,41,153,62,416,88,136,71,280,84,11887
15000US060590744072,1070,106,181,81,75,55,106,61,889,103,155,47,734,105,11888
15000US060590744081,791,119,104,71,19,23,85,64,687,122,154,61,533,113,11889
15000US060590744082,359,89,41,51,0,12,41,51,318,90,74,50,244,80,11890
15000US060590744083,474,108,73,61,43,49,30,40,401,106,65,36,336,108,11891
15000US060590745011,349,85,67,46,16,25,51,45,282,77,59,39,223,79,11892
15000US060590745012,492,84,181,68,86,62,95,59,311,85,158,66,153,67,11893
15000US060590745013,224,67,110,60,46,35,64,51,114,69,63,51,51,47,11894
15000US060590745014,333,69,25,30,0,12,25,30,308,68,94,55,214,71,11895
15000US060590745021,573,61,97,45,11,12,86,48,476,69,111,36,365,77,11896
15000US060590745022,442,57,107,51,39,34,68,42,335,62,32,27,303,58,11897
15000US060590746011,231,70,63,60,63,60,0,12,168,66,26,42,142,70,11898
15000US060590746012,364,97,58,61,30,43,28,43,306,83,162,80,144,72,11899
15000US060590746013,259,84,76,65,28,47,48,51,183,68,87,60,96,53,11900
15000US060590746014,398,91,106,74,37,45,69,61,292,75,46,34,246,79,11901
15000US060590746015,456,105,35,35,0,12,35,35,421,110,54,37,367,108,11902
15000US060590746021,183,73,15,18,6,10,9,15,168,72,14,17,154,73,11903
15000US060590746022,428,82,136,64,43,46,93,57,292,74,121,56,171,62,11904
15000US060590746023,302,66,40,33,21,26,19,19,262,66,81,49,181,70,11905
15000US060590746024,458,77,29,36,0,12,29,36,429,73,168,80,261,76,11906
15000US060590746025,270,77,28,35,7,11,21,33,242,71,78,48,164,65,11907
15000US060590747011,492,104,161,91,48,49,113,89,331,89,78,49,253,87,11908
15000US060590747012,452,117,161,98,47,46,114,91,291,95,130,67,161,88,11909
15000US060590747013,507,125,102,75,12,19,90,72,405,123,166,98,239,97,11910
15000US060590747021,339,65,4,7,0,12,4,7,335,64,62,44,273,64,11911
15000US060590747022,377,78,74,45,24,28,50,38,303,77,181,70,122,62,11912
15000US060590747023,393,73,130,60,31,31,99,54,263,75,52,37,211,73,11913
15000US060590748011,291,55,74,38,24,26,50,34,217,60,70,46,147,51,11914
15000US060590748012,325,54,98,38,23,20,75,31,227,56,77,34,150,52,11915
15000US060590748013,369,54,88,42,27,19,61,35,281,57,81,35,200,58,11916
15000US060590748021,284,76,134,63,64,44,70,59,150,67,21,16,129,63,11917
15000US060590748022,490,98,154,76,35,30,119,70,336,91,77,60,259,87,11918
15000US060590748023,482,94,178,86,48,43,130,76,304,90,59,55,245,96,11919
15000US060590748031,1091,103,187,84,49,34,138,79,904,125,308,76,596,124,11920
15000US060590748032,495,82,75,41,25,25,50,34,420,78,102,55,318,85,11921
15000US060590748033,243,71,70,49,48,48,22,19,173,54,65,48,108,49,11922
15000US060590748051,751,51,276,66,19,19,257,67,475,67,107,42,368,69,11923
15000US060590748052,244,38,73,30,60,27,13,15,171,41,58,32,113,35,11924
15000US060590748061,420,53,193,51,34,28,159,48,227,44,26,16,201,47,11925
15000US060590748062,492,55,106,43,38,28,68,32,386,63,153,50,233,56,11926
15000US060590749011,302,75,74,38,29,32,45,40,228,71,35,32,193,65,11927
15000US060590749012,526,95,70,45,0,12,70,45,456,94,174,59,282,88,11928
15000US060590749013,281,79,14,25,0,12,14,25,267,80,40,28,227,84,11929
15000US060590749014,400,92,86,55,16,25,70,49,314,95,67,55,247,89,11930
15000US060590749015,337,84,73,49,20,32,53,48,264,80,13,15,251,79,11931
15000US060590749021,438,78,132,61,41,35,91,53,306,72,56,47,250,78,11932
15000US060590749022,301,72,90,61,38,40,52,45,211,75,59,50,152,66,11933
15000US060590749023,417,81,132,62,17,27,115,58,285,88,49,40,236,79,11934
15000US060590750021,528,114,121,80,26,30,95,74,407,108,141,78,266,112,11935
15000US060590750022,582,103,110,83,29,45,81,70,472,103,158,86,314,88,11936
15000US060590750023,602,127,195,105,0,12,195,105,407,132,147,94,260,117,11937
15000US060590750024,617,88,28,44,28,44,0,12,589,92,262,80,327,92,11938
15000US060590750031,384,69,112,50,52,40,60,47,272,73,55,44,217,67,11939
15000US060590750032,657,90,199,68,65,39,134,58,458,100,66,43,392,95,11940
15000US060590750033,618,84,110,58,7,13,103,56,508,98,81,50,427,98,11941
15000US060590750041,766,100,240,79,83,54,157,74,526,118,70,57,456,122,11942
15000US060590750042,543,90,246,79,91,62,155,74,297,88,109,57,188,79,11943
15000US060590751001,404,107,152,81,71,62,81,60,252,93,62,32,190,90,11944
15000US060590751002,343,68,42,35,6,9,36,34,301,64,39,31,262,67,11945
15000US060590751003,692,96,50,46,10,16,40,45,642,108,88,45,554,111,11946
15000US060590751004,576,94,70,60,15,24,55,52,506,94,137,60,369,94,11947
15000US060590752011,640,96,120,69,56,48,64,51,520,105,148,71,372,93,11948
15000US060590752012,457,96,49,39,9,13,40,36,408,93,105,55,303,90,11949
15000US060590752021,500,69,91,57,23,22,68,54,409,88,131,64,278,83,11950
15000US060590752022,628,73,105,72,16,20,89,69,523,99,182,63,341,95,11951
15000US060590753011,632,112,78,65,41,53,37,41,554,126,79,56,475,108,11952
15000US060590753012,316,65,12,19,12,19,0,12,304,67,68,45,236,64,11953
15000US060590753013,609,99,54,56,46,54,8,13,555,102,190,84,365,92,11954
15000US060590753021,502,69,26,36,0,12,26,36,476,71,92,44,384,74,11955
15000US060590753022,602,81,16,19,4,9,12,17,586,85,131,35,455,90,11956
15000US060590753031,378,94,60,60,33,49,27,36,318,96,98,61,220,83,11957
15000US060590753032,397,59,0,12,0,12,0,12,397,59,109,48,288,56,11958
15000US060590753033,386,61,21,20,12,14,9,14,365,64,52,28,313,63,11959
15000US060590754011,537,75,10,16,0,12,10,16,527,75,77,42,450,75,11960
15000US060590754012,676,75,23,21,0,12,23,21,653,78,214,75,439,83,11961
15000US060590754031,546,110,0,12,0,12,0,12,546,110,105,70,441,108,11962
15000US060590754032,419,101,54,56,30,48,24,29,365,105,123,82,242,97,11963
15000US060590754033,1066,163,65,47,37,34,28,32,1001,168,201,140,800,162,11964
15000US060590754034,405,109,21,16,12,18,9,12,384,109,87,54,297,122,11965
15000US060590754041,507,138,20,32,0,12,20,32,487,134,150,77,337,131,11966
15000US060590754042,451,123,50,63,50,63,0,12,401,119,95,56,306,122,11967
15000US060590754043,356,121,43,68,43,68,0,12,313,106,121,106,192,112,11968
15000US060590754044,688,151,81,54,27,48,54,46,607,155,57,48,550,161,11969
15000US060590754051,561,60,59,42,24,32,35,29,502,58,93,41,409,60,11970
15000US060590754052,410,55,50,41,32,28,18,28,360,64,132,45,228,59,11971
15000US060590755041,1070,72,82,48,58,42,24,22,988,82,333,74,655,93,11972
15000US060590755042,476,62,42,35,19,22,23,27,434,64,45,30,389,68,11973
15000US060590755051,573,86,10,15,0,12,10,15,563,88,79,46,484,92,11974
15000US060590755052,742,76,32,25,17,10,15,25,710,80,98,52,612,89,11975
15000US060590755061,678,68,14,19,5,9,9,16,664,73,165,68,499,78,11976
15000US060590755062,517,70,0,12,0,12,0,12,517,70,96,36,421,73,11977
15000US060590755071,685,104,61,44,27,35,34,27,624,102,153,60,471,92,11978
15000US060590755072,419,80,112,67,43,48,69,52,307,79,8,13,299,79,11979
15000US060590755073,827,94,47,29,31,22,16,18,780,91,149,53,631,95,11980
15000US060590755121,687,78,124,65,0,12,124,65,563,88,88,52,475,89,11981
15000US060590755122,522,76,53,48,25,40,28,23,469,88,69,36,400,82,11982
15000US060590755131,908,104,88,55,29,25,59,52,820,117,145,72,675,110,11983
15000US060590755132,621,102,41,37,34,36,7,11,580,99,67,39,513,105,11984
15000US060590755141,723,79,64,44,26,29,38,35,659,81,91,47,568,88,11985
15000US060590755142,444,70,98,47,36,35,62,38,346,72,47,43,299,68,11986
15000US060590755151,2084,321,84,91,49,70,35,57,2000,322,231,194,1769,337,11987
15000US060590755152,687,186,28,40,28,40,0,12,659,193,82,99,577,203,11988
15000US060590755153,1497,275,264,225,103,129,161,177,1233,293,232,215,1001,252,11989
15000US060590755154,1884,259,71,57,39,46,32,50,1813,259,285,126,1528,262,11990
15000US060590756031,472,71,6,10,6,10,0,12,466,71,78,40,388,76,11991
15000US060590756032,460,81,8,13,0,12,8,13,452,81,170,74,282,64,11992
15000US060590756033,513,66,0,12,0,12,0,12,513,66,132,54,381,71,11993
15000US060590756041,501,78,0,12,0,12,0,12,501,78,13,20,488,76,11994
15000US060590756042,653,95,0,12,0,12,0,12,653,95,207,93,446,101,11995
15000US060590756043,285,63,0,12,0,12,0,12,285,63,33,38,252,64,11996
15000US060590756044,421,90,0,12,0,12,0,12,421,90,86,78,335,75,11997
15000US060590756045,822,136,16,20,0,12,16,20,806,133,347,147,459,114,11998
15000US060590756051,281,66,0,12,0,12,0,12,281,66,85,62,196,71,11999
15000US060590756052,514,83,16,25,0,12,16,25,498,86,13,21,485,88,12000
15000US060590756053,344,82,0,12,0,12,0,12,344,82,34,40,310,83,12001
15000US060590756054,626,121,0,12,0,12,0,12,626,121,0,12,626,121,12002
15000US060590756055,321,62,5,10,0,12,5,10,316,62,85,59,231,66,12003
15000US060590756061,643,117,0,12,0,12,0,12,643,117,169,114,474,119,12004
15000US060590756062,202,51,0,12,0,12,0,12,202,51,16,26,186,45,12005
15000US060590756063,575,111,0,12,0,12,0,12,575,111,130,78,445,106,12006
15000US060590756064,1054,108,0,12,0,12,0,12,1054,108,158,106,896,126,12007
15000US060590756071,289,74,0,12,0,12,0,12,289,74,41,29,248,79,12008
15000US060590756072,1045,197,14,21,14,21,0,12,1031,198,85,71,946,196,12009
15000US060590756073,510,113,14,23,0,12,14,23,496,117,89,95,407,103,12010
15000US060590756074,487,117,0,12,0,12,0,12,487,117,0,12,487,117,12011
15000US060590756075,313,89,34,38,19,30,15,24,279,98,102,66,177,88,12012
15000US060590757011,536,91,7,14,0,12,7,14,529,96,140,69,389,99,12013
15000US060590757012,682,135,108,83,0,12,108,83,574,142,76,97,498,141,12014
15000US060590757013,311,118,0,12,0,12,0,12,311,118,30,37,281,124,12015
15000US060590757014,592,120,34,51,0,12,34,51,558,116,102,58,456,121,12016
15000US060590757021,340,54,0,12,0,12,0,12,340,54,110,50,230,54,12017
15000US060590757022,331,53,26,23,16,18,10,15,305,56,35,22,270,55,12018
15000US060590757023,501,68,0,12,0,12,0,12,501,68,169,69,332,65,12019
15000US060590757031,727,66,0,12,0,12,0,12,727,66,141,61,586,76,12020
15000US060590757032,690,62,0,12,0,12,0,12,690,62,112,50,578,77,12021
15000US060590758051,363,98,88,64,29,29,59,62,275,80,15,16,260,78,12022
15000US060590758052,479,64,0,12,0,12,0,12,479,64,103,47,376,70,12023
15000US060590758053,458,96,16,17,16,17,0,12,442,97,31,26,411,96,12024
15000US060590758061,385,112,0,12,0,12,0,12,385,112,121,103,264,79,12025
15000US060590758062,343,99,27,41,27,41,0,12,316,100,57,43,259,100,12026
15000US060590758063,351,116,26,43,0,12,26,43,325,115,51,35,274,114,12027
15000US060590758064,593,129,72,108,0,12,72,108,521,133,124,68,397,127,12028
15000US060590758065,400,153,58,57,0,12,58,57,342,147,94,82,248,149,12029
15000US060590758071,318,72,0,12,0,12,0,12,318,72,121,60,197,71,12030
15000US060590758072,607,87,0,12,0,12,0,12,607,87,94,35,513,83,12031
15000US060590758073,278,68,47,31,0,12,47,31,231,67,60,36,171,71,12032
15000US060590758081,521,61,7,11,7,11,0,12,514,62,145,55,369,69,12033
15000US060590758082,573,70,27,28,18,24,9,14,546,73,134,51,412,73,12034
15000US060590758091,367,68,13,16,13,16,0,12,354,69,71,41,283,71,12035
15000US060590758092,341,61,0,12,0,12,0,12,341,61,79,36,262,62,12036
15000US060590758093,323,68,0,12,0,12,0,12,323,68,91,57,232,59,12037
15000US060590758101,489,57,14,21,14,21,0,12,475,60,125,49,350,75,12038
15000US060590758102,521,62,9,13,0,12,9,13,512,66,174,59,338,78,12039
15000US060590758111,537,45,14,11,9,10,5,7,523,46,102,30,421,51,12040
15000US060590758112,259,42,97,43,35,22,62,39,162,45,27,20,135,43,12041
15000US060590758121,716,82,144,78,40,47,104,63,572,106,101,47,471,106,12042
15000US060590758122,393,58,27,32,19,30,8,12,366,59,71,35,295,58,12043
15000US060590758123,373,54,8,13,0,12,8,13,365,56,65,35,300,58,12044
15000US060590758124,344,48,15,16,0,12,15,16,329,50,65,37,264,57,12045
15000US060590758131,686,68,12,14,7,10,5,9,674,68,98,39,576,75,12046
15000US060590758132,259,73,19,31,0,12,19,31,240,73,82,46,158,80,12047
15000US060590758133,702,89,17,25,0,12,17,25,685,84,124,43,561,89,12048
15000US060590758141,755,78,0,12,0,12,0,12,755,78,118,49,637,88,12049
15000US060590758142,271,48,0,12,0,12,0,12,271,48,62,46,209,50,12050
15000US060590758151,652,71,23,26,0,12,23,26,629,74,89,65,540,89,12051
15000US060590758152,574,86,143,81,14,16,129,79,431,84,141,70,290,85,12052
15000US060590758153,283,54,8,13,0,12,8,13,275,56,80,40,195,65,12053
15000US060590758161,724,78,88,60,0,12,88,60,636,87,87,43,549,96,12054
15000US060590758162,460,82,22,34,0,12,22,34,438,81,51,31,387,83,12055
15000US060590759011,245,48,8,11,0,12,8,11,237,49,29,28,208,57,12056
15000US060590759012,318,65,0,12,0,12,0,12,318,65,19,19,299,69,12057
15000US060590759013,928,91,22,26,0,12,22,26,906,91,148,63,758,99,12058
15000US060590759021,457,137,0,12,0,12,0,12,457,137,43,46,414,136,12059
15000US060590759022,809,161,46,57,0,12,46,57,763,159,224,108,539,158,12060
15000US060590759023,500,124,9,20,9,20,0,12,491,127,38,35,453,131,12061
15000US060590759024,662,137,58,64,0,12,58,64,604,131,201,145,403,112,12062
15000US060590759025,260,77,0,12,0,12,0,12,260,77,74,47,186,81,12063
15000US060590760001,344,116,11,19,11,19,0,12,333,114,75,75,258,100,12064
15000US060590760002,1330,164,15,25,0,12,15,25,1315,168,142,67,1173,179,12065
15000US060590760003,509,142,54,72,0,12,54,72,455,139,151,78,304,118,12066
15000US060590760004,574,114,12,21,0,12,12,21,562,118,100,58,462,119,12067
15000US060590760005,395,118,87,57,18,28,69,53,308,119,34,39,274,122,12068
15000US060590761011,2305,234,66,86,0,17,66,86,2239,240,286,116,1953,225,12069
15000US060590761012,451,96,14,22,0,12,14,22,437,94,114,72,323,109,12070
15000US060590761013,344,132,17,27,17,27,0,12,327,128,58,52,269,121,12071
15000US060590761014,427,107,57,72,0,12,57,72,370,97,166,85,204,81,12072
15000US060590761021,367,68,41,34,23,23,18,28,326,69,35,27,291,70,12073
15000US060590761022,0,12,0,12,0,12,0,12,0,12,0,12,0,12,12074
15000US060590761023,673,90,101,61,46,37,55,40,572,89,218,84,354,82,12075
15000US060590761024,549,86,0,12,0,12,0,12,549,86,25,23,524,89,12076
15000US060590761031,369,83,50,66,11,20,39,64,319,116,100,52,219,114,12077
15000US060590761032,519,113,25,20,0,12,25,20,494,111,101,71,393,125,12078
15000US060590761033,776,135,110,80,25,29,85,76,666,132,109,71,557,131,12079
15000US060590761034,838,147,49,46,49,46,0,12,789,157,97,61,692,169,12080
15000US060590762011,444,101,27,38,27,38,0,12,417,92,45,32,372,94,12081
15000US060590762012,145,54,0,12,0,12,0,12,145,54,11,18,134,55,12082
15000US060590762013,485,133,52,74,0,12,52,74,433,130,49,46,384,135,12083
15000US060590762014,302,88,23,38,0,12,23,38,279,93,134,76,145,59,12084
15000US060590762015,940,129,34,36,13,20,21,32,906,135,86,64,820,135,12085
15000US060590762021,451,86,39,40,20,22,19,32,412,88,120,58,292,83,12086
15000US060590762022,379,70,19,20,19,20,0,12,360,72,56,36,304,71,12087
15000US060590762023,676,100,21,22,21,22,0,12,655,104,104,48,551,115,12088
15000US060590762024,371,71,7,11,7,11,0,12,364,71,59,34,305,80,12089
15000US060590762041,223,57,0,12,0,12,0,12,223,57,58,32,165,68,12090
15000US060590762042,510,97,27,32,27,32,0,12,483,96,93,50,390,104,12091
15000US060590762043,409,93,238,101,9,17,229,100,171,72,28,27,143,70,12092
15000US060590762051,287,64,10,17,0,12,10,17,277,65,57,46,220,63,12093
15000US060590762052,417,66,10,15,0,12,10,15,407,66,68,44,339,74,12094
15000US060590762053,645,87,25,20,25,20,0,12,620,94,137,64,483,93,12095
15000US060590762054,229,60,0,12,0,12,0,12,229,60,26,25,203,63,12096
15000US060590762061,487,81,69,48,14,25,55,59,418,82,79,52,339,76,12097
15000US060590762062,352,72,8,20,0,12,8,20,344,69,84,59,260,73,12098
15000US060590762063,280,58,0,12,0,12,0,12,280,58,46,38,234,62,12099
15000US060590762064,439,62,7,12,0,12,7,12,432,63,99,48,333,70,12100
15000US060590762081,559,85,0,12,0,12,0,12,559,85,95,39,464,84,12101
15000US060590762082,241,56,7,12,7,12,0,12,234,54,63,43,171,52,12102
15000US060590762083,486,69,52,35,33,27,19,19,434,74,122,36,312,76,12103
15000US060590762084,313,72,45,47,0,12,45,47,268,66,23,21,245,68,12104
15000US060590863011,652,121,109,78,18,19,91,76,543,116,123,71,420,107,12105
15000US060590863012,617,105,16,18,11,16,5,9,601,107,218,87,383,94,12106
15000US060590863013,489,110,146,82,20,32,126,86,343,87,86,38,257,82,12107
15000US060590863031,1213,207,0,12,0,12,0,12,1213,207,109,97,1104,201,12108
15000US060590863032,690,161,38,45,23,37,15,25,652,167,124,73,528,163,12109
15000US060590863033,658,151,30,35,14,22,16,27,628,151,114,66,514,156,12110
15000US060590863041,672,100,51,43,8,12,43,40,621,104,58,33,563,108,12111
15000US060590863042,287,72,16,18,0,12,16,18,271,72,57,47,214,75,12112
15000US060590863043,736,99,102,60,52,36,50,49,634,104,135,55,499,96,12113
15000US060590863051,493,82,33,25,9,14,24,20,460,79,229,69,231,66,12114
15000US060590863052,342,74,16,17,16,17,0,12,326,76,128,84,198,61,12115
15000US060590863053,265,69,0,12,0,12,0,12,265,69,62,39,203,67,12116
15000US060590863061,252,60,45,43,10,18,35,42,207,52,61,31,146,50,12117
15000US060590863062,556,88,65,47,18,20,47,43,491,96,36,31,455,98,12118
15000US060590863063,397,96,9,13,9,13,0,12,388,97,115,61,273,105,12119
15000US060590864021,780,88,139,68,93,65,46,44,641,108,104,49,537,106,12120
15000US060590864022,275,56,0,12,0,12,0,12,275,56,107,62,168,61,12121
15000US060590864023,341,68,24,26,24,26,0,12,317,68,59,43,258,68,12122
15000US060590864041,678,108,84,63,58,58,26,23,594,117,224,110,370,112,12123
15000US060590864042,439,86,103,68,38,37,65,61,336,94,66,45,270,89,12124
15000US060590864043,321,81,40,43,8,12,32,42,281,86,57,35,224,83,12125
15000US060590864051,349,72,38,37,28,36,10,15,311,65,76,50,235,66,12126
15000US060590864052,324,84,86,61,56,54,30,32,238,94,43,29,195,89,12127
15000US060590864053,576,97,128,72,22,25,106,68,448,87,123,65,325,83,12128
15000US060590864054,401,74,60,52,19,30,41,43,341,74,69,36,272,79,12129
15000US060590864061,333,99,0,12,0,12,0,12,333,99,68,66,265,92,12130
15000US060590864062,360,94,16,19,8,14,8,13,344,98,90,74,254,88,12131
15000US060590864063,293,75,9,14,9,14,0,12,284,75,88,62,196,70,12132
15000US060590864064,372,97,15,20,0,12,15,20,357,99,72,36,285,104,12133
15000US060590864071,548,126,115,96,19,29,96,95,433,120,122,58,311,110,12134
15000US060590864072,698,122,99,62,0,12,99,62,599,123,155,85,444,131,12135
15000US060590864073,738,122,37,31,21,26,16,26,701,126,126,80,575,129,12136
15000US060590865011,384,88,38,39,30,37,8,13,346,85,107,61,239,76,12137
15000US060590865012,413,86,72,53,22,30,50,45,341,82,38,28,303,80,12138
15000US060590865013,311,73,58,46,0,12,58,46,253,70,83,47,170,68,12139
15000US060590865021,338,72,92,53,11,16,81,49,246,69,72,46,174,52,12140
15000US060590865022,436,80,182,56,75,60,107,51,254,71,41,34,213,79,12141
15000US060590865023,576,87,137,73,0,12,137,73,439,93,108,50,331,86,12142
15000US060590866011,442,116,182,107,0,12,182,107,260,105,56,53,204,92,12143
15000US060590866012,399,108,104,83,24,39,80,75,295,96,20,26,275,91,12144
15000US060590866013,524,116,140,78,42,44,98,72,384,122,61,48,323,114,12145
15000US060590866014,484,115,145,86,79,67,66,58,339,100,74,57,265,101,12146
15000US060590866015,536,122,131,95,65,75,66,61,405,130,146,89,259,116,12147
15000US060590866021,380,74,62,51,37,42,25,29,318,66,71,33,247,71,12148
15000US060590866022,596,96,165,74,10,16,155,74,431,112,17,19,414,111,12149
15000US060590866023,674,79,93,43,49,36,44,32,581,87,143,66,438,85,12150
15000US060590867011,286,109,12,19,12,19,0,12,274,108,65,46,209,118,12151
15000US060590867012,356,92,42,64,42,64,0,12,314,94,73,55,241,96,12152
15000US060590867013,705,135,24,30,24,30,0,12,681,134,131,78,550,144,12153
15000US060590867014,998,165,106,90,27,43,79,80,892,163,255,99,637,158,12154
15000US060590867021,448,103,78,54,28,34,50,44,370,99,35,24,335,96,12155
15000US060590867022,869,121,267,97,24,18,243,96,602,110,168,91,434,102,12156
15000US060590867023,561,94,140,80,73,60,67,52,421,96,123,61,298,86,12157
15000US060590868011,386,65,17,24,0,12,17,24,369,68,72,30,297,68,12158
15000US060590868012,268,58,5,8,0,12,5,8,263,58,45,28,218,61,12159
15000US060590868013,313,65,54,51,16,18,38,50,259,69,120,45,139,60,12160
15000US060590868021,457,95,14,17,0,12,14,17,443,98,135,63,308,99,12161
15000US060590868022,662,88,110,70,36,47,74,59,552,89,119,54,433,94,12162
15000US060590868023,385,91,0,12,0,12,0,12,385,91,98,38,287,97,12163
15000US060590868031,701,206,190,127,41,55,149,114,511,191,66,50,445,204,12164
15000US060590868032,781,132,99,90,15,26,84,86,682,120,193,83,489,135,12165
15000US060590868033,1003,199,111,81,0,12,111,81,892,192,192,84,700,183,12166
15000US060590868034,223,108,0,12,0,12,0,12,223,108,65,62,158,105,12167
15000US060590869011,578,119,121,77,17,29,104,73,457,121,181,88,276,110,12168
15000US060590869012,461,115,94,71,16,25,78,67,367,103,63,47,304,103,12169
15000US060590869013,515,104,26,43,0,12,26,43,489,108,109,67,380,106,12170
15000US060590869014,207,109,74,80,0,12,74,80,133,93,28,43,105,88,12171
15000US060590869015,702,125,149,76,32,49,117,63,553,126,205,76,348,121,12172
15000US060590869021,424,100,71,63,21,25,50,63,353,102,106,64,247,88,12173
15000US060590869022,586,121,43,36,32,30,11,17,543,123,150,65,393,125,12174
15000US060590869023,722,115,51,39,5,13,46,38,671,114,261,103,410,90,12175
15000US060590869031,676,95,213,97,13,19,200,98,463,99,41,27,422,99,12176
15000US060590869032,480,100,21,22,0,12,21,22,459,102,58,33,401,104,12177
15000US060590869033,276,50,29,26,15,19,14,18,247,56,58,34,189,49,12178
15000US060590869034,507,86,64,48,18,23,46,41,443,89,142,66,301,82,12179
15000US060590870011,339,97,27,31,10,17,17,27,312,95,72,51,240,76,12180
15000US060590870012,586,112,99,65,0,12,99,65,487,117,74,39,413,114,12181
15000US060590870013,557,80,22,24,22,24,0,12,535,81,83,43,452,84,12182
15000US060590870021,301,81,61,46,45,44,16,19,240,78,31,31,209,81,12183
15000US060590870022,496,132,71,66,34,46,37,49,425,133,120,80,305,116,12184
15000US060590870023,593,140,17,30,0,12,17,30,576,139,82,70,494,126,12185
15000US060590870024,868,157,97,91,17,23,80,87,771,157,148,80,623,170,12186
15000US060590871011,282,52,0,12,0,12,0,12,282,52,59,35,223,51,12187
15000US060590871012,1107,107,68,47,29,35,39,32,1039,116,165,85,874,126,12188
15000US060590871013,370,56,77,49,11,17,66,48,293,65,67,41,226,68,12189
15000US060590871021,351,84,76,53,13,23,63,50,275,83,55,44,220,80,12190
15000US060590871022,1039,109,128,68,9,14,119,65,911,115,180,82,731,119,12191
15000US060590871023,293,74,53,48,35,44,18,21,240,75,49,37,191,71,12192
15000US060590871031,546,123,69,79,21,28,48,73,477,130,113,82,364,122,12193
15000US060590871032,681,125,43,42,34,40,9,16,638,138,103,67,535,148,12194
15000US060590871033,403,105,65,83,0,12,65,83,338,120,43,42,295,130,12195
15000US060590871034,509,143,77,58,28,33,49,46,432,139,69,45,363,133,12196
15000US060590871051,442,93,90,57,42,45,48,44,352,95,58,35,294,99,12197
15000US060590871052,926,103,61,37,7,13,54,34,865,103,246,97,619,120,12198
15000US060590871061,774,98,199,102,0,12,199,102,575,106,96,38,479,116,12199
15000US060590871062,754,96,29,33,29,33,0,12,725,96,282,81,443,101,12200
15000US060590872001,830,144,67,86,67,86,0,12,763,130,222,117,541,125,12201
15000US060590872002,1101,158,55,68,38,60,17,27,1046,165,107,62,939,180,12202
15000US060590872003,251,117,13,22,13,22,0,12,238,124,70,66,168,119,12203
15000US060590872004,418,128,30,47,0,12,30,47,388,130,29,35,359,134,12204
15000US060590873001,320,151,239,140,11,17,228,139,81,74,17,28,64,68,12205
15000US060590873002,1080,175,55,70,0,12,55,70,1025,171,115,84,910,190,12206
15000US060590873003,599,129,113,82,51,59,62,59,486,127,93,87,393,123,12207
15000US060590873004,398,113,43,52,43,52,0,12,355,116,104,73,251,111,12208
15000US060590873005,550,143,89,80,0,12,89,80,461,139,148,100,313,106,12209
15000US060590874011,752,97,45,38,15,18,30,35,707,100,125,67,582,94,12210
15000US060590874012,618,99,33,30,19,25,14,17,585,96,133,61,452,109,12211
15000US060590874031,289,52,27,23,13,19,14,14,262,56,77,37,185,45,12212
15000US060590874032,403,52,171,44,7,9,164,44,232,53,12,14,220,52,12213
15000US060590874041,632,49,181,57,72,38,109,44,451,60,141,56,310,64,12214
15000US060590874042,242,48,14,13,14,13,0,12,228,47,66,36,162,49,12215
15000US060590874051,229,73,48,44,22,34,26,30,181,66,21,24,160,65,12216
15000US060590874052,394,76,116,69,33,32,83,61,278,73,38,29,240,74,12217
15000US060590874053,704,99,264,76,57,55,207,69,440,96,73,43,367,103,12218
15000US060590875031,296,101,104,76,21,25,83,73,192,86,68,64,124,61,12219
15000US060590875032,740,101,33,38,4,9,29,37,707,96,141,54,566,100,12220
15000US060590875033,309,69,28,27,11,19,17,19,281,70,28,25,253,72,12221
15000US060590875034,371,115,29,34,9,14,20,31,342,114,29,30,313,120,12222
15000US060590875041,221,55,29,29,0,12,29,29,192,56,45,38,147,49,12223
15000US060590875042,745,95,233,69,52,36,181,65,512,110,124,53,388,99,12224
15000US060590875043,347,71,133,56,9,15,124,55,214,78,32,31,182,73,12225
15000US060590875044,339,70,53,45,7,10,46,43,286,57,52,37,234,53,12226
15000US060590875051,536,107,19,21,0,12,19,21,517,106,154,86,363,124,12227
15000US060590875052,343,111,101,71,28,45,73,58,242,99,82,69,160,95,12228
15000US060590875053,529,112,201,95,98,73,103,63,328,110,56,48,272,99,12229
15000US060590876011,394,93,74,47,0,12,74,47,320,99,27,20,293,97,12230
15000US060590876012,388,96,24,33,5,10,19,32,364,95,77,44,287,94,12231
15000US060590876013,612,91,73,51,17,18,56,46,539,89,139,69,400,95,12232
15000US060590876021,253,85,17,26,0,12,17,26,236,87,52,50,184,89,12233
15000US060590876022,477,139,55,84,0,12,55,84,422,130,31,36,391,130,12234
15000US060590876023,817,150,208,151,16,25,192,151,609,183,113,104,496,169,12235
15000US060590876024,273,100,0,12,0,12,0,12,273,100,70,62,203,89,12236
15000US060590876025,289,86,18,26,0,12,18,26,271,91,31,34,240,81,12237
15000US060590877011,260,68,68,45,35,31,33,32,192,59,50,33,142,57,12238
15000US060590877012,706,100,63,46,18,28,45,32,643,109,132,71,511,114,12239
15000US060590877013,396,94,11,17,0,12,11,17,385,96,42,31,343,106,12240
15000US060590877014,291,77,62,45,34,47,28,28,229,66,70,45,159,58,12241
15000US060590877031,428,101,72,60,4,9,68,60,356,98,103,65,253,87,12242
15000US060590877032,400,84,31,32,18,23,13,20,369,89,67,38,302,90,12243
15000US060590877033,308,79,9,14,0,12,9,14,299,81,64,48,235,76,12244
15000US060590877034,349,66,43,49,0,12,43,49,306,81,98,52,208,88,12245
15000US060590877041,205,58,18,28,0,12,18,28,187,56,24,24,163,54,12246
15000US060590877042,327,49,11,17,0,12,11,17,316,50,142,50,174,58,12247
15000US060590877043,307,55,0,12,0,12,0,12,307,55,88,50,219,61,12248
15000US060590877044,434,80,24,39,0,12,24,39,410,80,48,29,362,79,12249
15000US060590878011,651,85,92,57,14,24,78,51,559,103,114,50,445,100,12250
15000US060590878012,654,103,136,63,60,37,76,59,518,107,126,51,392,113,12251
15000US060590878013,323,78,0,12,0,12,0,12,323,78,68,33,255,83,12252
15000US060590878021,705,148,131,97,49,56,82,82,574,139,57,40,517,140,12253
15000US060590878022,795,157,130,89,84,75,46,44,665,166,67,60,598,167,12254
15000US060590878023,773,135,104,93,0,12,104,93,669,130,163,76,506,131,12255
15000US060590878031,878,107,232,109,75,70,157,95,646,109,111,60,535,107,12256
15000US060590878032,471,90,149,89,38,54,111,73,322,92,111,70,211,75,12257
15000US060590878051,964,121,81,54,11,16,70,50,883,117,179,74,704,122,12258
15000US060590878052,374,102,130,82,0,12,130,82,244,99,28,39,216,94,12259
15000US060590878053,440,87,103,68,16,16,87,68,337,81,84,44,253,80,12260
15000US060590878061,437,101,62,47,36,43,26,22,375,100,36,26,339,107,12261
15000US060590878062,303,55,9,13,9,13,0,12,294,56,133,59,161,56,12262
15000US060590878063,807,128,117,74,38,29,79,66,690,134,91,65,599,135,12263
15000US060590879011,522,92,48,50,7,11,41,49,474,88,118,49,356,102,12264
15000US060590879012,651,114,69,52,56,50,13,15,582,106,217,76,365,80,12265
15000US060590879021,311,68,63,39,39,26,24,38,248,60,85,36,163,67,12266
15000US060590879022,542,97,98,72,33,40,65,59,444,109,141,70,303,97,12267
15000US060590879023,465,81,108,58,64,46,44,40,357,88,126,70,231,70,12268
15000US060590880011,346,70,7,11,0,12,7,11,339,72,91,47,248,71,12269
15000US060590880012,330,74,22,22,9,16,13,15,308,77,129,64,179,66,12270
15000US060590880013,515,86,55,41,31,18,24,37,460,84,107,51,353,87,12271
15000US060590880021,490,62,33,29,21,25,12,15,457,67,180,55,277,71,12272
15000US060590880022,628,74,80,41,43,32,37,33,548,85,69,43,479,84,12273
15000US060590881011,686,51,69,41,56,40,13,14,617,60,104,47,513,63,12274
15000US060590881041,972,112,8,13,0,12,8,13,964,110,339,84,625,116,12275
15000US060590881042,706,109,20,33,0,12,20,33,686,107,138,65,548,112,12276
15000US060590881051,616,80,46,37,39,34,7,12,570,83,183,72,387,87,12277
15000US060590881052,478,74,24,24,24,24,0,12,454,79,135,59,319,77,12278
15000US060590881061,881,109,35,30,23,22,12,20,846,109,145,55,701,116,12279
15000US060590881062,869,96,182,85,88,60,94,52,687,99,244,77,443,88,12280
15000US060590881071,695,102,75,45,39,35,36,32,620,112,139,64,481,99,12281
15000US060590881072,997,106,104,60,39,39,65,54,893,117,248,77,645,110,12282
15000US060590882011,443,76,94,61,75,55,19,29,349,81,113,52,236,73,12283
15000US060590882012,409,74,31,27,11,16,20,21,378,72,160,67,218,69,12284
15000US060590882013,286,67,0,12,0,12,0,12,286,67,88,61,198,73,12285
15000US060590882021,390,55,96,47,29,17,67,43,294,56,15,13,279,59,12286
15000US060590882022,469,58,7,11,4,8,3,7,462,56,130,39,332,58,12287
15000US060590882031,699,85,42,30,21,20,21,21,657,85,183,54,474,96,12288
15000US060590882032,815,84,189,73,69,48,120,56,626,84,215,83,411,96,12289
15000US060590883011,694,104,128,70,7,11,121,68,566,101,103,51,463,101,12290
15000US060590883012,731,87,29,27,9,15,20,22,702,88,153,56,549,91,12291
15000US060590883013,315,71,6,11,6,11,0,12,309,71,103,41,206,71,12292
15000US060590883021,763,87,38,35,11,17,27,31,725,86,185,61,540,92,12293
15000US060590883022,562,65,30,33,30,33,0,12,532,69,119,48,413,80,12294
15000US060590883023,434,70,29,24,23,20,6,9,405,78,131,53,274,69,12295
15000US060590884011,314,59,6,11,0,12,6,11,308,61,78,39,230,60,12296
15000US060590884012,654,71,86,59,55,43,31,45,568,83,158,61,410,87,12297
15000US060590884013,379,59,59,51,27,24,32,47,320,60,53,33,267,59,12298
15000US060590884021,768,90,83,50,34,26,49,42,685,88,147,65,538,102,12299
15000US060590884022,456,96,104,61,14,17,90,64,352,106,88,52,264,96,12300
15000US060590884031,1096,110,111,58,13,16,98,54,985,120,136,75,849,125,12301
15000US060590884032,772,113,52,35,37,29,15,22,720,116,141,47,579,117,12302
15000US060590885011,925,83,106,52,17,27,89,52,819,82,210,62,609,98,12303
15000US060590885012,575,81,115,52,0,12,115,52,460,83,106,60,354,86,12304
15000US060590885013,336,62,18,19,8,13,10,15,318,64,77,40,241,61,12305
15000US060590885021,955,86,142,62,50,36,92,53,813,95,174,61,639,91,12306
15000US060590885022,266,64,15,19,0,12,15,19,251,66,54,34,197,62,12307
15000US060590885023,205,55,55,46,18,21,37,40,150,53,0,12,150,53,12308
15000US060590886011,631,108,35,43,0,12,35,43,596,112,123,72,473,125,12309
15000US060590886012,509,110,80,50,37,37,43,38,429,111,188,87,241,95,12310
15000US060590886013,739,121,154,98,70,61,84,79,585,138,68,50,517,139,12311
15000US060590886014,327,99,97,64,97,64,0,12,230,86,40,41,190,84,12312
15000US060590886021,764,94,72,44,28,26,44,35,692,97,228,70,464,88,12313
15000US060590886022,565,86,57,42,15,26,42,32,508,89,62,34,446,88,12314
15000US060590887011,353,61,106,53,19,18,87,50,247,61,22,24,225,56,12315
15000US060590887012,594,80,101,52,10,16,91,49,493,86,53,35,440,89,12316
15000US060590887013,737,78,117,45,30,28,87,39,620,76,99,49,521,77,12317
15000US060590887014,217,56,9,13,0,12,9,13,208,57,64,47,144,50,12318
15000US060590887021,876,74,119,58,38,35,81,47,757,91,132,55,625,96,12319
15000US060590887022,696,76,183,66,36,30,147,64,513,87,66,33,447,91,12320
15000US060590888011,460,100,30,35,18,28,12,20,430,105,101,71,329,98,12321
15000US060590888012,345,85,73,55,26,30,47,43,272,85,3,11,269,85,12322
15000US060590888013,479,98,36,43,0,12,36,43,443,103,123,67,320,102,12323
15000US060590888014,702,140,153,91,24,39,129,84,549,138,50,49,499,139,12324
15000US060590888015,583,101,46,45,20,32,26,31,537,101,40,43,497,107,12325
15000US060590888021,427,69,32,28,0,12,32,28,395,73,54,36,341,76,12326
15000US060590888022,425,57,50,35,43,32,7,10,375,59,54,31,321,61,12327
15000US060590888023,361,60,54,43,0,12,54,43,307,57,81,35,226,57,12328
15000US060590888024,256,67,94,47,18,20,76,47,162,67,30,30,132,64,12329
15000US060590889011,325,72,66,47,9,14,57,45,259,69,61,37,198,66,12330
15000US060590889012,361,77,93,51,10,16,83,51,268,62,59,43,209,61,12331
15000US060590889013,482,81,134,65,28,23,106,62,348,74,152,60,196,68,12332
15000US060590889014,507,77,101,62,39,42,62,48,406,73,92,44,314,80,12333
15000US060590889021,351,63,57,42,6,10,51,39,294,73,32,30,262,71,12334
15000US060590889022,574,63,94,38,40,29,54,36,480,57,88,42,392,59,12335
15000US060590889023,279,54,65,38,19,21,46,32,214,55,42,29,172,59,12336
15000US060590889031,673,87,145,64,61,39,84,54,528,97,133,51,395,90,12337
15000US060590889032,757,95,45,33,19,21,26,25,712,105,196,63,516,115,12338
15000US060590889033,605,80,52,40,19,22,33,32,553,78,194,53,359,88,12339
15000US060590889041,199,66,18,24,0,12,18,24,181,59,104,54,77,42,12340
15000US060590889042,628,103,88,81,12,17,76,80,540,119,196,89,344,104,12341
15000US060590889043,211,82,12,18,12,18,0,12,199,82,78,61,121,56,12342
15000US060590889044,389,99,64,56,14,19,50,53,325,89,60,47,265,84,12343
15000US060590889051,368,78,71,58,14,13,57,55,297,81,112,56,185,79,12344
15000US060590889052,708,100,117,62,29,26,88,62,591,96,150,61,441,104,12345
15000US060590889053,282,72,19,21,19,21,0,12,263,77,64,35,199,78,12346
15000US060590890011,379,67,87,42,47,41,40,30,292,66,73,36,219,66,12347
15000US060590890012,451,75,66,39,36,31,30,23,385,84,66,29,319,81,12348
15000US060590890013,334,69,58,38,31,29,27,28,276,79,91,46,185,75,12349
15000US060590890014,476,70,121,66,29,36,92,52,355,76,101,43,254,81,12350
15000US060590890031,327,37,79,38,42,31,37,22,248,41,52,36,196,44,12351
15000US060590890032,562,39,88,39,14,12,74,37,474,43,90,34,384,48,12352
15000US060590890041,467,87,75,46,51,35,24,28,392,93,56,30,336,92,12353
15000US060590890042,719,116,121,78,18,30,103,72,598,124,145,74,453,119,12354
15000US060590890043,571,107,135,75,60,42,75,61,436,93,168,73,268,80,12355
15000US060590891021,722,82,95,58,23,21,72,55,627,88,148,58,479,92,12356
15000US060590891022,321,80,48,44,23,21,25,38,273,83,115,68,158,65,12357
15000US060590891023,613,98,33,32,9,14,24,28,580,103,91,51,489,109,12358
15000US060590891041,233,61,52,38,22,26,30,27,181,58,43,31,138,54,12359
15000US060590891042,929,88,210,75,66,50,144,65,719,100,193,71,526,109,12360
15000US060590891043,178,62,27,41,0,12,27,41,151,59,42,33,109,57,12361
15000US060590891051,288,51,69,42,27,26,42,32,219,59,71,39,148,59,12362
15000US060590891052,357,72,118,55,31,24,87,50,239,64,38,35,201,61,12363
15000US060590891053,524,74,175,73,47,35,128,65,349,79,39,36,310,80,12364
15000US060590891061,584,54,116,48,17,24,99,49,468,54,87,37,381,62,12365
15000US060590891062,390,49,73,36,17,14,56,34,317,51,41,21,276,49,12366
15000US060590891071,608,95,16,18,5,11,11,14,592,97,80,42,512,103,12367
15000US060590891072,590,103,75,60,48,46,27,40,515,102,64,40,451,99,12368
15000US060590992021,663,95,33,30,11,16,22,24,630,95,135,60,495,94,12369
15000US060590992022,839,116,156,96,8,13,148,95,683,111,187,68,496,104,12370
15000US060590992023,510,103,94,59,54,59,40,35,416,98,86,49,330,99,12371
15000US060590992031,762,105,87,53,38,35,49,42,675,109,225,81,450,116,12372
15000US060590992032,765,100,70,44,42,37,28,32,695,99,168,62,527,103,12373
15000US060590992041,515,63,26,21,6,11,20,23,489,67,91,48,398,77,12374
15000US060590992042,247,65,28,20,14,20,14,16,219,66,75,50,144,51,12375
15000US060590992043,633,69,25,23,7,13,18,20,608,69,185,73,423,86,12376
15000US060590992121,415,73,76,61,11,17,65,61,339,68,94,47,245,70,12377
15000US060590992122,362,79,20,22,20,22,0,12,342,79,72,38,270,78,12378
15000US060590992123,520,102,70,45,8,13,62,43,450,108,37,30,413,107,12379
15000US060590992124,366,88,32,26,0,12,32,26,334,94,162,89,172,61,12380
15000US060590992141,378,68,0,12,0,12,0,12,378,68,51,45,327,72,12381
15000US060590992142,295,66,7,11,0,12,7,11,288,68,62,45,226,68,12382
15000US060590992143,305,58,10,16,0,12,10,16,295,59,73,50,222,57,12383
15000US060590992144,408,74,7,12,7,12,0,12,401,73,124,46,277,78,12384
15000US060590992151,927,98,24,26,16,24,8,12,903,103,106,50,797,106,12385
15000US060590992152,631,78,5,8,5,8,0,12,626,79,136,53,490,95,12386
15000US060590992153,296,50,0,12,0,12,0,12,296,50,37,31,259,50,12387
15000US060590992161,244,67,25,27,0,12,25,27,219,72,44,36,175,75,12388
15000US060590992162,566,67,0,12,0,12,0,12,566,67,107,46,459,77,12389
15000US060590992163,300,67,12,19,0,12,12,19,288,65,40,33,248,66,12390
15000US060590992164,331,68,12,17,0,12,12,17,319,67,49,39,270,62,12391
15000US060590992171,396,45,0,12,0,12,0,12,396,45,86,35,310,52,12392
15000US060590992172,480,49,0,12,0,12,0,12,480,49,80,29,400,54,12393
15000US060590992201,602,146,0,12,0,12,0,12,602,146,45,43,557,151,12394
15000US060590992202,734,160,34,51,34,51,0,12,700,159,39,44,661,154,12395
15000US060590992203,500,99,0,12,0,12,0,12,500,99,145,67,355,102,12396
15000US060590992204,439,133,10,17,10,17,0,12,429,132,80,85,349,119,12397
15000US060590992221,555,88,28,27,19,22,9,15,527,86,172,80,355,72,12398
15000US060590992222,438,58,31,28,31,28,0,12,407,58,110,49,297,72,12399
15000US060590992223,322,53,34,26,24,22,10,15,288,57,106,50,182,57,12400
15000US060590992224,291,53,45,34,45,34,0,12,246,60,46,31,200,56,12401
15000US060590992231,853,97,117,69,39,43,78,55,736,112,199,70,537,110,12402
15000US060590992232,403,74,76,54,35,38,41,44,327,72,54,39,273,66,12403
15000US060590992233,438,74,7,11,0,12,7,11,431,73,87,39,344,82,12404
15000US060590992241,592,72,6,9,0,12,6,9,586,71,162,59,424,83,12405
15000US060590992242,504,73,25,28,0,12,25,28,479,77,112,67,367,74,12406
15000US060590992251,539,65,22,31,22,31,0,12,517,73,71,39,446,81,12407
15000US060590992252,505,66,18,19,0,12,18,19,487,66,101,44,386,75,12408
15000US060590992261,640,57,35,31,11,19,24,25,605,63,148,57,457,73,12409
15000US060590992262,494,55,33,26,15,24,18,21,461,64,168,48,293,66,12410
15000US060590992271,268,58,9,15,0,12,9,15,259,58,51,34,208,58,12411
15000US060590992272,444,99,10,16,0,12,10,16,434,101,41,45,393,104,12412
15000US060590992273,550,88,23,20,10,15,13,15,527,87,136,48,391,91,12413
15000US060590992274,678,93,78,52,20,19,58,43,600,91,153,55,447,88,12414
15000US060590992291,521,106,17,27,0,12,17,27,504,102,91,65,413,108,12415
15000US060590992292,706,126,0,12,0,12,0,12,706,126,88,60,618,130,12416
15000US060590992293,1212,171,24,29,0,12,24,29,1188,178,346,100,842,194,12417
15000US060590992301,547,71,22,23,0,12,22,23,525,73,143,56,382,64,12418
15000US060590992302,952,83,19,21,17,19,2,6,933,85,297,96,636,103,12419
15000US060590992311,584,57,0,12,0,12,0,12,584,57,153,63,431,72,12420
15000US060590992312,567,74,8,12,0,12,8,12,559,73,162,50,397,82,12421
15000US060590992313,638,84,18,22,6,12,12,18,620,88,80,36,540,94,12422
15000US060590992321,707,70,22,23,9,14,13,18,685,70,162,61,523,74,12423
15000US060590992322,404,55,38,30,38,30,0,12,366,60,167,58,199,59,12424
15000US060590992323,413,66,7,10,0,12,7,10,406,67,73,48,333,72,12425
15000US060590992324,383,68,17,20,17,20,0,12,366,68,37,26,329,75,12426
15000US060590992331,498,65,29,29,20,23,9,15,469,63,81,45,388,72,12427
15000US060590992332,560,63,36,30,9,13,27,33,524,66,118,52,406,76,12428
15000US060590992341,510,71,20,22,10,16,10,14,490,71,88,45,402,83,12429
15000US060590992342,700,77,23,23,0,12,23,23,677,80,223,61,454,87,12430
15000US060590992351,354,67,17,19,17,19,0,12,337,66,37,27,300,70,12431
15000US060590992352,263,57,0,12,0,12,0,12,263,57,47,30,216,58,12432
15000US060590992353,884,107,66,53,35,48,31,24,818,110,138,69,680,115,12433
15000US060590992354,444,74,0,12,0,12,0,12,444,74,105,51,339,77,12434
15000US060590992371,629,73,25,27,0,12,25,27,604,77,181,71,423,84,12435
15000US060590992372,619,69,14,22,14,22,0,12,605,70,121,49,484,77,12436
15000US060590992381,671,53,10,15,10,15,0,12,661,55,177,57,484,65,12437
15000US060590992382,705,57,9,14,0,12,9,14,696,58,91,48,605,70,12438
15000US060590992391,265,68,11,17,0,12,11,17,254,68,57,32,197,68,12439
15000US060590992392,417,71,0,12,0,12,0,12,417,71,22,18,395,76,12440
15000US060590992393,346,74,5,9,5,9,0,12,341,74,84,41,257,73,12441
15000US060590992394,305,65,11,17,11,17,0,12,294,66,87,48,207,60,12442
15000US060590992401,302,101,16,24,0,12,16,24,286,99,58,41,228,105,12443
15000US060590992402,797,110,0,12,0,12,0,12,797,110,168,81,629,110,12444
15000US060590992403,214,76,0,12,0,12,0,12,214,76,0,12,214,76,12445
15000US060590992404,726,98,40,47,23,38,17,27,686,105,111,90,575,119,12446
15000US060590992411,658,84,10,15,10,15,0,12,648,86,117,46,531,88,12447
15000US060590992412,1030,81,68,39,27,25,41,33,962,86,199,75,763,111,12448
15000US060590992421,584,78,28,25,4,10,24,22,556,79,110,63,446,71,12449
15000US060590992422,553,82,21,23,7,12,14,21,532,86,160,71,372,89,12450
15000US060590992431,1145,85,0,12,0,12,0,12,1145,85,134,66,1011,104,12451
15000US060590992432,600,75,14,21,0,12,14,21,586,76,138,54,448,78,12452
15000US060590992441,633,56,6,10,0,12,6,10,627,57,116,50,511,66,12453
15000US060590992442,1167,87,19,21,10,15,9,14,1148,90,422,75,726,92,12454
15000US060590992451,472,52,0,12,0,12,0,12,472,52,96,33,376,51,12455
15000US060590992452,620,53,9,14,9,14,0,12,611,54,105,47,506,72,12456
15000US060590992461,348,50,0,12,0,12,0,12,348,50,81,31,267,53,12457
15000US060590992462,555,69,0,12,0,12,0,12,555,69,84,59,471,76,12458
15000US060590992463,286,52,17,19,7,11,10,16,269,57,55,50,214,60,12459
15000US060590992471,367,36,57,30,33,22,24,20,310,45,61,32,249,51,12460
15000US060590992472,404,41,96,38,22,20,74,34,308,46,103,36,205,42,12461
15000US060590992481,727,99,236,89,45,29,191,82,491,98,18,19,473,97,12462
15000US060590992482,667,105,104,67,20,23,84,62,563,112,163,63,400,101,12463
15000US060590992491,441,47,90,40,13,16,77,38,351,55,109,40,242,57,12464
15000US060590992492,408,50,122,46,17,14,105,45,286,52,64,27,222,49,12465
15000US060590992501,612,78,24,29,0,12,24,29,588,91,144,72,444,90,12466
15000US060590992502,476,79,17,22,0,12,17,22,459,81,69,56,390,79,12467
15000US060590992511,980,152,66,81,47,75,19,30,914,152,195,106,719,157,12468
15000US060590992512,728,145,48,67,0,12,48,67,680,147,153,71,527,150,12469
15000US060590992513,405,84,25,38,0,12,25,38,380,86,31,32,349,83,12470
15000US060590993051,420,111,34,42,0,12,34,42,386,115,99,77,287,124,12471
15000US060590993052,536,119,0,12,0,12,0,12,536,119,86,74,450,112,12472
15000US060590993053,803,124,0,12,0,12,0,12,803,124,57,51,746,131,12473
15000US060590993054,365,90,32,31,22,26,10,19,333,94,48,40,285,90,12474
15000US060590993055,404,95,76,55,25,43,51,53,328,87,55,47,273,89,12475
15000US060590993056,438,83,23,27,0,12,23,27,415,87,64,45,351,86,12476
15000US060590993061,651,132,44,43,32,38,12,19,607,139,128,92,479,127,12477
15000US060590993062,496,129,43,67,0,12,43,67,453,121,32,37,421,127,12478
15000US060590993063,411,111,0,12,0,12,0,12,411,111,0,12,411,111,12479
15000US060590993064,666,111,25,39,0,12,25,39,641,119,49,47,592,113,12480
15000US060590993065,338,100,0,12,0,12,0,12,338,100,28,31,310,111,12481
15000US060590993071,676,92,0,12,0,12,0,12,676,92,69,32,607,95,12482
15000US060590993072,590,86,11,18,11,18,0,12,579,86,106,55,473,87,12483
15000US060590993081,680,96,19,30,0,12,19,30,661,97,69,46,592,104,12484
15000US060590993082,603,107,0,12,0,12,0,12,603,107,103,69,500,106,12485
15000US060590993083,861,102,16,24,16,24,0,12,845,104,136,66,709,118,12486
15000US060590993091,421,71,0,12,0,12,0,12,421,71,125,57,296,89,12487
15000US060590993092,906,143,8,14,0,12,8,14,898,145,68,77,830,152,12488
15000US060590993093,920,142,74,62,42,49,32,41,846,146,128,67,718,157,12489
15000US060590993101,566,143,13,22,0,12,13,22,553,147,70,61,483,145,12490
15000US060590993102,899,157,26,34,0,12,26,34,873,156,142,88,731,150,12491
15000US060590993103,481,120,97,90,26,44,71,83,384,122,16,23,368,123,12492
15000US060590993111,546,101,0,12,0,12,0,12,546,101,24,19,522,103,12493
15000US060590993112,681,85,6,10,0,12,6,10,675,87,133,56,542,89,12494
15000US060590993113,484,89,6,9,0,12,6,9,478,89,26,19,452,92,12495
15000US060590994021,371,105,133,99,0,12,133,99,238,107,26,25,212,111,12496
15000US060590994022,870,117,185,87,9,13,176,87,685,120,172,68,513,117,12497
15000US060590994023,245,72,16,19,8,13,8,13,229,72,64,33,165,70,12498
15000US060590994024,579,131,190,95,27,42,163,88,389,138,47,56,342,130,12499
15000US060590994041,946,92,0,12,0,12,0,12,946,92,174,76,772,109,12500
15000US060590994042,715,69,23,35,0,12,23,35,692,72,143,57,549,70,12501
15000US060590994051,345,56,0,12,0,12,0,12,345,56,62,39,283,61,12502
15000US060590994052,552,69,33,27,9,14,24,31,519,71,82,42,437,78,12503
15000US060590994053,706,96,69,50,30,35,39,42,637,112,87,48,550,102,12504
15000US060590994061,591,76,8,13,0,12,8,13,583,75,91,43,492,87,12505
15000US060590994062,1092,93,69,54,15,17,54,52,1023,103,303,91,720,103,12506
15000US060590994071,956,40,51,39,24,24,27,32,905,51,232,67,673,68,12507
15000US060590994081,416,76,38,49,32,48,6,10,378,74,157,57,221,77,12508
15000US060590994082,955,77,52,38,20,29,32,38,903,85,129,55,774,86,12509
15000US060590994083,278,45,0,12,0,12,0,12,278,45,58,40,220,45,12510
15000US060590994101,456,92,51,45,39,48,12,14,405,89,81,53,324,82,12511
15000US060590994102,288,61,0,12,0,12,0,12,288,61,114,64,174,52,12512
15000US060590994103,1017,112,161,71,79,56,82,60,856,117,184,88,672,108,12513
15000US060590994111,313,64,0,12,0,12,0,12,313,64,166,59,147,57,12514
15000US060590994112,782,111,129,60,53,46,76,44,653,119,124,77,529,120,12515
15000US060590994113,475,109,18,20,0,12,18,20,457,112,82,66,375,104,12516
15000US060590994114,411,93,29,26,10,15,19,20,382,85,38,29,344,85,12517
15000US060590994121,872,79,47,51,0,12,47,51,825,86,85,59,740,94,12518
15000US060590994122,399,78,0,12,0,12,0,12,399,78,94,42,305,75,12519
15000US060590994123,599,84,0,12,0,12,0,12,599,84,78,38,521,86,12520
15000US060590994131,230,60,0,12,0,12,0,12,230,60,32,36,198,66,12521
15000US060590994132,813,138,29,33,0,12,29,33,784,137,136,86,648,144,12522
15000US060590994133,953,159,108,96,0,12,108,96,845,141,92,62,753,145,12523
15000US060590994134,1048,132,27,28,27,28,0,12,1021,140,597,147,424,117,12524
15000US060590994135,358,103,0,12,0,12,0,12,358,103,30,33,328,107,12525
15000US060590994151,442,63,22,21,3,8,19,20,420,66,28,25,392,72,12526
15000US060590994152,443,69,34,47,0,12,34,47,409,60,62,36,347,62,12527
15000US060590994153,398,62,7,10,7,10,0,12,391,60,91,43,300,65,12528
15000US060590994154,415,51,7,10,7,10,0,12,408,53,92,45,316,62,12529
15000US060590994155,222,54,0,12,0,12,0,12,222,54,62,33,160,65,12530
15000US060590994161,748,130,38,55,0,12,38,55,710,136,20,27,690,135,12531
15000US060590994162,399,141,18,29,0,12,18,29,381,146,0,12,381,146,12532
15000US060590994163,1010,161,0,12,0,12,0,12,1010,161,127,64,883,163,12533
15000US060590994171,1178,102,65,64,9,14,56,62,1113,101,152,76,961,106,12534
15000US060590994172,828,105,13,16,0,12,13,16,815,106,155,71,660,104,12535
15000US060590995021,130,37,6,9,0,12,6,9,124,37,11,8,113,38,12536
15000US060590995041,958,40,27,29,27,29,0,12,931,50,236,73,695,86,12537
15000US060590995061,493,68,17,18,0,12,17,18,476,71,85,38,391,71,12538
15000US060590995081,716,106,69,59,39,45,30,38,647,126,72,56,575,135,12539
15000US060590995082,277,84,0,12,0,12,0,12,277,84,17,26,260,83,12540
15000US060590995083,360,86,54,47,28,26,26,39,306,76,41,41,265,73,12541
15000US060590995084,647,124,51,83,51,83,0,12,596,106,146,69,450,120,12542
15000US060590995091,410,60,8,15,8,15,0,12,402,61,205,62,197,61,12543
15000US060590995092,634,102,13,20,13,20,0,12,621,103,282,113,339,100,12544
15000US060590995093,503,88,8,14,8,14,0,12,495,90,249,87,246,71,12545
15000US060590995094,287,49,0,12,0,12,0,12,287,49,124,58,163,65,12546
15000US060590995095,436,86,0,12,0,12,0,12,436,86,214,81,222,76,12547
15000US060590995101,1344,135,15,24,15,24,0,12,1329,139,678,163,651,153,12548
15000US060590995102,971,125,0,12,0,12,0,12,971,125,418,133,553,136,12549
15000US060590995103,925,109,0,12,0,12,0,12,925,109,420,106,505,124,12550
15000US060590995111,309,74,0,12,0,12,0,12,309,74,53,30,256,72,12551
15000US060590995112,471,74,0,12,0,12,0,12,471,74,73,37,398,81,12552
15000US060590995113,348,70,0,12,0,12,0,12,348,70,32,42,316,65,12553
15000US060590995114,522,81,0,12,0,12,0,12,522,81,86,55,436,93,12554
15000US060590995121,617,81,9,14,9,14,0,12,608,78,86,49,522,84,12555
15000US060590995122,562,83,32,33,13,20,19,28,530,93,67,51,463,85,12556
15000US060590995123,318,67,0,12,0,12,0,12,318,67,81,52,237,61,12557
15000US060590995131,669,104,0,12,0,12,0,12,669,104,115,58,554,99,12558
15000US060590995132,475,79,10,17,0,12,10,17,465,83,75,42,390,88,12559
15000US060590995141,657,124,0,12,0,12,0,12,657,124,171,83,486,107,12560
15000US060590995142,442,80,0,12,0,12,0,12,442,80,81,52,361,81,12561
15000US060590995143,534,106,0,12,0,12,0,12,534,106,180,71,354,108,12562
15000US060590995144,343,93,0,12,0,12,0,12,343,93,100,91,243,78,12563
15000US060590995145,235,92,0,12,0,12,0,12,235,92,4,19,231,89,12564
15000US060590996011,492,99,94,55,39,32,55,44,398,107,145,76,253,89,12565
15000US060590996012,711,106,114,48,41,30,73,39,597,104,228,86,369,101,12566
15000US060590996013,410,103,156,83,47,33,109,79,254,104,103,77,151,79,12567
15000US060590996014,367,79,9,13,0,12,9,13,358,80,88,67,270,69,12568
15000US060590996021,490,81,29,28,10,15,19,22,461,86,63,37,398,88,12569
15000US060590996022,580,76,23,33,23,33,0,12,557,78,169,70,388,82,12570
15000US060590996031,890,103,57,47,57,47,0,12,833,105,231,113,602,121,12571
15000US060590996032,272,51,14,22,14,22,0,12,258,50,27,29,231,53,12572
15000US060590996033,545,107,22,31,0,12,22,31,523,108,116,83,407,108,12573
15000US060590996034,548,96,96,89,16,25,80,91,452,101,131,58,321,104,12574
15000US060590996041,569,59,21,25,0,12,21,25,548,65,129,52,419,76,12575
15000US060590996042,645,62,22,24,12,18,10,16,623,70,124,47,499,85,12576
15000US060590996051,668,69,29,25,19,21,10,16,639,70,106,42,533,76,12577
15000US060590996052,686,75,13,17,0,12,13,17,673,76,181,67,492,81,12578
15000US060590997011,889,97,146,72,53,35,93,63,743,104,308,79,435,102,12579
15000US060590997012,412,108,86,62,54,58,32,38,326,87,86,57,240,79,12580
15000US060590997013,481,81,100,59,22,26,78,55,381,80,67,34,314,82,12581
15000US060590997021,699,116,52,50,25,39,27,34,647,126,148,97,499,132,12582
15000US060590997022,878,190,113,102,0,12,113,102,765,182,230,129,535,142,12583
15000US060590997023,856,159,91,97,76,95,15,24,765,174,220,126,545,161,12584
15000US060590997031,583,96,11,16,0,12,11,16,572,96,159,60,413,100,12585
15000US060590997032,750,90,13,21,13,21,0,12,737,93,127,69,610,97,12586
15000US060590997033,547,97,9,14,0,12,9,14,538,98,195,89,343,93,12587
15000US060590998011,406,91,17,20,7,12,10,16,389,88,131,68,258,79,12588
15000US060590998012,664,105,56,41,35,28,21,33,608,107,188,56,420,109,12589
15000US060590998013,487,97,153,74,13,16,140,74,334,100,91,53,243,94,12590
15000US060590998021,908,108,111,58,88,60,23,21,797,106,391,88,406,93,12591
15000US060590998022,880,80,185,69,78,47,107,60,695,92,278,74,417,84,12592
15000US060590998031,928,106,213,79,77,41,136,73,715,108,279,66,436,100,12593
15000US060590998032,323,73,69,35,33,28,36,27,254,71,51,34,203,70,12594
15000US060590998033,483,85,37,29,8,14,29,26,446,91,144,65,302,84,12595
15000US060590999021,354,74,57,37,26,25,31,31,297,75,66,41,231,71,12596
15000US060590999022,398,80,55,44,15,23,40,38,343,79,53,36,290,80,12597
15000US060590999023,505,95,92,68,47,60,45,36,413,97,106,49,307,99,12598
15000US060590999031,372,75,42,38,36,38,6,11,330,75,115,43,215,73,12599
15000US060590999032,600,82,208,76,40,44,168,71,392,92,142,63,250,85,12600
15000US060590999033,570,81,28,24,0,12,28,24,542,82,152,54,390,83,12601
15000US060590999041,367,75,47,30,30,26,17,20,320,78,100,63,220,61,12602
15000US060590999042,496,97,109,63,10,13,99,63,387,102,102,50,285,96,12603
15000US060590999043,321,89,0,12,0,12,0,12,321,89,83,58,238,83,12604
15000US060590999044,323,84,84,68,14,22,70,64,239,64,50,41,189,64,12605
15000US060590999045,384,104,100,60,43,49,57,35,284,94,138,86,146,58,12606
15000US060590999051,602,115,81,51,48,45,33,27,521,131,195,85,326,121,12607
15000US060590999052,754,101,96,71,0,12,96,71,658,103,256,111,402,99,12608
15000US060590999061,657,80,64,51,23,26,41,46,593,83,71,37,522,87,12609
15000US060590999062,396,62,15,16,8,12,7,12,381,63,147,42,234,63,12610
15000US060590999063,519,76,9,14,0,12,9,14,510,77,157,71,353,77,12611
15000US060591100011,972,73,16,19,9,14,7,12,956,74,311,87,645,86,12612
15000US060591100012,556,66,43,36,16,17,27,30,513,68,44,26,469,64,12613
15000US060591100031,392,68,29,26,29,26,0,12,363,69,65,40,298,69,12614
15000US060591100032,755,73,15,19,8,13,7,13,740,74,179,72,561,81,12615
15000US060591100041,456,62,23,36,0,12,23,36,433,64,48,31,385,64,12616
15000US060591100042,307,56,14,22,14,22,0,12,293,57,87,48,206,66,12617
15000US060591100043,388,68,0,12,0,12,0,12,388,68,104,50,284,73,12618
15000US060591100044,535,64,0,12,0,12,0,12,535,64,146,61,389,72,12619
15000US060591100051,516,65,10,15,0,12,10,15,506,66,180,55,326,65,12620
15000US060591100052,592,59,17,20,13,18,4,8,575,59,99,49,476,66,12621
15000US060591100061,705,64,0,12,0,12,0,12,705,64,158,59,547,79,12622
15000US060591100062,431,62,0,12,0,12,0,12,431,62,123,60,308,74,12623
15000US060591100071,280,41,10,17,10,17,0,12,270,42,52,31,218,45,12624
15000US060591100072,296,50,0,12,0,12,0,12,296,50,43,32,253,49,12625
15000US060591100073,645,74,0,12,0,12,0,12,645,74,185,59,460,86,12626
15000US060591100074,454,69,13,21,0,12,13,21,441,68,77,41,364,77,12627
15000US060591100081,972,76,0,12,0,12,0,12,972,76,178,64,794,93,12628
15000US060591100082,410,57,7,12,0,12,7,12,403,59,69,37,334,62,12629
15000US060591100083,293,43,0,12,0,12,0,12,293,43,39,31,254,49,12630
15000US060591100101,734,64,11,17,0,12,11,17,723,65,158,65,565,87,12631
15000US060591100102,370,61,0,12,0,12,0,12,370,61,111,50,259,62,12632
15000US060591100103,317,52,0,12,0,12,0,12,317,52,92,48,225,64,12633
15000US060591100111,675,77,31,38,6,11,25,37,644,77,101,46,543,90,12634
15000US060591100112,387,64,0,12,0,12,0,12,387,64,116,51,271,60,12635
15000US060591100121,424,68,0,12,0,12,0,12,424,68,70,37,354,75,12636
15000US060591100122,392,72,8,14,8,14,0,12,384,72,94,52,290,69,12637
15000US060591100123,316,62,0,12,0,12,0,12,316,62,57,33,259,69,12638
15000US060591100124,713,80,9,15,0,12,9,15,704,82,188,63,516,83,12639
15000US060591100141,233,60,10,15,0,12,10,15,223,59,30,24,193,61,12640
15000US060591100142,574,90,24,34,0,12,24,34,550,88,107,41,443,90,12641
15000US060591100143,586,90,35,34,6,9,29,36,551,87,132,53,419,90,12642
15000US060591100144,449,74,56,38,33,37,23,38,393,76,73,52,320,70,12643
15000US060591100151,436,67,14,16,7,12,7,11,422,70,113,49,309,75,12644
15000US060591100152,611,66,0,12,0,12,0,12,611,66,110,44,501,82,12645
15000US060591100153,126,45,0,12,0,12,0,12,126,45,10,16,116,44,12646
15000US060591101021,525,75,7,12,0,12,7,12,518,76,118,51,400,84,12647
15000US060591101022,636,74,6,11,6,11,0,12,630,76,133,73,497,86,12648
15000US060591101023,680,100,55,47,23,34,32,38,625,102,108,60,517,112,12649
15000US060591101041,871,107,18,20,10,14,8,14,853,109,192,85,661,101,12650
15000US060591101042,558,69,7,12,7,12,0,12,551,70,193,57,358,76,12651
15000US060591101043,410,87,48,49,32,46,16,17,362,101,35,44,327,97,12652
15000US060591101061,265,61,23,24,7,10,16,22,242,64,47,29,195,69,12653
15000US060591101062,384,79,0,12,0,12,0,12,384,79,76,42,308,91,12654
15000US060591101063,557,66,18,20,8,12,10,16,539,66,86,49,453,69,12655
15000US060591101081,248,62,6,12,6,12,0,12,242,65,54,41,188,65,12656
15000US060591101082,514,71,17,27,0,12,17,27,497,72,69,41,428,79,12657
15000US060591101083,294,75,30,25,0,12,30,25,264,71,118,68,146,55,12658
15000US060591101091,281,68,0,12,0,12,0,12,281,68,50,33,231,71,12659
15000US060591101092,528,101,8,12,0,12,8,12,520,101,67,37,453,103,12660
15000US060591101093,405,80,0,12,0,12,0,12,405,80,67,41,338,88,12661
15000US060591101094,590,104,43,38,30,35,13,14,547,110,89,55,458,99,12662
15000US060591101101,402,93,39,39,0,12,39,39,363,92,63,49,300,88,12663
15000US060591101102,872,111,62,53,35,45,27,25,810,117,222,87,588,109,12664
15000US060591101103,551,83,47,49,8,15,39,45,504,72,104,57,400,73,12665
15000US060591101111,497,88,8,13,0,12,8,13,489,87,104,46,385,92,12666
15000US060591101112,726,98,24,37,0,12,24,37,702,96,118,65,584,107,12667
15000US060591101113,722,94,68,56,0,12,68,56,654,91,117,55,537,92,12668
15000US060591101131,710,34,47,22,10,16,37,19,663,33,171,58,492,55,12669
15000US060591101141,581,85,34,30,34,30,0,12,547,91,111,42,436,94,12670
15000US060591101142,394,57,0,12,0,12,0,12,394,57,83,43,311,63,12671
15000US060591101143,527,76,0,12,0,12,0,12,527,76,98,49,429,87,12672
15000US060591101151,395,77,0,12,0,12,0,12,395,77,27,25,368,78,12673
15000US060591101152,328,56,0,12,0,12,0,12,328,56,40,21,288,56,12674
15000US060591101153,425,55,0,12,0,12,0,12,425,55,73,39,352,62,12675
15000US060591101161,485,67,9,15,9,15,0,12,476,67,101,42,375,77,12676
15000US060591101162,379,70,8,13,0,12,8,13,371,72,121,55,250,64,12677
15000US060591101163,618,84,92,75,0,12,92,75,526,97,55,37,471,98,12678
15000US060591101171,656,126,60,50,60,50,0,12,596,136,197,101,399,120,12679
15000US060591101172,307,99,0,12,0,12,0,12,307,99,124,89,183,63,12680
15000US060591101173,420,140,3,12,0,12,3,12,417,144,10,17,407,144,12681
15000US060591101174,720,132,30,37,14,24,16,29,690,140,95,55,595,155,12682
15000US060591101181,428,40,0,12,0,12,0,12,428,40,78,38,350,55,12683
15000US060591101182,343,40,0,12,0,12,0,12,343,40,46,20,297,37,12684
15000US060591102011,898,123,68,76,45,71,23,28,830,127,190,83,640,125,12685
15000US060591102012,886,126,17,21,0,12,17,21,869,128,151,76,718,140,12686
15000US060591102013,774,142,23,24,0,12,23,24,751,142,149,69,602,131,12687
15000US060591102021,963,141,56,53,13,21,43,50,907,136,144,79,763,152,12688
15000US060591102022,382,121,0,12,0,12,0,12,382,121,47,42,335,121,12689
15000US060591102023,900,129,61,49,43,43,18,27,839,128,215,83,624,142,12690
15000US060591102031,993,96,72,45,40,33,32,33,921,111,95,55,826,109,12691
15000US060591102032,644,73,40,43,14,16,26,41,604,79,140,62,464,83,12692
15000US060591103011,1193,131,134,100,58,70,76,77,1059,151,194,91,865,149,12693
15000US060591103012,222,87,0,12,0,12,0,12,222,87,25,34,197,89,12694
15000US060591103013,363,95,24,42,0,12,24,42,339,94,36,36,303,109,12695
15000US060591103014,415,112,11,18,11,18,0,12,404,114,200,89,204,109,12696
15000US060591103021,441,82,38,38,0,12,38,38,403,79,127,69,276,79,12697
15000US060591103022,531,80,34,28,14,17,20,21,497,75,148,73,349,65,12698
15000US060591103023,623,91,46,39,46,39,0,12,577,91,134,66,443,85,12699
15000US060591103031,656,102,14,16,0,12,14,16,642,106,132,56,510,114,12700
15000US060591103032,806,106,70,72,36,49,34,46,736,107,185,57,551,111,12701
15000US060591103041,537,72,3,9,3,9,0,12,534,74,68,41,466,74,12702
15000US060591103042,783,82,5,10,5,10,0,12,778,82,193,62,585,104,12703
15000US060591104011,448,86,0,12,0,12,0,12,448,86,94,45,354,96,12704
15000US060591104012,341,69,49,36,29,25,20,24,292,74,73,59,219,63,12705
15000US060591104013,576,88,16,18,7,12,9,14,560,87,110,52,450,104,12706
15000US060591104021,329,56,0,12,0,12,0,12,329,56,65,38,264,60,12707
15000US060591104022,445,82,19,20,10,14,9,15,426,84,101,67,325,80,12708
15000US060591104023,575,85,196,60,39,33,157,64,379,87,91,48,288,90,12709
15000US060591105001,612,169,116,72,25,31,91,66,496,180,179,114,317,148,12710
15000US060591105002,819,160,177,123,29,47,148,118,642,149,253,94,389,151,12711
15000US060591105003,621,193,167,133,55,88,112,100,454,180,45,51,409,177,12712
15000US060591105004,368,101,0,12,0,12,0,12,368,101,73,40,295,95,12713
15000US060591106031,530,136,152,94,35,59,117,96,378,129,76,83,302,104,12714
15000US060591106032,368,141,76,75,63,72,13,22,292,118,14,23,278,116,12715
15000US060591106033,637,172,151,114,47,57,104,97,486,158,82,49,404,150,12716
15000US060591106034,417,105,79,77,0,12,79,77,338,92,54,58,284,97,12717
15000US060591106035,471,145,13,21,13,21,0,12,458,145,200,120,258,128,12718
15000US060591106041,699,135,0,12,0,12,0,12,699,135,78,52,621,150,12719
15000US060591106042,518,115,38,42,38,42,0,12,480,120,41,41,439,125,12720
15000US060591106043,913,145,0,12,0,12,0,12,913,145,185,101,728,141,12721
15000US060591106044,401,89,0,12,0,12,0,12,401,89,48,39,353,94,12722
15000US060591106051,345,92,12,19,0,12,12,19,333,95,51,41,282,88,12723
15000US060591106052,504,127,10,17,0,12,10,17,494,129,97,74,397,136,12724
15000US060591106053,567,122,0,12,0,12,0,12,567,122,92,67,475,115,12725
15000US060591106054,269,98,0,12,0,12,0,12,269,98,40,35,229,99,12726
15000US060591106055,414,101,0,12,0,12,0,12,414,101,54,45,360,107,12727
15000US060591106061,693,77,185,70,85,57,100,60,508,94,91,62,417,95,12728
15000US060591106062,469,83,127,55,17,28,110,57,342,91,31,23,311,89,12729
15000US060591106071,245,61,0,12,0,12,0,12,245,61,97,48,148,50,12730
15000US060591106072,460,97,21,28,0,12,21,28,439,103,88,67,351,92,12731
15000US060591106073,660,88,0,12,0,12,0,12,660,88,79,60,581,101,12732
15000US060599800001,0,12,0,12,0,12,0,12,0,12,0,12,0,12,12733
15000US060599901000,0,12,0,12,0,12,0,12,0,12,0,12,0,12,12734
15000US060610201041,157,62,16,24,16,24,0,12,141,60,43,39,98,54,12735
15000US060610201042,201,64,0,12,0,12,0,12,201,64,25,30,176,59,12736
15000US060610201043,155,79,0,12,0,12,0,12,155,79,19,30,136,74,12737
15000US060610201051,155,49,11,16,0,12,11,16,144,51,42,28,102,43,12738
15000US060610201052,251,77,38,43,24,37,14,22,213,72,6,9,207,71,12739
15000US060610201061,256,66,21,23,0,12,21,23,235,66,21,16,214,63,12740
15000US060610201062,315,76,0,12,0,12,0,12,315,76,65,42,250,60,12741
15000US060610201071,392,126,62,59,36,44,26,41,330,111,67,50,263,104,12742
15000US060610201072,452,120,96,75,22,36,74,65,356,111,0,12,356,111,12743
15000US060610201073,161,89,0,12,0,12,0,12,161,89,13,20,148,86,12744
15000US060610202001,1001,150,34,40,17,29,17,28,967,147,205,91,762,135,12745
15000US060610202002,1115,148,59,88,59,88,0,12,1056,131,393,123,663,126,12746
15000US060610202003,218,131,17,27,0,12,17,27,201,130,101,93,100,98,12747
15000US060610202004,184,117,11,20,0,12,11,20,173,123,158,120,15,24,12748
15000US060610203001,942,152,133,88,54,48,79,88,809,143,211,88,598,157,12749
15000US060610203002,699,146,163,106,17,28,146,103,536,133,168,82,368,125,12750
15000US060610203003,486,132,16,27,16,27,0,12,470,134,214,120,256,96,12751
15000US060610204011,772,73,80,39,20,18,60,36,692,75,190,57,502,82,12752
15000US060610204012,260,57,30,28,14,15,16,24,230,59,39,24,191,57,12753
15000US060610204021,762,83,0,12,0,12,0,12,762,83,113,47,649,87,12754
15000US060610204022,811,79,61,48,35,32,26,38,750,94,196,70,554,101,12755
15000US060610205011,334,53,10,15,10,15,0,12,324,51,61,29,263,51,12756
15000US060610205012,338,56,17,17,6,9,11,15,321,55,65,31,256,60,12757
15000US060610205013,489,55,37,24,26,24,11,14,452,55,127,42,325,47,12758
15000US060610205021,766,73,21,23,21,23,0,12,745,74,144,56,601,82,12759
15000US060610205022,383,59,29,31,29,31,0,12,354,55,118,38,236,62,12760
15000US060610205023,608,74,17,15,11,12,6,10,591,76,152,48,439,86,12761
15000US060610206011,558,102,17,28,17,28,0,12,541,104,57,50,484,111,12762
15000US060610206012,1242,147,13,20,13,20,0,12,1229,148,295,121,934,151,12763
15000US060610206013,900,119,0,12,0,12,0,12,900,119,217,96,683,141,12764
15000US060610206021,598,111,15,24,15,24,0,12,583,111,137,88,446,101,12765
15000US060610206022,318,84,16,27,0,12,16,27,302,85,127,60,175,84,12766
15000US060610206023,483,118,20,31,0,12,20,31,463,119,121,66,342,138,12767
15000US060610206024,1038,203,40,37,0,12,40,37,998,213,141,82,857,211,12768
15000US060610206025,303,75,0,12,0,12,0,12,303,75,31,36,272,80,12769
15000US060610206041,419,100,0,12,0,12,0,12,419,100,82,55,337,102,12770
15000US060610206042,785,113,41,51,0,12,41,51,744,117,205,70,539,113,12771
15000US060610206043,326,79,0,12,0,12,0,12,326,79,65,44,261,81,12772
15000US060610206044,600,102,26,32,0,12,26,32,574,104,105,55,469,107,12773
15000US060610206051,580,97,15,20,0,12,15,20,565,96,31,29,534,104,12774
15000US060610206052,901,110,0,12,0,12,0,12,901,110,187,95,714,129,12775
15000US060610206053,677,97,0,12,0,12,0,12,677,97,134,84,543,89,12776
15000US060610206061,663,78,0,12,0,12,0,12,663,78,79,44,584,82,12777
15000US060610206062,228,50,0,12,0,12,0,12,228,50,20,22,208,49,12778
15000US060610206063,504,58,0,12,0,12,0,12,504,58,45,27,459,65,12779
15000US060610207101,393,60,9,14,9,14,0,12,384,59,38,27,346,68,12780
15000US060610207102,549,69,0,12,0,12,0,12,549,69,120,52,429,74,12781
15000US060610207103,742,77,17,20,17,20,0,12,725,81,195,71,530,92,12782
15000US060610207111,669,108,49,51,8,12,41,49,620,106,265,89,355,77,12783
15000US060610207112,782,109,51,38,7,11,44,36,731,113,97,60,634,113,12784
15000US060610207113,449,98,12,17,0,12,12,17,437,95,73,49,364,89,12785
15000US060610207121,641,92,156,86,35,40,121,75,485,94,105,55,380,96,12786
15000US060610207122,280,61,6,10,6,10,0,12,274,61,135,57,139,52,12787
15000US060610207123,523,69,32,36,0,12,32,36,491,68,134,62,357,78,12788
15000US060610207131,821,102,117,68,45,48,72,62,704,113,297,104,407,107,12789
15000US060610207132,494,79,66,62,0,12,66,62,428,79,117,46,311,80,12790
15000US060610207141,741,77,16,17,0,12,16,17,725,79,218,77,507,91,12791
15000US060610207142,703,72,0,12,0,12,0,12,703,72,149,59,554,82,12792
15000US060610207151,621,75,21,25,11,17,10,17,600,73,128,52,472,88,12793
15000US060610207152,509,74,33,29,0,12,33,29,476,76,92,50,384,75,12794
15000US060610207171,399,60,0,12,0,12,0,12,399,60,81,57,318,72,12795
15000US060610207172,900,66,0,12,0,12,0,12,900,66,164,53,736,76,12796
15000US060610208051,734,78,16,15,0,12,16,15,718,79,108,55,610,81,12797
15000US060610208052,468,88,55,50,9,14,46,48,413,83,68,33,345,88,12798
15000US060610208053,469,99,30,37,0,12,30,37,439,96,83,54,356,85,12799
15000US060610208061,929,107,51,37,21,23,30,28,878,108,237,66,641,105,12800
15000US060610208062,694,83,54,50,20,23,34,45,640,91,177,69,463,100,12801
15000US060610209011,424,67,98,46,36,28,62,37,326,63,52,21,274,64,12802
15000US060610209012,519,68,107,45,29,16,78,42,412,73,94,42,318,76,12803
15000US060610209081,677,125,60,74,0,12,60,74,617,124,168,94,449,121,12804
15000US060610209082,753,124,39,47,0,12,39,47,714,127,170,82,544,137,12805
15000US060610209083,732,139,83,86,14,23,69,84,649,140,149,77,500,138,12806
15000US060610209084,370,92,0,12,0,12,0,12,370,92,172,81,198,73,12807
15000US060610210031,678,160,59,48,18,24,41,41,619,167,278,153,341,134,12808
15000US060610210032,244,71,0,12,0,12,0,12,244,71,148,86,96,56,12809
15000US060610210033,416,84,0,12,0,12,0,12,416,84,93,63,323,77,12810
15000US060610210034,222,72,19,32,19,32,0,12,203,71,54,40,149,64,12811
15000US060610210035,526,108,0,12,0,12,0,12,526,108,108,94,418,92,12812
15000US060610210036,276,124,52,83,0,12,52,83,224,132,38,45,186,121,12813
15000US060610210341,590,80,22,28,22,28,0,12,568,81,80,45,488,78,12814
15000US060610210342,471,81,0,12,0,12,0,12,471,81,66,40,405,80,12815
15000US060610210343,276,75,11,19,0,12,11,19,265,76,50,34,215,73,12816
15000US060610210351,647,116,0,12,0,12,0,12,647,116,118,81,529,117,12817
15000US060610210352,1092,146,10,17,0,12,10,17,1082,145,302,118,780,139,12818
15000US060610210353,741,127,33,48,33,48,0,12,708,127,77,66,631,136,12819
15000US060610210371,963,41,55,39,11,11,44,37,908,55,200,53,708,68,12820
15000US060610210381,306,85,0,12,0,12,0,12,306,85,13,23,293,81,12821
15000US060610210382,659,124,24,28,14,22,10,16,635,125,135,78,500,136,12822
15000US060610210383,615,144,79,60,40,38,39,43,536,139,96,74,440,135,12823
15000US060610210384,762,126,11,19,0,12,11,19,751,127,90,58,661,139,12824
15000US060610210391,559,58,9,13,0,12,9,13,550,57,167,44,383,64,12825
15000US060610210392,443,45,0,12,0,12,0,12,443,45,174,66,269,68,12826
15000US060610210401,562,68,0,12,0,12,0,12,562,68,260,84,302,79,12827
15000US060610210402,873,90,32,36,16,26,16,25,841,92,349,97,492,104,12828
15000US060610210403,623,71,0,12,0,12,0,12,623,71,225,79,398,82,12829
15000US060610210431,532,70,0,12,0,12,0,12,532,70,110,57,422,75,12830
15000US060610210432,620,68,0,12,0,12,0,12,620,68,88,44,532,74,12831
15000US060610210441,568,102,13,20,0,12,13,20,555,104,108,55,447,104,12832
15000US060610210442,744,77,34,37,0,12,34,37,710,78,94,50,616,83,12833
15000US060610210443,518,81,0,12,0,12,0,12,518,81,69,42,449,85,12834
15000US060610210451,837,82,97,68,50,53,47,37,740,90,75,34,665,92,12835
15000US060610210452,276,72,0,12,0,12,0,12,276,72,34,25,242,73,12836
15000US060610210461,280,85,25,25,0,12,25,25,255,84,26,29,229,85,12837
15000US060610210462,819,128,33,48,0,12,33,48,786,119,151,60,635,124,12838
15000US060610210463,851,119,18,28,0,12,18,28,833,117,233,81,600,119,12839
15000US060610211031,313,80,6,10,0,12,6,10,307,80,104,70,203,68,12840
15000US060610211032,235,80,7,11,0,12,7,11,228,79,19,17,209,81,12841
15000US060610211033,457,80,71,58,20,20,51,52,386,65,136,52,250,64,12842
15000US060610211034,337,84,0,12,0,12,0,12,337,84,82,50,255,83,12843
15000US060610211061,351,47,0,12,0,12,0,12,351,47,79,33,272,48,12844
15000US060610211062,542,59,0,12,0,12,0,12,542,59,118,38,424,60,12845
15000US060610211081,259,74,19,24,0,12,19,24,240,72,19,20,221,75,12846
15000US060610211082,957,89,76,49,46,34,30,36,881,99,325,91,556,108,12847
15000US060610211091,849,79,0,12,0,12,0,12,849,79,95,47,754,86,12848
15000US060610211092,858,78,64,34,26,27,38,26,794,87,191,67,603,90,12849
15000US060610211221,903,57,10,16,10,16,0,12,893,60,251,59,642,84,12850
15000US060610211222,411,45,14,17,14,17,0,12,397,47,55,36,342,53,12851
15000US060610211231,984,115,0,12,0,12,0,12,984,115,150,66,834,119,12852
15000US060610211232,667,113,13,23,0,12,13,23,654,116,47,42,607,116,12853
15000US060610211233,1066,123,0,12,0,12,0,12,1066,123,273,106,793,129,12854
15000US060610211281,428,84,17,26,0,12,17,26,411,78,59,41,352,86,12855
15000US060610211282,692,89,0,12,0,12,0,12,692,89,108,54,584,92,12856
15000US060610211291,825,96,92,45,37,25,55,37,733,104,188,66,545,105,12857
15000US060610211292,540,90,21,34,0,12,21,34,519,85,91,61,428,80,12858
15000US060610211301,1281,70,73,62,51,58,22,20,1208,96,199,67,1009,111,12859
15000US060610211311,573,78,10,16,10,16,0,12,563,80,112,50,451,84,12860
15000US060610211312,1341,101,65,44,13,20,52,40,1276,104,328,110,948,114,12861
15000US060610212031,1234,185,38,46,0,12,38,46,1196,185,265,162,931,209,12862
15000US060610212032,734,137,0,12,0,12,0,12,734,137,186,75,548,137,12863
15000US060610212033,680,147,0,12,0,12,0,12,680,147,144,83,536,151,12864
15000US060610212041,537,68,10,12,10,12,0,12,527,70,108,47,419,68,12865
15000US060610212042,368,59,26,35,26,35,0,12,342,59,95,46,247,63,12866
15000US060610213041,685,121,33,52,0,12,33,52,652,114,164,78,488,119,12867
15000US060610213042,246,70,39,35,15,23,24,27,207,77,73,75,134,57,12868
15000US060610213043,532,102,0,12,0,12,0,12,532,102,98,60,434,103,12869
15000US060610213044,451,70,0,12,0,12,0,12,451,70,142,65,309,74,12870
15000US060610213091,255,55,0,12,0,12,0,12,255,55,28,33,227,60,12871
15000US060610213092,550,109,18,27,0,12,18,27,532,109,148,79,384,109,12872
15000US060610213093,1157,162,90,63,19,31,71,53,1067,159,168,93,899,146,12873
15000US060610213094,1452,205,108,146,0,17,108,146,1344,156,216,89,1128,171,12874
15000US060610213221,145,62,7,9,0,12,7,9,138,61,30,34,108,53,12875
15000US060610213222,4372,184,316,138,28,31,288,138,4056,212,618,173,3438,208,12876
15000US060610214011,355,57,15,15,7,11,8,10,340,59,68,34,272,58,12877
15000US060610214012,477,76,67,37,27,16,40,34,410,74,96,39,314,71,12878
15000US060610214031,473,132,156,85,54,86,102,99,317,123,52,61,265,126,12879
15000US060610214032,346,112,0,12,0,12,0,12,346,112,107,72,239,122,12880
15000US060610214033,317,104,0,12,0,12,0,12,317,104,78,65,239,89,12881
15000US060610214034,674,131,90,61,31,36,59,49,584,141,231,114,353,134,12882
15000US060610214035,512,122,41,37,12,19,29,33,471,126,67,43,404,132,12883
15000US060610215011,291,69,2,4,2,4,0,12,289,69,41,31,248,68,12884
15000US060610215012,1325,170,58,60,29,33,29,50,1267,162,248,103,1019,159,12885
15000US060610215013,492,110,15,23,0,12,15,23,477,110,107,62,370,119,12886
15000US060610215021,1049,93,39,24,20,19,19,19,1010,94,197,69,813,111,12887
15000US060610215022,423,66,18,18,18,18,0,12,405,64,83,35,322,63,12888
15000US060610216031,1227,124,125,60,33,34,92,63,1102,125,449,101,653,126,12889
15000US060610216032,393,101,80,66,17,20,63,70,313,102,85,56,228,101,12890
15000US060610216033,287,55,0,12,0,12,0,12,287,55,121,57,166,55,12891
15000US060610216041,522,85,0,12,0,12,0,12,522,85,125,49,397,85,12892
15000US060610216042,747,88,21,23,0,12,21,23,726,87,236,63,490,95,12893
15000US060610218011,647,97,10,15,10,15,0,12,637,95,211,87,426,86,12894
15000US060610218012,581,97,10,15,10,15,0,12,571,96,176,78,395,97,12895
15000US060610218013,325,74,0,12,0,12,0,12,325,74,82,40,243,72,12896
15000US060610218014,267,59,25,35,0,12,25,35,242,58,32,32,210,60,12897
15000US060610218021,588,116,59,69,0,12,59,69,529,126,81,51,448,121,12898
15000US060610218022,1198,124,64,50,64,50,0,12,1134,130,322,101,812,165,12899
15000US060610218023,292,48,46,34,21,25,25,26,246,58,107,49,139,56,12900
15000US060610218024,424,60,17,16,11,13,6,9,407,64,112,49,295,66,12901
15000US060610219011,462,97,23,34,5,18,18,30,439,90,67,34,372,94,12902
15000US060610219012,731,98,18,20,9,14,9,14,713,104,196,86,517,101,12903
15000US060610219021,724,93,30,27,30,27,0,12,694,99,162,57,532,98,12904
15000US060610219022,825,97,7,10,0,12,7,10,818,97,131,65,687,114,12905
15000US060610219023,269,62,18,21,18,21,0,12,251,65,57,35,194,66,12906
15000US060610220021,509,122,20,25,20,25,0,12,489,118,179,102,310,95,12907
15000US060610220022,1101,140,104,68,67,70,37,36,997,134,409,126,588,134,12908
15000US060610220023,1159,164,54,36,13,20,41,32,1105,167,417,137,688,148,12909
15000US060610220111,260,69,17,26,17,26,0,12,243,69,19,16,224,68,12910
15000US060610220112,414,81,6,8,6,8,0,12,408,82,50,37,358,77,12911
15000US060610220131,252,52,22,15,7,7,15,13,230,52,100,35,130,39,12912
15000US060610220132,373,59,18,19,9,13,9,13,355,58,113,43,242,62,12913
15000US060610220133,453,80,19,17,3,6,16,16,434,80,105,32,329,80,12914
15000US060610220141,119,52,0,12,0,12,0,12,119,52,14,21,105,48,12915
15000US060610220142,246,86,0,12,0,12,0,12,246,86,31,30,215,78,12916
15000US060610220143,188,63,0,12,0,12,0,12,188,63,69,49,119,51,12917
15000US060610221001,257,88,0,12,0,12,0,12,257,88,12,13,245,86,12918
15000US060610221002,78,47,0,12,0,12,0,12,78,47,35,34,43,36,12919
15000US060610222001,237,71,22,27,0,12,22,27,215,65,5,8,210,64,12920
15000US060610222002,61,39,6,8,0,12,6,8,55,38,11,11,44,36,12921
15000US060610223001,57,26,0,12,0,12,0,12,57,26,15,17,42,25,12922
15000US060610223002,155,59,6,8,0,12,6,8,149,58,11,19,138,56,12923
15000US060610224001,745,73,22,23,9,14,13,18,723,72,164,61,559,75,12924
15000US060610224002,987,79,31,31,18,27,13,18,956,83,78,40,878,88,12925
15000US060610225001,746,135,26,24,15,18,11,16,720,134,172,69,548,132,12926
15000US060610225002,841,105,15,20,0,12,15,20,826,104,125,54,701,115,12927
15000US060610226001,1900,97,68,43,8,14,60,45,1832,99,273,108,1559,133,12928
15000US060610228001,1518,66,49,42,31,36,18,21,1469,76,281,72,1188,90,12929
15000US060610229001,1762,76,126,55,100,51,26,24,1636,85,197,69,1439,97,12930
15000US060610230001,993,44,49,32,22,23,27,23,944,52,120,36,824,65,12931
15000US060610231001,574,117,0,12,0,12,0,12,574,117,126,76,448,114,12932
15000US060610231002,869,131,26,40,0,12,26,40,843,130,155,82,688,131,12933
15000US060610231003,1125,171,47,77,0,12,47,77,1078,166,220,120,858,181,12934
15000US060610232001,1629,67,60,50,31,39,29,30,1569,79,351,78,1218,113,12935
15000US060610233001,698,82,30,27,9,13,21,25,668,82,118,53,550,93,12936
15000US060610233002,878,81,20,19,11,14,9,14,858,85,179,63,679,98,12937
15000US060610234001,1293,88,37,32,7,11,30,31,1256,90,234,86,1022,106,12938
15000US060610234002,226,61,18,20,18,20,0,12,208,64,18,19,190,66,12939
15000US060610235001,1666,77,19,21,0,17,19,21,1647,79,228,72,1419,104,12940
15000US060610236001,1451,104,0,12,0,12,0,12,1451,104,349,99,1102,125,12941
15000US060610236002,1163,89,17,27,0,12,17,27,1146,91,248,98,898,119,12942
15000US060610237001,1041,78,15,24,15,24,0,12,1026,82,464,103,562,115,12943
15000US060610237002,899,100,0,12,0,12,0,12,899,100,297,88,602,106,12944
15000US060610238001,1897,89,8,13,8,13,0,12,1889,90,555,112,1334,143,12945
15000US060610239001,1040,37,49,42,3,5,46,42,991,53,268,61,723,70,12946
15000US060619900000,0,12,0,12,0,12,0,12,0,12,0,12,0,12,12947
15000US060630001001,287,103,41,51,41,51,0,12,246,103,106,80,140,79,12948
15000US060630001002,441,141,37,35,0,12,37,35,404,146,196,103,208,109,12949
15000US060630001003,362,105,41,52,41,52,0,12,321,104,196,98,125,64,12950
15000US060630001004,642,128,81,76,62,68,19,28,561,129,200,104,361,116,12951
15000US060630001005,263,103,0,12,0,12,0,12,263,103,96,67,167,91,12952
15000US060630001006,294,98,0,12,0,12,0,12,294,98,119,81,175,88,12953
15000US060630002011,412,67,15,16,0,12,15,16,397,68,74,33,323,71,12954
15000US060630002012,347,90,0,12,0,12,0,12,347,90,131,65,216,73,12955
15000US060630002021,262,61,0,12,0,12,0,12,262,61,50,39,212,61,12956
15000US060630002022,217,66,6,9,6,9,0,12,211,65,91,47,120,49,12957
15000US060630003001,312,91,38,53,38,53,0,12,274,73,109,59,165,64,12958
15000US060630003002,520,145,41,32,22,18,19,25,479,142,94,49,385,139,12959
15000US060630003003,521,115,89,43,29,30,60,47,432,106,146,66,286,88,12960
15000US060630003004,401,138,0,12,0,12,0,12,401,138,82,76,319,121,12961
15000US060630004001,325,78,15,20,0,12,15,20,310,74,69,35,241,80,12962
15000US060630004002,402,116,44,45,35,43,9,14,358,117,106,78,252,106,12963
15000US060630004003,476,104,25,36,25,36,0,12,451,107,218,87,233,96,12964
15000US060630005011,281,63,16,21,4,8,12,20,265,66,67,35,198,62,12965
15000US060630005012,657,102,111,62,56,40,55,42,546,99,148,65,398,98,12966
15000US060630005021,208,53,5,9,0,12,5,9,203,51,71,29,132,41,12967
15000US060630005022,284,63,0,12,0,12,0,12,284,63,83,54,201,56,12968
15000US060630005023,462,82,27,27,3,6,24,26,435,81,110,43,325,81,12969
15000US060650301011,366,13,66,32,15,18,51,31,300,33,128,44,172,53,12970
15000US060650301031,232,63,34,28,9,14,25,25,198,66,37,28,161,63,12971
15000US060650301032,449,59,97,62,3,5,94,62,352,83,102,41,250,83,12972
15000US060650301041,702,126,58,54,17,19,41,50,644,126,124,74,520,114,12973
15000US060650301042,265,88,0,12,0,12,0,12,265,88,116,85,149,77,12974
15000US060650301043,1029,143,144,78,17,19,127,76,885,153,249,97,636,148,12975
15000US060650302001,571,71,66,45,32,29,34,34,505,75,80,37,425,76,12976
15000US060650302002,185,65,0,12,0,12,0,12,185,65,0,12,185,65,12977
15000US060650302003,469,97,140,64,33,28,107,59,329,93,70,45,259,86,12978
15000US060650302004,343,82,15,17,0,12,15,17,328,84,52,27,276,86,12979
15000US060650302005,268,68,7,11,7,11,0,12,261,68,35,26,226,69,12980
15000US060650303001,443,114,62,50,30,39,32,32,381,117,65,37,316,118,12981
15000US060650303002,114,57,13,12,8,12,5,8,101,58,39,40,62,45,12982
15000US060650303003,168,81,6,10,0,12,6,10,162,81,40,44,122,76,12983
15000US060650303004,466,103,62,61,0,12,62,61,404,107,149,75,255,100,12984
15000US060650303005,308,92,51,58,15,16,36,56,257,82,66,43,191,80,12985
15000US060650304001,186,68,65,51,0,12,65,51,121,53,43,36,78,45,12986
15000US060650304002,438,79,73,54,22,33,51,42,365,79,123,60,242,77,12987
15000US060650304003,231,81,51,46,15,17,36,42,180,74,71,54,109,62,12988
15000US060650304004,259,81,86,52,14,24,72,51,173,68,13,15,160,68,12989
15000US060650304005,480,93,110,67,45,39,65,54,370,95,105,52,265,83,12990
15000US060650305011,347,83,80,57,25,33,55,47,267,73,46,32,221,68,12991
15000US060650305012,442,88,138,64,46,44,92,50,304,78,84,57,220,80,12992
15000US060650305013,273,83,35,38,14,22,21,33,238,76,73,52,165,66,12993
15000US060650305014,239,55,0,12,0,12,0,12,239,55,108,52,131,53,12994
15000US060650305021,246,59,80,45,3,7,77,45,166,58,39,30,127,52,12995
15000US060650305022,271,53,62,30,23,18,39,26,209,53,74,36,135,50,12996
15000US060650305031,230,60,45,32,23,20,22,25,185,58,29,26,156,56,12997
15000US060650305032,403,78,142,62,60,37,82,49,261,73,65,32,196,71,12998
15000US060650305033,286,62,97,53,55,40,42,35,189,55,55,34,134,45,12999
15000US060650306011,696,91,0,12,0,12,0,12,696,91,81,39,615,106,13000
15000US060650306012,332,59,11,17,11,17,0,12,321,59,90,43,231,57,13001
15000US060650306013,764,80,0,12,0,12,0,12,764,80,152,61,612,86,13002
15000US060650306021,497,65,0,12,0,12,0,12,497,65,155,59,342,69,13003
15000US060650306022,488,67,16,25,16,25,0,12,472,69,148,52,324,82,13004
15000US060650306023,272,56,0,12,0,12,0,12,272,56,68,41,204,64,13005
15000US060650306031,517,76,6,10,0,12,6,10,511,77,88,41,423,78,13006
15000US060650306032,265,58,10,18,10,18,0,12,255,52,42,32,213,59,13007
15000US060650306033,281,47,0,12,0,12,0,12,281,47,47,34,234,56,13008
15000US060650307001,504,95,34,41,0,12,34,41,470,92,127,64,343,102,13009
15000US060650307002,644,151,243,121,32,50,211,108,401,116,124,84,277,103,13010
15000US060650307003,279,86,13,25,13,25,0,12,266,85,54,66,212,72,13011
15000US060650307004,289,108,20,29,20,29,0,12,269,112,122,81,147,85,13012
15000US060650307005,391,121,0,12,0,12,0,12,391,121,73,84,318,124,13013
15000US060650308001,192,57,23,40,0,12,23,40,169,58,49,44,120,60,13014
15000US060650308002,242,74,0,12,0,12,0,12,242,74,21,20,221,79,13015
15000US060650308003,768,142,71,64,61,62,10,17,697,143,143,77,554,184,13016
15000US060650308004,770,172,158,133,16,29,142,133,612,168,102,77,510,159,13017
15000US060650308005,475,127,13,20,13,20,0,12,462,130,85,59,377,133,13018
15000US060650309001,339,55,46,30,14,15,32,30,293,59,104,42,189,53,13019
15000US060650309002,515,52,37,27,5,7,32,25,478,56,88,37,390,57,13020
15000US060650310011,637,141,0,12,0,12,0,12,637,141,136,92,501,167,13021
15000US060650310012,894,140,0,12,0,12,0,12,894,140,303,136,591,148,13022
15000US060650310013,670,142,50,47,16,24,34,40,620,147,157,105,463,140,13023
15000US060650310021,365,72,24,29,24,29,0,12,341,72,115,42,226,76,13024
15000US060650310022,400,82,69,58,7,12,62,57,331,79,107,40,224,82,13025
15000US060650310023,412,83,117,64,66,50,51,54,295,76,59,39,236,77,13026
15000US060650311001,671,104,176,91,43,35,133,83,495,112,72,38,423,110,13027
15000US060650311002,185,62,33,29,15,21,18,20,152,59,42,29,110,57,13028
15000US060650311003,240,49,5,8,5,8,0,12,235,51,63,37,172,54,13029
15000US060650311004,130,62,18,20,0,12,18,20,112,63,8,12,104,63,13030
15000US060650311005,407,67,38,38,0,12,38,38,369,69,44,28,325,75,13031
15000US060650312001,316,98,0,12,0,12,0,12,316,98,85,63,231,108,13032
15000US060650312002,240,93,35,52,35,52,0,12,205,94,70,61,135,94,13033
15000US060650312003,393,102,0,12,0,12,0,12,393,102,96,67,297,94,13034
15000US060650312004,471,127,28,40,16,33,12,21,443,128,107,66,336,142,13035
15000US060650312005,627,131,80,85,0,12,80,85,547,134,92,59,455,133,13036
15000US060650313001,316,54,57,36,20,18,37,31,259,57,69,37,190,55,13037
15000US060650313002,324,49,74,43,35,36,39,28,250,67,28,20,222,67,13038
15000US060650314011,198,60,32,29,9,19,23,23,166,67,91,65,75,55,13039
15000US060650314012,247,109,0,12,0,12,0,12,247,109,41,42,206,121,13040
15000US060650314013,364,152,75,84,12,19,63,82,289,132,21,23,268,131,13041
15000US060650314014,792,162,167,88,91,64,76,78,625,184,162,76,463,182,13042
15000US060650314015,559,169,95,83,11,22,84,83,464,161,59,41,405,158,13043
15000US060650314021,1124,157,101,75,9,14,92,74,1023,183,389,126,634,183,13044
15000US060650314022,359,111,6,11,0,12,6,11,353,109,46,49,307,104,13045
15000US060650314023,352,85,17,26,17,26,0,12,335,84,132,76,203,84,13046
15000US060650314024,485,99,85,88,30,34,55,76,400,121,94,78,306,122,13047
15000US060650315011,259,87,11,19,0,12,11,19,248,87,17,28,231,88,13048
15000US060650315012,250,115,9,14,0,12,9,14,241,116,94,87,147,75,13049
15000US060650315013,340,118,14,23,14,23,0,12,326,117,44,46,282,112,13050
15000US060650315014,289,101,0,12,0,12,0,12,289,101,31,39,258,106,13051
15000US060650315015,472,96,68,57,10,16,58,55,404,98,226,92,178,90,13052
15000US060650315021,1073,184,275,179,0,12,275,179,798,199,381,181,417,184,13053
15000US060650315022,506,167,31,37,31,37,0,12,475,163,103,90,372,185,13054
15000US060650315023,773,141,168,119,44,47,124,114,605,122,173,81,432,121,13055
15000US060650315024,303,109,0,12,0,12,0,12,303,109,121,88,182,113,13056
15000US060650315025,217,80,28,38,12,19,16,30,189,76,91,59,98,73,13057
15000US060650316011,491,95,116,68,33,32,83,63,375,107,139,69,236,101,13058
15000US060650316012,251,78,17,19,0,12,17,19,234,78,56,43,178,76,13059
15000US060650316013,532,106,34,28,24,22,10,16,498,109,113,69,385,108,13060
15000US060650316021,118,78,8,13,8,13,0,12,110,80,25,18,85,78,13061
15000US060650316022,673,108,114,71,0,12,114,71,559,106,92,46,467,106,13062
15000US060650316023,269,79,113,75,52,51,61,54,156,71,80,57,76,51,13063
15000US060650316024,656,105,162,85,108,75,54,45,494,110,188,71,306,89,13064
15000US060650317011,376,62,138,60,27,31,111,52,238,57,34,24,204,59,13065
15000US060650317012,375,65,0,12,0,12,0,12,375,65,103,41,272,63,13066
15000US060650317021,351,56,36,34,19,19,17,25,315,60,56,29,259,63,13067
15000US060650317022,410,60,0,12,0,12,0,12,410,60,91,37,319,66,13068
15000US060650317031,446,85,31,34,0,12,31,34,415,89,54,41,361,90,13069
15000US060650317032,629,87,94,58,31,37,63,50,535,87,126,42,409,91,13070
15000US060650317041,373,86,50,42,25,23,25,35,323,83,83,43,240,73,13071
15000US060650317042,455,96,25,34,0,12,25,34,430,96,65,38,365,97,13072
15000US060650317043,341,70,7,12,0,12,7,12,334,72,84,57,250,70,13073
15000US060650317044,442,90,14,17,14,17,0,12,428,96,108,51,320,103,13074
15000US060650401011,548,77,48,30,14,12,34,30,500,81,151,66,349,75,13075
15000US060650401012,259,62,96,55,38,31,58,43,163,53,67,33,96,40,13076
15000US060650401013,169,55,28,33,28,33,0,12,141,47,67,38,74,37,13077
15000US060650401021,518,92,114,61,89,62,25,27,404,98,135,57,269,86,13078
15000US060650401022,500,95,28,27,10,15,18,25,472,98,91,43,381,95,13079
15000US060650402011,1196,125,235,113,186,103,49,46,961,129,311,100,650,133,13080
15000US060650402012,443,93,17,23,0,12,17,23,426,98,133,73,293,88,13081
15000US060650402021,488,56,129,65,26,30,103,61,359,66,133,59,226,57,13082
15000US060650402022,432,58,75,37,47,33,28,18,357,60,110,47,247,68,13083
15000US060650402031,481,71,203,61,117,58,86,40,278,71,95,55,183,65,13084
15000US060650402032,466,66,153,61,29,24,124,56,313,67,47,28,266,63,13085
15000US060650402041,391,68,123,51,46,34,77,49,268,67,41,31,227,67,13086
15000US060650402042,443,56,130,37,64,30,66,29,313,64,149,47,164,44,13087
15000US060650403011,680,160,178,97,63,61,115,90,502,162,141,80,361,143,13088
15000US060650403012,536,140,128,88,31,45,97,83,408,152,136,83,272,138,13089
15000US060650403013,418,126,130,105,64,75,66,70,288,112,39,46,249,115,13090
15000US060650403014,358,124,12,20,0,12,12,20,346,123,99,92,247,107,13091
15000US060650403021,1240,168,29,43,0,12,29,43,1211,178,383,152,828,214,13092
15000US060650403022,549,128,39,38,21,25,18,29,510,132,98,72,412,136,13093
15000US060650403023,347,92,27,32,14,25,13,21,320,91,75,51,245,93,13094
15000US060650403031,896,58,130,65,52,44,78,43,766,79,217,72,549,91,13095
15000US060650404021,415,80,43,35,15,24,28,35,372,75,139,62,233,75,13096
15000US060650404022,626,77,129,74,86,67,43,39,497,99,145,69,352,110,13097
15000US060650404031,485,91,105,70,54,58,51,40,380,79,58,36,322,87,13098
15000US060650404032,308,82,31,33,0,12,31,33,277,74,142,55,135,66,13099
15000US060650404033,541,71,32,29,11,12,21,25,509,74,211,73,298,71,13100
15000US060650404041,915,42,87,42,52,35,35,23,828,55,238,74,590,85,13101
15000US060650404051,520,108,73,56,25,27,48,48,447,110,104,47,343,116,13102
15000US060650404052,1158,116,23,25,13,19,10,18,1135,116,415,116,720,103,13103
15000US060650405011,627,97,166,79,34,43,132,67,461,93,170,63,291,84,13104
15000US060650405012,543,98,143,73,59,56,84,52,400,100,116,61,284,98,13105
15000US060650405013,635,95,45,43,27,31,18,29,590,94,128,45,462,97,13106
15000US060650405021,1170,111,238,96,68,51,170,88,932,121,177,84,755,117,13107
15000US060650405022,454,97,171,78,30,25,141,76,283,84,122,61,161,70,13108
15000US060650405031,827,116,106,58,39,26,67,51,721,116,131,58,590,119,13109
15000US060650405032,93,48,0,12,0,12,0,12,93,48,42,44,51,35,13110
15000US060650405033,934,109,95,66,19,21,76,64,839,113,462,118,377,100,13111
15000US060650406031,591,57,54,35,47,32,7,10,537,68,142,48,395,67,13112
15000US060650406041,376,67,6,10,0,12,6,10,370,70,132,55,238,68,13113
15000US060650406042,539,97,1,8,0,12,1,8,538,96,181,67,357,102,13114
15000US060650406043,542,90,0,12,0,12,0,12,542,90,182,73,360,87,13115
15000US060650406051,326,77,89,52,23,26,66,48,237,67,92,38,145,56,13116
15000US060650406052,433,76,76,45,24,25,52,39,357,81,81,37,276,79,13117
15000US060650406061,486,62,50,36,23,21,27,29,436,67,121,58,315,59,13118
15000US060650406062,312,67,124,52,25,22,99,52,188,55,42,24,146,49,13119
15000US060650406071,1387,143,100,71,31,35,69,61,1287,161,333,126,954,155,13120
15000US060650406072,1089,156,100,82,90,78,10,18,989,160,180,90,809,178,13121
15000US060650406091,1376,152,104,81,26,31,78,73,1272,169,210,98,1062,187,13122
15000US060650406092,1719,165,104,73,25,28,79,67,1615,178,224,81,1391,181,13123
15000US060650406111,1228,100,0,12,0,12,0,12,1228,100,249,83,979,114,13124
15000US060650406112,658,98,99,86,80,79,19,25,559,107,114,58,445,93,13125
15000US060650406131,630,115,10,16,10,16,0,12,620,118,145,81,475,139,13126
15000US060650406132,1226,160,66,66,66,66,0,17,1160,173,234,100,926,174,13127
15000US060650406133,1142,151,128,90,31,47,97,83,1014,151,78,69,936,153,13128
15000US060650406151,1006,136,127,81,70,63,57,55,879,135,148,88,731,140,13129
15000US060650406152,244,100,13,21,0,12,13,21,231,98,61,60,170,86,13130
15000US060650406153,996,142,68,58,57,58,11,19,928,142,158,79,770,147,13131
15000US060650406161,920,106,3,9,0,12,3,9,917,107,201,72,716,106,13132
15000US060650406162,810,103,28,28,28,28,0,12,782,105,200,66,582,98,13133
15000US060650407011,243,43,0,12,0,12,0,12,243,43,55,33,188,43,13134
15000US060650407012,227,56,4,7,4,7,0,12,223,57,82,38,141,54,13135
15000US060650407013,214,43,0,12,0,12,0,12,214,43,29,20,185,46,13136
15000US060650407021,437,71,41,32,22,28,19,26,396,72,69,39,327,68,13137
15000US060650407022,471,70,46,37,7,11,39,35,425,72,153,53,272,65,13138
15000US060650407031,382,59,25,25,10,16,15,19,357,60,77,40,280,60,13139
15000US060650407032,587,74,15,12,8,9,7,9,572,73,139,42,433,80,13140
15000US060650408061,904,37,29,25,8,11,21,22,875,46,181,53,694,65,13141
15000US060650408071,411,54,40,36,35,34,5,8,371,59,104,40,267,64,13142
15000US060650408072,641,66,49,39,25,28,24,26,592,69,94,36,498,71,13143
15000US060650408081,484,120,24,31,0,12,24,31,460,126,48,45,412,135,13144
15000US060650408082,770,162,170,123,55,75,115,94,600,147,254,127,346,125,13145
15000US060650408083,1042,162,242,141,101,94,141,110,800,175,149,137,651,148,13146
15000US060650408091,474,93,37,32,8,13,29,30,437,92,22,21,415,88,13147
15000US060650408092,615,88,40,31,16,18,24,27,575,89,103,71,472,115,13148
15000US060650408121,1112,70,75,49,45,40,30,34,1037,80,265,90,772,107,13149
15000US060650408131,982,108,50,49,19,22,31,45,932,105,251,77,681,118,13150
15000US060650408132,847,87,85,60,31,28,54,56,762,100,196,75,566,93,13151
15000US060650408141,1101,123,56,54,8,17,48,50,1045,133,186,85,859,132,13152
15000US060650408142,562,105,84,58,33,39,51,47,478,101,126,68,352,102,13153
15000US060650408151,638,87,66,59,16,21,50,54,572,97,118,57,454,103,13154
15000US060650408152,602,98,36,38,29,33,7,11,566,102,51,38,515,99,13155
15000US060650408161,952,45,31,31,31,31,0,12,921,56,82,40,839,65,13156
15000US060650408211,1040,135,176,90,57,57,119,68,864,147,64,38,800,140,13157
15000US060650408212,943,115,17,20,0,12,17,20,926,113,58,33,868,115,13158
15000US060650409011,900,161,14,23,0,12,14,23,886,159,123,77,763,154,13159
15000US060650409012,664,113,0,12,0,12,0,12,664,113,92,65,572,116,13160
15000US060650409013,556,106,51,51,24,28,27,43,505,96,159,77,346,98,13161
15000US060650409021,420,68,8,13,0,12,8,13,412,71,64,32,348,70,13162
15000US060650409022,530,80,47,43,47,43,0,12,483,85,91,65,392,79,13163
15000US060650409023,628,85,43,38,43,38,0,12,585,85,215,65,370,94,13164
15000US060650409031,303,52,21,19,0,12,21,19,282,51,107,41,175,51,13165
15000US060650409032,423,72,87,47,16,16,71,44,336,77,87,44,249,82,13166
15000US060650409041,352,67,20,18,6,10,14,14,332,69,68,25,264,70,13167
15000US060650409042,638,63,45,41,12,15,33,34,593,64,164,55,429,68,13168
15000US060650410011,763,38,199,63,22,22,177,62,564,69,137,52,427,74,13169
15000US060650410021,418,50,68,37,17,21,51,32,350,48,108,39,242,51,13170
15000US060650410022,426,46,42,25,20,15,22,20,384,50,45,20,339,56,13171
15000US060650410031,725,31,50,26,17,11,33,24,675,38,190,53,485,64,13172
15000US060650410041,404,69,70,48,37,35,33,33,334,70,68,44,266,75,13173
15000US060650410042,737,79,207,88,31,37,176,84,530,119,87,55,443,116,13174
15000US060650410043,228,62,32,29,10,15,22,24,196,60,40,32,156,61,13175
15000US060650411011,282,92,152,85,0,12,152,85,130,69,0,12,130,69,13176
15000US060650411012,659,115,271,95,91,60,180,73,388,114,31,40,357,113,13177
15000US060650411013,325,85,79,53,34,38,45,35,246,77,58,56,188,73,13178
15000US060650411021,424,58,116,47,34,24,82,46,308,59,51,30,257,60,13179
15000US060650411022,552,65,77,35,30,19,47,30,475,68,74,35,401,70,13180
15000US060650412011,463,93,67,61,0,12,67,61,396,90,123,50,273,99,13181
15000US060650412012,776,101,149,87,95,74,54,47,627,119,71,61,556,120,13182
15000US060650412021,347,66,41,31,12,15,29,30,306,68,27,17,279,72,13183
15000US060650412022,407,62,61,34,27,25,34,24,346,68,120,52,226,63,13184
15000US060650412023,249,53,32,31,0,12,32,31,217,57,80,46,137,48,13185
15000US060650412031,455,54,40,32,16,14,24,27,415,59,123,44,292,60,13186
15000US060650412032,505,61,141,41,42,29,99,41,364,61,32,21,332,59,13187
15000US060650413011,466,58,98,38,20,16,78,38,368,59,112,36,256,58,13188
15000US060650413012,326,54,55,32,12,9,43,31,271,53,61,32,210,53,13189
15000US060650413021,618,79,158,66,60,45,98,58,460,84,167,57,293,90,13190
15000US060650413022,444,82,102,58,18,20,84,56,342,79,102,60,240,71,13191
15000US060650414031,785,68,36,24,20,16,16,17,749,74,201,55,548,75,13192
15000US060650414032,312,62,20,26,5,8,15,24,292,63,21,16,271,68,13193
15000US060650414041,527,63,50,33,29,21,21,26,477,66,95,42,382,73,13194
15000US060650414042,435,59,45,37,0,12,45,37,390,67,79,35,311,75,13195
15000US060650414051,692,106,98,68,66,46,32,52,594,111,123,70,471,117,13196
15000US060650414052,537,101,41,51,0,12,41,51,496,105,146,68,350,100,13197
15000US060650414061,1162,142,68,57,8,13,60,56,1094,143,197,88,897,130,13198
15000US060650414062,633,111,119,70,29,21,90,68,514,107,155,75,359,101,13199
15000US060650414071,742,97,33,37,33,37,0,12,709,101,157,67,552,93,13200
15000US060650414072,299,81,46,37,12,14,34,33,253,77,33,24,220,73,13201
15000US060650414073,616,95,93,42,29,32,64,32,523,92,103,45,420,88,13202
15000US060650414081,464,114,16,23,0,12,16,23,448,113,126,59,322,101,13203
15000US060650414082,802,136,138,77,49,42,89,58,664,127,75,61,589,129,13204
15000US060650414091,2031,256,117,118,117,118,0,17,1914,288,256,133,1658,294,13205
15000US060650414092,1382,237,42,57,0,12,42,57,1340,244,90,84,1250,243,13206
15000US060650414093,1134,226,31,48,0,12,31,48,1103,238,262,165,841,250,13207
15000US060650414094,275,183,132,165,31,51,101,156,143,115,30,49,113,103,13208
15000US060650414101,379,45,79,39,30,23,49,33,300,46,43,19,257,46,13209
15000US060650414102,294,44,79,37,0,12,79,37,215,48,31,26,184,46,13210
15000US060650414111,464,48,62,45,30,24,32,36,402,59,156,49,246,62,13211
15000US060650414112,320,49,12,16,5,9,7,14,308,53,119,54,189,53,13212
15000US060650414121,817,80,110,73,10,17,100,72,707,105,136,62,571,109,13213
15000US060650414122,591,83,29,26,17,19,12,17,562,86,217,80,345,91,13214
15000US060650415001,199,61,0,12,0,12,0,12,199,61,54,37,145,62,13215
15000US060650415002,651,80,120,67,19,18,101,65,531,85,71,41,460,92,13216
15000US060650416001,426,120,169,83,24,39,145,74,257,101,86,60,171,97,13217
15000US060650416002,639,133,106,81,29,47,77,67,533,126,69,43,464,127,13218
15000US060650416003,138,85,10,17,0,12,10,17,128,86,19,22,109,83,13219
15000US060650416004,539,120,95,72,0,12,95,72,444,111,75,49,369,112,13220
15000US060650417021,304,79,11,17,0,12,11,17,293,81,125,67,168,65,13221
15000US060650417022,652,102,55,58,0,12,55,58,597,94,127,67,470,99,13222
15000US060650417023,440,92,89,67,0,12,89,67,351,73,57,36,294,80,13223
15000US060650417031,492,76,129,66,0,12,129,66,363,73,60,33,303,75,13224
15000US060650417032,620,89,136,63,31,34,105,53,484,86,116,58,368,88,13225
15000US060650417033,667,87,186,76,22,20,164,74,481,89,136,62,345,97,13226
15000US060650417041,517,83,158,52,39,29,119,52,359,81,65,25,294,79,13227
15000US060650417042,460,82,148,49,32,29,116,45,312,83,113,49,199,64,13228
15000US060650418031,1116,120,19,21,8,14,11,16,1097,116,180,66,917,126,13229
15000US060650418032,829,110,6,11,0,12,6,11,823,112,130,63,693,104,13230
15000US060650418041,443,65,0,12,0,12,0,12,443,65,32,29,411,68,13231
15000US060650418042,874,91,0,12,0,12,0,12,874,91,134,68,740,94,13232
15000US060650418051,494,103,22,25,10,16,12,19,472,102,48,32,424,100,13233
15000US060650418052,575,99,10,16,0,12,10,16,565,96,115,53,450,87,13234
15000US060650418053,892,121,105,69,18,22,87,66,787,136,119,72,668,131,13235
15000US060650418061,620,82,24,34,0,12,24,34,596,82,125,63,471,85,13236
15000US060650418062,622,81,0,12,0,12,0,12,622,81,145,45,477,85,13237
15000US060650418071,365,45,7,9,0,12,7,9,358,44,85,43,273,53,13238
15000US060650418072,333,45,14,14,7,10,7,10,319,47,83,28,236,50,13239
15000US060650418081,739,102,46,58,10,15,36,56,693,101,102,57,591,111,13240
15000US060650418082,780,101,12,18,12,18,0,12,768,101,90,40,678,104,13241
15000US060650418083,719,114,10,15,0,12,10,15,709,115,238,71,471,111,13242
15000US060650418091,342,104,16,26,16,26,0,12,326,104,128,84,198,100,13243
15000US060650418092,607,169,66,55,47,46,19,29,541,174,134,78,407,174,13244
15000US060650418093,1157,162,60,59,28,42,32,38,1097,164,241,107,856,162,13245
15000US060650418101,538,93,0,12,0,12,0,12,538,93,35,29,503,98,13246
15000US060650418102,550,81,33,26,16,18,17,20,517,85,89,54,428,80,13247
15000US060650418103,540,77,12,18,0,12,12,18,528,77,89,45,439,89,13248
15000US060650418121,537,81,39,31,6,9,33,30,498,89,118,57,380,92,13249
15000US060650418122,548,81,0,12,0,12,0,12,548,81,122,69,426,87,13250
15000US060650418131,627,82,30,32,0,12,30,32,597,88,177,75,420,78,13251
15000US060650418132,910,117,30,25,30,25,0,12,880,116,342,90,538,107,13252
15000US060650418133,641,108,139,72,10,16,129,75,502,123,107,56,395,112,13253
15000US060650419041,495,85,21,27,8,12,13,24,474,83,75,42,399,88,13254
15000US060650419042,685,88,67,52,47,51,20,17,618,93,180,80,438,92,13255
15000US060650419043,399,90,50,37,20,24,30,26,349,99,54,36,295,98,13256
15000US060650419051,998,35,112,54,19,17,93,52,886,63,140,49,746,71,13257
15000US060650419061,625,108,99,55,32,25,67,47,526,106,118,38,408,106,13258
15000US060650419062,447,109,100,75,10,16,90,74,347,90,85,59,262,87,13259
15000US060650419063,487,95,40,43,8,13,32,42,447,88,104,51,343,92,13260
15000US060650419064,448,79,44,48,20,30,24,37,404,83,39,35,365,85,13261
15000US060650419091,322,81,62,55,11,19,51,58,260,71,103,58,157,57,13262
15000US060650419092,360,80,22,26,8,11,14,22,338,78,127,73,211,69,13263
15000US060650419093,330,84,44,48,44,48,0,12,286,73,89,51,197,74,13264
15000US060650419094,416,82,39,49,0,12,39,49,377,75,130,70,247,79,13265
15000US060650419101,1111,162,95,70,31,36,64,70,1016,166,201,88,815,158,13266
15000US060650419102,1260,156,103,93,91,93,12,20,1157,155,104,63,1053,160,13267
15000US060650419111,1148,179,47,47,17,25,30,43,1101,184,284,97,817,166,13268
15000US060650419112,649,135,20,30,20,30,0,12,629,132,136,100,493,119,13269
15000US060650419113,1852,185,44,46,5,13,39,46,1808,188,392,113,1416,221,13270
15000US060650419121,776,107,27,37,27,37,0,12,749,108,68,38,681,109,13271
15000US060650419122,495,100,29,46,0,12,29,46,466,96,57,36,409,99,13272
15000US060650419123,628,93,11,16,0,12,11,16,617,96,50,32,567,96,13273
15000US060650419131,598,83,17,25,2,9,15,23,581,87,95,54,486,90,13274
15000US060650419132,816,116,22,25,0,12,22,25,794,117,172,98,622,116,13275
15000US060650419133,736,111,0,12,0,12,0,12,736,111,57,35,679,115,13276
15000US060650420031,940,112,77,57,39,42,38,41,863,123,164,66,699,118,13277
15000US060650420032,721,112,17,20,0,12,17,20,704,110,178,53,526,115,13278
15000US060650420041,396,76,9,16,0,12,9,16,387,78,157,62,230,71,13279
15000US060650420042,661,79,25,26,9,16,16,19,636,80,109,46,527,82,13280
15000US060650420051,792,96,14,16,7,12,7,11,778,97,153,53,625,104,13281
15000US060650420052,794,85,28,31,0,12,28,31,766,91,100,48,666,94,13282
15000US060650420071,859,101,158,53,39,29,119,49,701,108,184,75,517,99,13283
15000US060650420072,546,81,15,18,7,12,8,13,531,82,189,68,342,81,13284
15000US060650420081,1180,166,56,77,0,12,56,77,1124,154,251,146,873,169,13285
15000US060650420082,1073,155,86,88,55,82,31,47,987,149,244,118,743,144,13286
15000US060650420091,709,108,64,40,54,37,10,15,645,115,139,69,506,113,13287
15000US060650420092,685,118,64,57,11,14,53,54,621,121,225,93,396,111,13288
15000US060650420093,454,119,78,42,56,39,22,36,376,120,140,78,236,105,13289
15000US060650420101,802,115,104,62,42,44,62,51,698,114,236,83,462,118,13290
15000US060650420102,648,117,97,67,35,34,62,57,551,119,166,77,385,105,13291
15000US060650420121,866,118,63,47,16,21,47,42,803,128,84,40,719,135,13292
15000US060650420122,1029,96,26,25,7,13,19,21,1003,101,219,77,784,110,13293
15000US060650420131,1545,127,59,76,59,76,0,17,1486,134,318,146,1168,155,13294
15000US060650420132,800,103,34,37,34,37,0,12,766,105,118,55,648,124,13295
15000US060650420141,1056,163,43,37,31,33,12,20,1013,167,210,116,803,168,13296
15000US060650420142,440,111,42,64,42,64,0,12,398,96,129,78,269,87,13297
15000US060650420143,1388,163,14,21,14,21,0,12,1374,160,288,108,1086,184,13298
15000US060650422061,804,172,30,29,12,20,18,22,774,172,64,55,710,169,13299
15000US060650422062,514,137,17,33,0,12,17,33,497,132,47,37,450,135,13300
15000US060650422063,272,83,29,30,0,12,29,30,243,86,30,35,213,88,13301
15000US060650422064,725,169,48,51,31,47,17,22,677,161,180,96,497,155,13302
15000US060650422071,569,67,8,12,0,12,8,12,561,67,66,38,495,69,13303
15000US060650422072,609,77,26,34,0,12,26,34,583,80,119,58,464,94,13304
15000US060650422081,412,41,5,9,5,9,0,12,407,43,117,41,290,50,13305
15000US060650422082,507,43,5,8,0,12,5,8,502,44,60,21,442,50,13306
15000US060650422091,914,113,208,95,101,66,107,64,706,121,153,64,553,129,13307
15000US060650422092,410,96,81,36,20,23,61,29,329,95,47,34,282,93,13308
15000US060650422101,487,112,74,58,33,39,41,43,413,106,64,54,349,93,13309
15000US060650422102,696,106,18,20,9,14,9,14,678,107,91,65,587,109,13310
15000US060650422103,561,101,96,60,21,33,75,52,465,102,65,57,400,102,13311
15000US060650422121,1100,138,125,95,28,36,97,87,975,158,93,71,882,157,13312
15000US060650422122,765,128,61,58,0,12,61,58,704,125,216,97,488,127,13313
15000US060650422131,443,85,20,22,0,12,20,22,423,89,92,48,331,87,13314
15000US060650422132,537,73,0,12,0,12,0,12,537,73,124,51,413,76,13315
15000US060650422133,532,82,30,29,6,11,24,25,502,84,174,55,328,84,13316
15000US060650422141,1134,109,31,38,0,12,31,38,1103,120,267,101,836,114,13317
15000US060650422142,636,101,63,56,21,28,42,45,573,102,82,59,491,95,13318
15000US060650422171,568,126,0,12,0,12,0,12,568,126,211,117,357,108,13319
15000US060650422172,588,121,0,12,0,12,0,12,588,121,25,27,563,130,13320
15000US060650422173,520,118,17,27,17,27,0,12,503,118,50,44,453,120,13321
15000US060650422174,378,95,0,12,0,12,0,12,378,95,49,51,329,102,13322
15000US060650423001,22,35,0,12,0,12,0,12,22,35,0,12,22,35,13323
15000US060650423002,640,124,68,87,12,19,56,83,572,104,169,84,403,108,13324
15000US060650423003,735,127,121,78,47,51,74,62,614,139,191,90,423,137,13325
15000US060650423004,601,120,235,83,69,54,166,85,366,112,17,21,349,116,13326
15000US060650424011,551,42,26,23,9,10,17,22,525,47,102,39,423,49,13327
15000US060650424021,793,85,70,44,25,25,45,38,723,88,161,71,562,104,13328
15000US060650424022,483,80,48,54,0,12,48,54,435,79,54,32,381,84,13329
15000US060650424031,655,88,49,41,49,41,0,12,606,82,153,73,453,100,13330
15000US060650424032,419,84,69,56,11,18,58,53,350,77,48,39,302,86,13331
15000US060650424041,597,17,161,54,28,20,133,50,436,54,146,53,290,65,13332
15000US060650424051,1212,104,365,101,106,51,259,87,847,108,229,88,618,94,13333
15000US060650424052,420,66,63,43,15,16,48,39,357,74,29,27,328,73,13334
15000US060650424061,581,67,79,50,23,28,56,43,502,80,39,31,463,86,13335
15000US060650424062,625,66,42,33,15,16,27,28,583,69,205,68,378,87,13336
15000US060650424071,533,68,31,24,22,21,9,11,502,71,152,55,350,70,13337
15000US060650424072,333,62,38,33,24,30,14,13,295,59,79,38,216,60,13338
15000US060650424081,411,55,22,19,11,12,11,14,389,57,65,26,324,59,13339
15000US060650424082,444,59,103,54,27,27,76,51,341,70,52,28,289,70,13340
15000US060650424091,394,69,71,38,33,26,38,32,323,72,68,37,255,75,13341
15000US060650424092,514,74,91,49,26,26,65,42,423,83,114,59,309,79,13342
15000US060650424101,829,95,35,34,35,34,0,12,794,99,331,115,463,103,13343
15000US060650424102,571,93,3,8,3,8,0,12,568,95,102,65,466,92,13344
15000US060650424111,300,47,15,15,4,7,11,13,285,47,78,40,207,46,13345
15000US060650424112,432,53,31,31,5,8,26,29,401,52,46,28,355,54,13346
15000US060650424121,420,102,0,12,0,12,0,12,420,102,194,90,226,88,13347
15000US060650424122,461,69,10,15,10,15,0,12,451,69,126,50,325,74,13348
15000US060650424123,594,88,37,23,27,22,10,14,557,93,177,80,380,87,13349
15000US060650425051,356,63,145,53,22,21,123,50,211,59,53,32,158,54,13350
15000US060650425052,481,67,121,44,29,23,92,46,360,60,162,53,198,57,13351
15000US060650425061,959,200,90,82,30,31,60,75,869,192,101,71,768,196,13352
15000US060650425062,1715,235,214,146,70,69,144,120,1501,261,187,136,1314,251,13353
15000US060650425071,673,103,89,55,47,35,42,42,584,117,156,69,428,110,13354
15000US060650425072,367,83,52,45,33,41,19,22,315,80,112,61,203,63,13355
15000US060650425081,473,105,193,93,21,32,172,88,280,95,39,32,241,93,13356
15000US060650425082,368,87,37,33,13,18,24,28,331,94,75,65,256,107,13357
15000US060650425083,427,91,80,56,8,15,72,53,347,89,91,49,256,71,13358
15000US060650425091,351,61,92,49,23,17,69,47,259,59,101,39,158,57,13359
15000US060650425092,458,57,75,33,43,28,32,21,383,67,108,48,275,58,13360
15000US060650425101,378,81,95,60,38,33,57,47,283,74,106,53,177,71,13361
15000US060650425102,423,117,180,104,0,12,180,104,243,89,52,37,191,86,13362
15000US060650425103,340,73,52,49,11,19,41,44,288,74,73,49,215,77,13363
15000US060650425111,458,55,157,56,83,51,74,38,301,52,100,41,201,52,13364
15000US060650425112,343,52,33,18,7,9,26,17,310,54,77,34,233,45,13365
15000US060650425121,362,62,35,23,4,7,31,21,327,62,89,39,238,55,13366
15000US060650425122,519,68,71,37,26,24,45,29,448,68,118,56,330,58,13367
15000US060650425131,275,56,67,38,14,21,53,33,208,50,114,47,94,45,13368
15000US060650425132,259,47,22,17,6,10,16,15,237,49,103,47,134,42,13369
15000US060650425133,250,46,21,15,7,10,14,14,229,48,52,25,177,47,13370
15000US060650425141,548,54,166,54,54,34,112,44,382,63,137,59,245,64,13371
15000US060650425142,253,52,44,30,0,12,44,30,209,50,36,20,173,50,13372
15000US060650425151,571,85,230,109,83,65,147,85,341,106,99,69,242,88,13373
15000US060650425152,469,92,142,78,30,41,112,67,327,96,107,69,220,93,13374
15000US060650425161,546,87,137,68,27,32,110,65,409,88,125,50,284,80,13375
15000US060650425162,445,87,72,61,17,21,55,54,373,96,54,42,319,99,13376
15000US060650425171,394,60,46,34,25,30,21,16,348,66,75,44,273,59,13377
15000US060650425172,429,65,81,47,27,23,54,42,348,64,48,28,300,68,13378
15000US060650425181,346,65,58,32,31,20,27,25,288,66,69,39,219,57,13379
15000US060650425182,555,71,56,39,8,11,48,37,499,75,178,61,321,65,13380
15000US060650425191,508,33,166,69,80,44,86,60,342,69,64,29,278,72,13381
15000US060650425201,1313,61,298,99,122,64,176,75,1015,100,295,82,720,88,13382
15000US060650425211,586,87,83,45,27,22,56,41,503,97,129,77,374,94,13383
15000US060650425212,590,94,156,61,74,45,82,60,434,95,64,44,370,80,13384
15000US060650426171,666,159,218,125,68,63,150,112,448,137,225,104,223,108,13385
15000US060650426172,633,153,142,72,17,29,125,66,491,152,146,86,345,138,13386
15000US060650426173,1206,176,233,86,124,78,109,68,973,168,333,118,640,138,13387
15000US060650426181,1111,118,310,93,111,57,199,77,801,130,186,72,615,129,13388
15000US060650426182,717,115,206,98,15,19,191,96,511,99,95,53,416,95,13389
15000US060650426191,2652,145,399,163,130,81,269,157,2253,187,630,202,1623,241,13390
15000US060650426201,582,160,120,111,0,12,120,111,462,147,85,69,377,128,13391
15000US060650426202,2204,198,335,178,128,106,207,135,1869,234,416,162,1453,247,13392
15000US060650426211,870,92,86,70,8,13,78,69,784,108,174,71,610,103,13393
15000US060650426212,813,102,58,47,6,10,52,44,755,114,164,66,591,116,13394
15000US060650426221,1186,85,46,35,22,23,24,27,1140,95,272,93,868,111,13395
15000US060650426231,1242,76,53,37,12,19,41,32,1189,79,300,81,889,97,13396
15000US060650426241,1022,65,155,67,81,61,74,43,867,87,174,65,693,100,13397
15000US060650427061,285,81,26,26,26,26,0,12,259,81,36,24,223,76,13398
15000US060650427062,466,104,134,81,62,54,72,66,332,90,64,49,268,88,13399
15000US060650427063,602,127,95,62,15,18,80,58,507,121,96,54,411,111,13400
15000US060650427064,442,100,111,62,66,54,45,32,331,101,94,52,237,96,13401
15000US060650427081,564,90,28,24,17,18,11,18,536,97,148,87,388,110,13402
15000US060650427082,870,96,78,49,23,27,55,38,792,101,217,78,575,94,13403
15000US060650427091,1057,143,10,17,10,17,0,12,1047,144,353,149,694,133,13404
15000US060650427092,778,116,0,12,0,12,0,12,778,116,269,84,509,99,13405
15000US060650427111,1108,141,11,20,11,20,0,12,1097,139,435,125,662,152,13406
15000US060650427112,595,96,20,24,20,24,0,12,575,98,364,97,211,74,13407
15000US060650427113,912,132,42,55,7,13,35,52,870,136,389,112,481,139,13408
15000US060650427141,750,119,15,26,15,26,0,12,735,116,195,73,540,119,13409
15000US060650427142,589,112,13,20,13,20,0,12,576,113,166,78,410,115,13410
15000US060650427151,578,174,61,87,61,87,0,12,517,179,29,46,488,181,13411
15000US060650427152,983,257,26,43,26,43,0,12,957,262,113,92,844,275,13412
15000US060650427153,2442,345,191,123,108,92,83,79,2251,328,379,177,1872,322,13413
15000US060650427161,527,106,9,14,0,12,9,14,518,105,80,62,438,103,13414
15000US060650427162,740,108,86,50,33,29,53,41,654,121,135,57,519,121,13415
15000US060650427163,612,117,0,12,0,12,0,12,612,117,101,48,511,120,13416
15000US060650427171,1540,78,306,117,96,66,210,102,1234,136,276,98,958,146,13417
15000US060650427191,924,98,95,57,35,34,60,45,829,102,166,76,663,104,13418
15000US060650427192,613,96,109,60,59,46,50,44,504,94,161,59,343,94,13419
15000US060650427201,577,108,91,58,53,35,38,41,486,126,173,83,313,111,13420
15000US060650427202,811,130,141,77,58,46,83,62,670,135,172,78,498,131,13421
15000US060650427231,995,130,198,89,66,52,132,76,797,137,284,85,513,120,13422
15000US060650427232,939,133,257,110,60,41,197,108,682,134,225,75,457,125,13423
15000US060650427241,943,39,84,41,52,37,32,23,859,54,136,42,723,61,13424
15000US060650427261,2006,75,132,71,99,69,33,28,1874,96,396,103,1478,126,13425
15000US060650427281,646,51,55,39,31,32,24,18,591,55,188,45,403,56,13426
15000US060650427291,1333,180,96,64,43,56,53,46,1237,182,553,130,684,202,13427
15000US060650427292,1397,219,147,124,73,92,74,82,1250,246,311,137,939,233,13428
15000US060650427293,1242,187,52,55,21,34,31,44,1190,177,466,112,724,156,13429
15000US060650427301,385,102,81,67,33,41,48,54,304,91,77,43,227,88,13430
15000US060650427302,978,126,146,81,34,43,112,80,832,122,317,96,515,120,13431
15000US060650427311,802,111,82,48,21,20,61,44,720,116,239,82,481,114,13432
15000US060650427312,1017,97,74,46,45,38,29,32,943,107,98,52,845,114,13433
15000US060650427321,1741,66,151,73,44,46,107,54,1590,86,434,127,1156,145,13434
15000US060650427331,1711,125,37,30,8,11,29,27,1674,126,464,101,1210,143,13435
15000US060650427332,50,26,0,12,0,12,0,12,50,26,7,11,43,28,13436
15000US060650427371,716,54,56,39,20,23,36,33,660,63,144,47,516,69,13437
15000US060650427381,766,120,58,52,40,49,18,20,708,114,86,47,622,120,13438
15000US060650427382,1425,128,193,88,17,20,176,88,1232,131,213,72,1019,130,13439
15000US060650427391,1108,128,77,44,19,23,58,38,1031,130,282,80,749,132,13440
15000US060650427392,877,128,25,25,6,9,19,24,852,129,230,99,622,126,13441
15000US060650427401,885,58,22,21,8,12,14,16,863,60,380,76,483,86,13442
15000US060650427402,297,55,32,40,25,39,7,11,265,46,119,49,146,39,13443
15000US060650427411,545,71,27,26,16,20,11,17,518,78,258,81,260,60,13444
15000US060650427412,799,88,49,42,11,13,38,41,750,93,341,78,409,100,13445
15000US060650427421,1201,88,36,39,36,39,0,12,1165,92,324,115,841,137,13446
15000US060650427431,783,55,31,19,11,10,20,17,752,57,182,67,570,80,13447
15000US060650427441,1030,61,156,64,63,39,93,54,874,81,173,51,701,81,13448
15000US060650427451,1149,129,87,67,16,18,71,65,1062,128,363,88,699,123,13449
15000US060650427452,851,104,0,12,0,12,0,12,851,104,136,54,715,110,13450
15000US060650428001,497,145,98,85,34,46,64,71,399,133,70,73,329,125,13451
15000US060650428002,798,157,157,114,77,70,80,97,641,162,203,101,438,165,13452
15000US060650428003,817,165,96,80,18,21,78,77,721,161,331,133,390,130,13453
15000US060650429011,754,119,120,79,79,70,41,41,634,126,275,93,359,100,13454
15000US060650429012,1040,121,203,92,75,54,128,82,837,124,317,109,520,135,13455
15000US060650429021,682,91,85,58,27,28,58,50,597,91,247,78,350,87,13456
15000US060650429022,545,97,172,72,33,41,139,62,373,85,157,64,216,75,13457
15000US060650429031,697,122,99,60,5,10,94,60,598,122,180,81,418,118,13458
15000US060650429032,728,100,185,71,90,55,95,49,543,112,164,63,379,114,13459
15000US060650429041,724,158,93,111,49,57,44,74,631,160,179,86,452,158,13460
15000US060650429042,1093,173,253,139,161,114,92,72,840,181,186,117,654,187,13461
15000US060650429043,373,156,107,83,38,31,69,78,266,134,111,113,155,94,13462
15000US060650430011,971,120,207,63,81,49,126,68,764,125,271,93,493,130,13463
15000US060650430012,544,107,143,78,45,40,98,62,401,97,98,56,303,101,13464
15000US060650430031,622,107,136,71,44,40,92,63,486,110,136,62,350,101,13465
15000US060650430032,699,95,201,84,60,41,141,77,498,99,170,59,328,97,13466
15000US060650430033,492,95,163,65,60,46,103,60,329,83,80,47,249,82,13467
15000US060650430051,687,115,110,75,44,32,66,63,577,118,179,80,398,118,13468
15000US060650430052,419,89,71,56,30,38,41,47,348,95,68,48,280,84,13469
15000US060650430053,405,99,118,74,59,56,59,55,287,91,100,47,187,87,13470
15000US060650430061,660,90,197,75,125,61,72,57,463,81,158,79,305,78,13471
15000US060650430062,739,85,92,54,52,46,40,39,647,94,227,71,420,87,13472
15000US060650430071,1410,134,24,26,12,19,12,16,1386,133,264,93,1122,138,13473
15000US060650430072,693,125,14,17,7,12,7,12,679,128,40,33,639,128,13474
15000US060650430081,888,92,108,65,10,16,98,63,780,104,264,106,516,105,13475
15000US060650430082,899,94,53,34,33,31,20,23,846,101,208,79,638,104,13476
15000US060650430091,874,80,36,26,21,21,15,17,838,84,232,68,606,102,13477
15000US060650430092,583,78,15,20,0,12,15,20,568,80,151,65,417,90,13478
15000US060650430101,905,92,129,57,56,52,73,53,776,104,111,46,665,101,13479
15000US060650430102,652,92,24,21,16,16,8,13,628,90,162,64,466,101,13480
15000US060650432061,520,121,77,55,17,28,60,45,443,114,21,27,422,121,13481
15000US060650432062,174,74,0,12,0,12,0,12,174,74,14,22,160,76,13482
15000US060650432063,973,161,47,67,1,16,46,69,926,154,267,100,659,178,13483
15000US060650432064,982,186,121,91,17,27,104,85,861,193,264,148,597,179,13484
15000US060650432111,255,65,20,32,0,12,20,32,235,63,48,28,187,64,13485
15000US060650432112,346,74,9,14,9,14,0,12,337,75,50,29,287,80,13486
15000US060650432113,541,76,38,30,12,18,26,25,503,79,121,78,382,80,13487
15000US060650432114,474,81,38,30,23,19,15,22,436,86,78,52,358,77,13488
15000US060650432161,748,174,40,40,22,39,18,29,708,173,80,67,628,170,13489
15000US060650432162,659,138,168,105,23,37,145,104,491,134,151,85,340,123,13490
15000US060650432163,827,148,35,41,0,12,35,41,792,152,152,74,640,162,13491
15000US060650432171,1006,54,80,58,23,24,57,53,926,77,271,79,655,93,13492
15000US060650432181,537,89,38,43,0,12,38,43,499,90,118,71,381,84,13493
15000US060650432182,566,103,36,40,25,37,11,17,530,104,143,63,387,101,13494
15000US060650432183,512,90,8,14,8,14,0,12,504,88,102,57,402,84,13495
15000US060650432201,942,115,94,64,8,14,86,63,848,116,81,61,767,125,13496
15000US060650432202,673,95,51,40,8,12,43,34,622,101,138,55,484,98,13497
15000US060650432221,612,83,11,17,0,12,11,17,601,86,117,44,484,86,13498
15000US060650432222,721,99,24,36,24,36,0,12,697,96,122,53,575,100,13499
15000US060650432271,305,81,14,24,0,12,14,24,291,84,24,27,267,76,13500
15000US060650432272,552,124,0,12,0,12,0,12,552,124,92,83,460,134,13501
15000US060650432273,1160,127,149,90,28,33,121,86,1011,136,179,115,832,144,13502
15000US060650432281,715,106,139,85,6,10,133,84,576,102,49,43,527,106,13503
15000US060650432282,689,97,26,27,0,12,26,27,663,106,144,70,519,84,13504
15000US060650432291,713,87,70,66,12,20,58,63,643,91,267,80,376,109,13505
15000US060650432292,636,95,21,33,21,33,0,12,615,89,101,53,514,94,13506
15000US060650432293,953,93,23,27,13,22,10,15,930,100,367,95,563,113,13507
15000US060650432351,341,76,23,27,12,19,11,19,318,77,50,41,268,82,13508
15000US060650432352,1005,95,58,40,58,40,0,12,947,101,311,94,636,121,13509
15000US060650432391,914,170,80,88,51,81,29,34,834,158,209,102,625,153,13510
15000US060650432392,856,172,0,12,0,12,0,12,856,172,205,87,651,174,13511
15000US060650432393,617,159,60,49,30,32,30,36,557,169,225,132,332,141,13512
15000US060650432401,1531,176,36,41,0,12,36,41,1495,174,185,100,1310,182,13513
15000US060650432402,1343,140,135,97,99,89,36,48,1208,144,231,95,977,158,13514
15000US060650432421,1366,144,45,42,32,34,13,23,1321,144,344,97,977,165,13515
15000US060650432422,1231,157,56,67,18,32,38,59,1175,168,210,107,965,173,13516
15000US060650432441,694,110,50,53,8,17,42,49,644,125,213,86,431,121,13517
15000US060650432442,776,129,13,22,13,22,0,12,763,129,94,58,669,126,13518
15000US060650432443,1102,140,12,20,0,12,12,20,1090,136,256,94,834,146,13519
15000US060650432461,338,87,18,21,10,15,8,14,320,85,103,49,217,78,13520
15000US060650432462,1329,92,67,55,29,40,38,41,1262,110,203,78,1059,131,13521
15000US060650432471,878,154,13,22,0,12,13,22,865,155,143,77,722,151,13522
15000US060650432472,1588,161,139,96,102,93,37,35,1449,180,156,77,1293,198,13523
15000US060650432481,1351,73,40,35,10,15,30,34,1311,87,279,84,1032,112,13524
15000US060650432501,221,90,0,12,0,12,0,12,221,90,11,17,210,91,13525
15000US060650432502,255,69,8,15,8,15,0,12,247,73,39,36,208,80,13526
15000US060650432503,618,127,0,12,0,12,0,12,618,127,73,52,545,135,13527
15000US060650432504,440,111,24,40,0,12,24,40,416,109,123,60,293,106,13528
15000US060650432505,1104,166,25,31,11,19,14,24,1079,169,141,74,938,176,13529
15000US060650432521,1452,159,52,48,41,45,11,17,1400,160,237,95,1163,168,13530
15000US060650432522,737,130,11,20,0,12,11,20,726,134,142,87,584,120,13531
15000US060650432541,421,95,55,53,20,22,35,48,366,96,98,53,268,93,13532
15000US060650432542,366,71,24,26,24,26,0,12,342,70,61,40,281,76,13533
15000US060650432543,795,100,72,49,21,26,51,38,723,103,218,85,505,98,13534
15000US060650432561,237,59,30,25,0,12,30,25,207,63,33,32,174,62,13535
15000US060650432562,455,77,10,16,0,12,10,16,445,80,75,50,370,86,13536
15000US060650432563,320,70,0,12,0,12,0,12,320,70,56,34,264,73,13537
15000US060650432571,753,141,33,36,0,12,33,36,720,147,62,51,658,149,13538
15000US060650432572,1416,176,16,25,0,17,16,25,1400,183,303,141,1097,199,13539
15000US060650432573,348,130,2,3,2,3,0,12,346,129,105,106,241,139,13540
15000US060650432621,1006,102,5,8,0,12,5,8,1001,104,318,86,683,110,13541
15000US060650432622,593,69,0,12,0,12,0,12,593,69,145,59,448,70,13542
15000US060650432641,767,141,11,17,0,12,11,17,756,144,113,67,643,133,13543
15000US060650432642,440,90,10,16,0,12,10,16,430,93,62,43,368,97,13544
15000US060650432643,1117,150,71,59,15,24,56,54,1046,155,180,89,866,165,13545
15000US060650432651,823,103,13,17,0,12,13,17,810,102,209,81,601,106,13546
15000US060650432652,722,109,4,8,0,12,4,8,718,109,106,56,612,115,13547
15000US060650432653,389,74,30,46,0,12,30,46,359,71,88,45,271,69,13548
15000US060650432661,228,67,0,12,0,12,0,12,228,67,59,44,169,67,13549
15000US060650432662,1489,128,153,63,68,52,85,50,1336,126,186,74,1150,134,13550
15000US060650432671,887,136,15,22,15,22,0,12,872,136,144,69,728,140,13551
15000US060650432672,1384,153,39,43,0,12,39,43,1345,153,249,104,1096,171,13552
15000US060650432701,191,73,16,24,16,24,0,12,175,72,35,29,140,76,13553
15000US060650432702,1331,112,65,45,27,26,38,37,1266,113,497,97,769,110,13554
15000US060650432711,1058,65,113,62,38,34,75,56,945,86,228,72,717,95,13555
15000US060650432721,559,99,0,12,0,12,0,12,559,99,152,79,407,95,13556
15000US060650432722,1200,129,19,20,0,12,19,20,1181,130,361,141,820,140,13557
15000US060650432741,697,67,76,36,29,23,47,30,621,77,86,34,535,78,13558
15000US060650432761,1099,55,33,32,33,32,0,12,1066,60,232,75,834,91,13559
15000US060650432781,295,86,48,68,0,12,48,68,247,62,36,27,211,57,13560
15000US060650432782,427,83,0,12,0,12,0,12,427,83,75,43,352,80,13561
15000US060650432783,396,76,7,11,0,12,7,11,389,76,75,50,314,71,13562
15000US060650432784,762,111,45,39,45,39,0,12,717,118,184,81,533,109,13563
15000US060650432791,858,98,57,33,27,22,30,24,801,103,279,60,522,106,13564
15000US060650432792,442,99,8,12,8,12,0,12,434,99,104,51,330,106,13565
15000US060650432793,255,65,24,25,7,13,17,21,231,65,35,29,196,65,13566
15000US060650432911,600,132,0,12,0,12,0,12,600,132,127,64,473,114,13567
15000US060650432912,824,143,0,12,0,12,0,12,824,143,421,129,403,125,13568
15000US060650432913,628,170,33,35,0,12,33,35,595,178,93,52,502,167,13569
15000US060650432914,278,87,27,43,0,12,27,43,251,96,72,57,179,90,13570
15000US060650432915,724,125,16,26,16,26,0,12,708,122,152,75,556,128,13571
15000US060650433041,569,113,22,28,14,23,8,17,547,113,317,112,230,94,13572
15000US060650433042,338,100,67,53,29,45,38,45,271,99,76,45,195,101,13573
15000US060650433043,1144,161,45,43,30,35,15,24,1099,169,251,113,848,174,13574
15000US060650433044,500,94,91,65,75,57,16,30,409,90,149,77,260,97,13575
15000US060650433061,840,106,107,54,15,17,92,51,733,103,302,97,431,102,13576
15000US060650433062,776,108,93,55,44,44,49,46,683,118,239,85,444,115,13577
15000US060650433071,1003,123,187,95,53,55,134,93,816,137,424,113,392,140,13578
15000US060650433072,1104,149,367,141,208,118,159,101,737,142,265,106,472,131,13579
15000US060650433073,418,115,89,73,40,42,49,61,329,105,92,54,237,109,13580
15000US060650433081,375,58,27,25,4,7,23,24,348,59,109,41,239,53,13581
15000US060650433082,619,67,206,58,104,39,102,45,413,70,153,49,260,68,13582
15000US060650433091,505,87,165,73,63,41,102,69,340,71,208,60,132,52,13583
15000US060650433092,444,68,94,47,30,18,64,45,350,68,112,41,238,65,13584
15000US060650433101,483,85,212,82,131,71,81,63,271,75,132,65,139,58,13585
15000US060650433102,551,94,157,75,124,69,33,32,394,93,129,54,265,88,13586
15000US060650433111,304,48,68,48,23,18,45,42,236,55,86,43,150,41,13587
15000US060650433112,366,49,42,25,25,22,17,14,324,52,86,45,238,57,13588
15000US060650433121,654,105,140,70,77,59,63,40,514,103,159,60,355,94,13589
15000US060650433122,555,97,88,63,60,54,28,33,467,107,176,91,291,81,13590
15000US060650433131,533,75,177,65,83,44,94,50,356,75,123,49,233,65,13591
15000US060650433132,480,57,110,54,37,25,73,47,370,57,145,45,225,49,13592
15000US060650433141,463,67,16,18,10,15,6,10,447,71,198,73,249,85,13593
15000US060650433142,611,110,60,47,39,33,21,31,551,112,151,77,400,101,13594
15000US060650433151,684,45,127,55,72,43,55,32,557,76,236,65,321,73,13595
15000US060650433161,394,71,0,12,0,12,0,12,394,71,233,58,161,69,13596
15000US060650433162,1199,94,133,75,62,63,71,52,1066,105,376,80,690,116,13597
15000US060650433171,784,148,207,138,0,12,207,138,577,166,173,90,404,160,13598
15000US060650433172,1118,178,118,84,15,26,103,76,1000,179,364,117,636,163,13599
15000US060650433173,468,111,27,31,16,26,11,21,441,113,121,58,320,111,13600
15000US060650434011,628,122,229,98,114,72,115,63,399,115,158,79,241,102,13601
15000US060650434012,475,90,143,72,63,56,80,52,332,88,113,57,219,73,13602
15000US060650434013,748,130,331,99,184,100,147,71,417,84,233,76,184,83,13603
15000US060650434031,354,67,91,44,43,27,48,32,263,63,139,48,124,52,13604
15000US060650434032,438,68,152,58,75,44,77,48,286,65,146,54,140,53,13605
15000US060650434041,763,85,0,12,0,12,0,12,763,85,424,87,339,94,13606
15000US060650434042,606,89,158,75,84,55,74,50,448,97,142,70,306,76,13607
15000US060650434051,418,85,128,67,108,57,20,33,290,77,128,63,162,64,13608
15000US060650434052,598,102,180,68,71,46,109,62,418,97,291,88,127,52,13609
15000US060650434053,869,121,226,97,112,69,114,73,643,105,303,96,340,85,13610
15000US060650435031,726,154,149,107,36,48,113,112,577,135,258,105,319,110,13611
15000US060650435032,945,186,184,153,108,108,76,63,761,146,300,111,461,128,13612
15000US060650435041,1100,200,165,106,73,66,92,73,935,205,344,150,591,184,13613
15000US060650435042,1362,222,48,46,37,41,11,19,1314,230,734,164,580,185,13614
15000US060650435051,690,95,41,33,27,27,14,18,649,100,356,90,293,99,13615
15000US060650435052,884,93,88,58,77,55,11,17,796,95,460,90,336,78,13616
15000US060650435061,765,154,42,47,31,41,11,20,723,158,340,124,383,98,13617
15000US060650435062,647,148,41,40,16,26,25,32,606,146,120,90,486,143,13618
15000US060650435063,612,134,73,64,58,63,15,31,539,129,235,95,304,123,13619
15000US060650435071,831,180,203,119,128,72,75,96,628,173,262,105,366,159,13620
15000US060650435072,761,170,205,116,110,85,95,83,556,149,284,125,272,107,13621
15000US060650435073,738,182,380,136,118,85,262,118,358,123,146,82,212,106,13622
15000US060650435081,1146,151,48,44,32,38,16,24,1098,159,311,109,787,156,13623
15000US060650435082,488,141,140,96,57,52,83,84,348,144,180,92,168,117,13624
15000US060650435083,763,179,109,92,22,26,87,90,654,170,154,106,500,145,13625
15000US060650435091,905,81,150,64,42,31,108,61,755,100,187,76,568,94,13626
15000US060650435092,780,84,42,31,16,20,26,24,738,91,356,94,382,91,13627
15000US060650435121,1152,126,168,86,48,41,120,83,984,134,453,106,531,125,13628
15000US060650435122,827,114,105,60,44,43,61,39,722,124,171,66,551,116,13629
15000US060650435131,883,71,112,57,66,42,46,40,771,77,273,76,498,76,13630
15000US060650435171,1201,110,109,72,12,19,97,68,1092,116,335,111,757,152,13631
15000US060650435172,579,112,102,54,61,42,41,35,477,120,113,73,364,105,13632
15000US060650436011,463,107,83,55,36,32,47,47,380,98,172,67,208,88,13633
15000US060650436012,761,113,300,90,162,70,138,83,461,112,146,72,315,103,13634
15000US060650436021,433,99,148,69,79,49,69,56,285,93,111,76,174,83,13635
15000US060650436022,603,102,200,79,56,54,144,68,403,95,168,68,235,83,13636
15000US060650437011,634,107,83,59,37,34,46,47,551,101,224,84,327,88,13637
15000US060650437012,894,110,214,86,94,57,120,68,680,118,206,78,474,111,13638
15000US060650437021,942,95,133,56,71,44,62,42,809,103,292,77,517,108,13639
15000US060650437022,742,110,122,77,40,50,82,57,620,108,258,97,362,77,13640
15000US060650437031,642,64,147,56,95,49,52,31,495,58,186,46,309,65,13641
15000US060650437032,299,67,59,44,42,35,17,26,240,56,90,41,150,44,13642
15000US060650438021,954,138,29,34,0,12,29,34,925,139,237,86,688,133,13643
15000US060650438022,257,61,43,43,34,42,9,13,214,53,71,41,143,56,13644
15000US060650438023,768,94,56,33,36,25,20,23,712,90,238,69,474,95,13645
15000US060650438071,1333,108,212,88,74,64,138,69,1121,131,237,91,884,152,13646
15000US060650438072,601,115,159,92,77,65,82,70,442,95,81,43,361,90,13647
15000US060650438091,245,69,8,12,8,12,0,12,237,67,83,61,154,57,13648
15000US060650438092,1130,103,48,47,35,44,13,16,1082,113,380,97,702,133,13649
15000US060650438101,477,69,0,12,0,12,0,12,477,69,154,66,323,77,13650
15000US060650438102,602,105,61,45,52,41,9,16,541,108,241,102,300,90,13651
15000US060650438103,892,113,40,34,15,21,25,28,852,112,283,88,569,111,13652
15000US060650438111,1023,118,44,30,26,25,18,20,979,123,334,99,645,110,13653
15000US060650438112,508,107,29,29,14,21,15,18,479,109,188,80,291,104,13654
15000US060650438121,2095,144,0,12,0,12,0,12,2095,144,875,170,1220,156,13655
15000US060650438122,1381,170,61,84,61,84,0,12,1320,173,681,166,639,135,13656
15000US060650438131,301,88,45,56,10,15,35,54,256,91,21,21,235,87,13657
15000US060650438132,648,114,94,74,33,28,61,68,554,133,125,80,429,125,13658
15000US060650438133,452,135,124,90,89,71,35,54,328,114,41,30,287,111,13659
15000US060650438134,233,60,11,10,3,5,8,8,222,59,86,23,136,55,13660
15000US060650438141,533,54,6,9,0,12,6,9,527,55,227,48,300,55,13661
15000US060650438181,1186,76,71,48,14,18,57,48,1115,76,223,69,892,88,13662
15000US060650438201,1552,109,60,42,0,12,60,42,1492,121,479,124,1013,117,13663
15000US060650438211,1061,55,137,51,21,20,116,50,924,74,151,60,773,91,13664
15000US060650438221,877,48,85,47,26,23,59,42,792,58,180,55,612,76,13665
15000US060650438231,2250,153,110,83,67,60,43,64,2140,152,399,161,1741,175,13666
15000US060650438232,187,69,0,12,0,12,0,12,187,69,107,62,80,60,13667
15000US060650439001,671,93,148,73,26,21,122,72,523,90,206,65,317,82,13668
15000US060650439002,434,105,45,32,21,22,24,22,389,102,58,37,331,96,13669
15000US060650439003,810,120,74,66,33,44,41,43,736,121,151,72,585,118,13670
15000US060650440001,457,56,160,39,46,28,114,37,297,57,68,35,229,51,13671
15000US060650440002,40,21,4,6,0,12,4,6,36,22,6,10,30,21,13672
15000US060650441011,660,74,165,57,93,44,72,40,495,83,164,64,331,75,13673
15000US060650441012,294,54,115,56,5,8,110,56,179,57,5,8,174,55,13674
15000US060650441021,924,60,241,79,117,58,124,56,683,85,241,55,442,89,13675
15000US060650441031,988,155,165,142,58,76,107,123,823,146,249,108,574,155,13676
15000US060650441032,1234,151,130,81,101,64,29,35,1104,141,453,113,651,148,13677
15000US060650441041,930,50,153,53,65,36,88,44,777,74,218,63,559,74,13678
15000US060650442001,1002,119,229,95,54,45,175,87,773,127,211,83,562,124,13679
15000US060650442002,579,117,279,81,96,48,183,75,300,110,128,76,172,79,13680
15000US060650443001,388,100,33,30,33,30,0,12,355,99,126,70,229,82,13681
15000US060650443002,909,101,150,86,21,23,129,83,759,106,189,64,570,114,13682
15000US060650444021,674,158,44,43,13,21,31,37,630,156,146,72,484,163,13683
15000US060650444022,218,109,15,25,0,12,15,25,203,105,29,34,174,104,13684
15000US060650444023,490,161,32,36,16,26,16,26,458,161,204,86,254,149,13685
15000US060650444024,430,133,15,27,15,27,0,12,415,135,164,106,251,119,13686
15000US060650444031,288,102,9,16,0,12,9,16,279,103,15,18,264,102,13687
15000US060650444032,311,88,32,44,0,12,32,44,279,78,103,58,176,60,13688
15000US060650444033,762,123,101,71,62,62,39,28,661,118,236,92,425,121,13689
15000US060650444041,581,85,45,29,31,25,14,17,536,83,105,50,431,83,13690
15000US060650444051,403,95,17,27,0,12,17,27,386,95,84,48,302,88,13691
15000US060650444052,380,131,0,12,0,12,0,12,380,131,52,44,328,131,13692
15000US060650445051,1219,173,234,153,75,79,159,116,985,244,372,163,613,207,13693
15000US060650445052,1029,212,64,48,16,26,48,44,965,210,465,122,500,155,13694
15000US060650445071,977,176,158,98,88,72,70,69,819,163,326,127,493,139,13695
15000US060650445072,1153,183,194,101,41,42,153,94,959,164,234,125,725,184,13696
15000US060650445091,1468,148,422,137,157,63,265,128,1046,160,254,85,792,146,13697
15000US060650445101,1117,171,196,88,77,59,119,75,921,171,195,63,726,164,13698
15000US060650445102,739,163,132,61,57,39,75,50,607,162,255,104,352,116,13699
15000US060650445151,1267,101,137,80,74,69,63,54,1130,117,250,80,880,140,13700
15000US060650445161,838,204,153,121,66,84,87,88,685,203,221,138,464,184,13701
15000US060650445162,1170,213,174,130,33,42,141,123,996,213,309,165,687,174,13702
15000US060650445171,1047,116,74,59,0,12,74,59,973,114,245,73,728,109,13703
15000US060650445181,612,116,99,67,63,52,36,43,513,115,137,58,376,100,13704
15000US060650445182,1260,132,285,86,97,59,188,63,975,138,289,93,686,125,13705
15000US060650445201,426,79,14,23,0,12,14,23,412,75,176,54,236,72,13706
15000US060650445202,282,51,58,40,12,13,46,39,224,47,62,34,162,41,13707
15000US060650445211,404,72,101,50,64,44,37,32,303,70,99,39,204,71,13708
15000US060650445221,1734,198,78,52,26,23,52,47,1656,199,635,149,1021,179,13709
15000US060650446021,563,101,75,65,27,36,48,51,488,95,129,71,359,106,13710
15000US060650446022,384,99,19,18,19,18,0,12,365,98,73,39,292,98,13711
15000US060650446023,616,109,44,50,44,50,0,12,572,110,186,69,386,108,13712
15000US060650446041,1008,127,68,55,21,25,47,48,940,132,277,78,663,143,13713
15000US060650446042,951,115,56,41,56,41,0,12,895,124,244,108,651,140,13714
15000US060650446051,857,99,151,84,47,42,104,66,706,105,178,97,528,103,13715
15000US060650446052,1202,144,228,99,64,55,164,80,974,151,133,59,841,146,13716
15000US060650446061,582,116,40,44,7,11,33,43,542,107,56,35,486,109,13717
15000US060650446062,652,125,93,53,37,36,56,40,559,126,145,67,414,114,13718
15000US060650447011,912,112,96,68,64,42,32,52,816,111,274,87,542,112,13719
15000US060650447012,762,142,63,58,53,55,10,15,699,143,208,97,491,117,13720
15000US060650447021,532,65,51,28,19,17,32,25,481,67,173,55,308,66,13721
15000US060650448041,1053,55,112,54,58,36,54,38,941,70,238,57,703,80,13722
15000US060650448051,933,115,38,28,30,25,8,12,895,117,153,57,742,133,13723
15000US060650448061,1404,128,98,81,91,82,7,12,1306,134,345,102,961,128,13724
15000US060650448071,836,77,80,52,27,21,53,47,756,83,231,76,525,94,13725
15000US060650449041,1663,100,140,61,103,56,37,24,1523,121,415,93,1108,150,13726
15000US060650449071,529,95,151,91,22,35,129,74,378,95,78,43,300,95,13727
15000US060650449072,327,89,70,54,32,41,38,37,257,79,47,28,210,81,13728
15000US060650449073,524,102,125,78,9,13,116,77,399,95,54,53,345,100,13729
15000US060650449111,1445,192,101,95,49,44,52,80,1344,189,399,114,945,197,13730
15000US060650449112,793,185,43,42,13,19,30,36,750,188,164,91,586,172,13731
15000US060650449151,927,99,124,61,29,29,95,55,803,99,51,35,752,101,13732
15000US060650449152,964,94,135,60,45,40,90,48,829,105,408,89,421,94,13733
15000US060650449161,820,121,20,22,0,12,20,22,800,123,83,45,717,127,13734
15000US060650449162,523,107,42,31,16,19,26,24,481,106,152,59,329,95,13735
15000US060650449163,734,107,160,73,37,29,123,72,574,117,128,69,446,118,13736
15000US060650449171,1291,187,47,56,0,12,47,56,1244,195,239,116,1005,212,13737
15000US060650449172,1222,211,0,12,0,12,0,12,1222,211,413,156,809,196,13738
15000US060650449181,996,140,0,12,0,12,0,12,996,140,316,81,680,106,13739
15000US060650449182,670,118,0,12,0,12,0,12,670,118,165,70,505,107,13740
15000US060650449191,685,134,19,30,19,30,0,12,666,138,299,110,367,114,13741
15000US060650449192,499,138,0,12,0,12,0,12,499,138,160,77,339,112,13742
15000US060650449193,1164,173,15,25,0,12,15,25,1149,172,386,127,763,187,13743
15000US060650449194,69,43,11,17,11,17,0,12,58,41,0,12,58,41,13744
15000US060650449211,1052,128,49,31,19,29,30,26,1003,137,284,86,719,139,13745
15000US060650449221,2406,187,31,52,31,52,0,12,2375,192,463,113,1912,201,13746
15000US060650449231,643,102,108,63,48,46,60,50,535,107,122,65,413,94,13747
15000US060650449232,513,85,37,54,0,12,37,54,476,84,130,49,346,84,13748
15000US060650449241,687,112,79,56,70,54,9,15,608,115,111,63,497,110,13749
15000US060650449242,556,114,78,58,16,21,62,55,478,103,164,77,314,108,13750
15000US060650449251,306,64,19,17,4,7,15,15,287,62,59,29,228,61,13751
15000US060650449252,686,63,45,26,19,17,26,19,641,67,172,59,469,68,13752
15000US060650449261,943,89,103,61,22,25,81,57,840,94,235,77,605,107,13753
15000US060650449262,433,95,42,27,18,19,24,22,391,93,158,67,233,81,13754
15000US060650449271,1378,159,115,67,66,52,49,41,1263,173,281,80,982,163,13755
15000US060650449272,392,93,0,12,0,12,0,12,392,93,133,53,259,76,13756
15000US060650449281,568,112,7,11,0,12,7,11,561,111,121,61,440,111,13757
15000US060650449282,1068,145,16,17,0,12,16,17,1052,146,273,93,779,124,13758
15000US060650449291,886,137,0,12,0,12,0,12,886,137,156,104,730,136,13759
15000US060650449292,1588,167,51,50,33,39,18,29,1537,171,255,128,1282,211,13760
15000US060650449301,1357,145,162,118,11,19,151,119,1195,145,290,97,905,143,13761
15000US060650449311,662,41,108,61,40,42,68,38,554,76,165,55,389,73,13762
15000US060650449321,1166,46,43,37,25,29,18,22,1123,64,241,68,882,88,13763
15000US060650450001,464,122,38,50,9,15,29,48,426,117,95,60,331,109,13764
15000US060650450002,561,102,9,14,9,14,0,12,552,101,120,51,432,104,13765
15000US060650450003,560,128,67,58,0,12,67,58,493,123,84,50,409,118,13766
15000US060650451031,461,108,75,52,10,16,65,51,386,100,105,52,281,93,13767
15000US060650451032,531,107,0,12,0,12,0,12,531,107,126,58,405,113,13768
15000US060650451033,434,105,0,12,0,12,0,12,434,105,44,35,390,102,13769
15000US060650451034,474,96,32,32,7,14,25,29,442,101,166,79,276,89,13770
15000US060650451081,691,179,34,39,14,23,20,31,657,179,176,98,481,171,13771
15000US060650451082,865,161,40,48,22,37,18,29,825,159,225,121,600,155,13772
15000US060650451083,828,192,158,123,97,97,61,79,670,174,210,115,460,147,13773
15000US060650451091,641,82,60,46,48,41,12,20,581,92,190,72,391,92,13774
15000US060650451092,682,107,47,26,37,26,10,15,635,109,95,48,540,105,13775
15000US060650451101,1232,133,69,51,49,44,20,24,1163,126,267,83,896,134,13776
15000US060650451102,511,101,19,17,6,9,13,14,492,102,133,57,359,98,13777
15000US060650451141,504,78,9,14,0,12,9,14,495,77,148,72,347,91,13778
15000US060650451142,574,103,0,12,0,12,0,12,574,103,54,34,520,107,13779
15000US060650451151,853,92,5,7,0,12,5,7,848,91,258,53,590,100,13780
15000US060650451161,777,81,35,30,6,9,29,29,742,87,193,59,549,90,13781
15000US060650451171,807,141,14,21,14,21,0,12,793,143,233,92,560,139,13782
15000US060650451172,1172,186,106,70,23,25,83,67,1066,186,202,87,864,192,13783
15000US060650451181,1248,123,94,66,29,27,65,65,1154,128,354,119,800,127,13784
15000US060650451191,678,114,30,36,0,12,30,36,648,120,111,49,537,125,13785
15000US060650451192,359,76,25,27,16,24,9,14,334,79,121,71,213,71,13786
15000US060650451201,163,58,0,12,0,12,0,12,163,58,30,22,133,52,13787
15000US060650451202,697,105,103,72,78,69,25,23,594,104,162,56,432,102,13788
15000US060650451203,787,121,86,54,9,14,77,52,701,134,253,104,448,118,13789
15000US060650451211,1030,167,173,103,59,49,114,99,857,185,319,123,538,146,13790
15000US060650451212,746,152,15,24,0,12,15,24,731,148,164,96,567,121,13791
15000US060650451213,1078,186,0,12,0,12,0,12,1078,186,167,97,911,169,13792
15000US060650451221,846,97,37,33,18,16,19,29,809,95,250,60,559,85,13793
15000US060650451231,407,89,0,12,0,12,0,12,407,89,100,49,307,84,13794
15000US060650451232,575,93,10,14,6,10,4,9,565,93,174,66,391,90,13795
15000US060650451241,691,88,37,34,31,33,6,9,654,86,119,46,535,81,13796
15000US060650451251,1384,168,6,11,6,11,0,12,1378,168,327,109,1051,147,13797
15000US060650452071,794,102,243,80,55,44,188,74,551,103,80,56,471,104,13798
15000US060650452072,922,102,109,54,16,19,93,52,813,102,177,58,636,108,13799
15000US060650452091,705,96,96,58,7,11,89,58,609,99,133,58,476,103,13800
15000US060650452092,1043,113,241,80,84,51,157,79,802,124,247,86,555,108,13801
15000US060650452121,589,88,30,30,10,21,20,21,559,89,189,59,370,89,13802
15000US060650452122,453,61,0,12,0,12,0,12,453,61,183,63,270,66,13803
15000US060650452131,1432,126,230,92,32,29,198,88,1202,143,262,95,940,151,13804
15000US060650452132,312,93,0,12,0,12,0,12,312,93,36,30,276,89,13805
15000US060650452141,1004,152,0,12,0,12,0,12,1004,152,194,100,810,148,13806
15000US060650452142,1239,177,0,12,0,12,0,12,1239,177,237,128,1002,189,13807
15000US060650452151,949,163,117,104,24,37,93,98,832,170,56,54,776,164,13808
15000US060650452152,140,75,12,19,0,12,12,19,128,75,27,46,101,62,13809
15000US060650452153,1126,160,43,66,0,12,43,66,1083,155,148,102,935,182,13810
15000US060650452154,867,159,55,66,38,60,17,27,812,164,114,74,698,166,13811
15000US060650452161,998,95,11,12,6,10,5,7,987,92,277,60,710,91,13812
15000US060650452171,1140,96,111,76,44,47,67,62,1029,99,232,79,797,108,13813
15000US060650452172,940,115,106,80,10,15,96,79,834,142,157,78,677,141,13814
15000US060650452221,44,31,0,12,0,12,0,12,44,31,29,26,15,16,13815
15000US060650452222,445,88,9,14,9,14,0,12,436,87,101,41,335,83,13816
15000US060650452223,326,75,7,11,0,12,7,11,319,75,38,25,281,75,13817
15000US060650452241,885,144,80,67,0,12,80,67,805,138,159,71,646,157,13818
15000US060650452242,987,150,14,16,0,12,14,16,973,152,251,99,722,155,13819
15000US060650452261,1095,157,13,20,0,12,13,20,1082,152,111,58,971,161,13820
15000US060650452262,763,131,121,84,72,60,49,57,642,129,28,27,614,129,13821
15000US060650452281,839,139,40,35,0,12,40,35,799,136,171,76,628,132,13822
15000US060650452282,977,136,11,18,11,18,0,12,966,139,138,65,828,160,13823
15000US060650452331,1323,123,119,89,18,27,101,86,1204,148,272,90,932,154,13824
15000US060650452332,375,87,14,17,7,12,7,11,361,86,14,16,347,86,13825
15000US060650453021,666,91,24,18,14,16,10,16,642,94,288,105,354,112,13826
15000US060650453022,172,52,25,28,10,17,15,23,147,53,72,47,75,36,13827
15000US060650453023,315,83,78,52,37,36,41,40,237,80,50,37,187,74,13828
15000US060650453031,834,48,245,79,47,39,198,70,589,83,156,54,433,85,13829
15000US060650453041,707,152,0,12,0,12,0,12,707,152,172,87,535,155,13830
15000US060650453042,1365,202,100,84,62,75,38,38,1265,203,226,112,1039,190,13831
15000US060650453043,831,180,45,63,45,63,0,12,786,175,166,122,620,154,13832
15000US060650455011,675,113,133,71,82,60,51,42,542,121,104,73,438,112,13833
15000US060650455012,864,111,157,86,49,49,108,76,707,107,242,80,465,106,13834
15000US060650455021,509,105,156,84,84,57,72,64,353,103,62,36,291,103,13835
15000US060650455022,668,95,101,52,28,36,73,44,567,94,263,86,304,92,13836
15000US060650456041,650,168,154,93,56,55,98,81,496,149,156,86,340,137,13837
15000US060650456042,556,114,131,95,18,29,113,90,425,126,213,106,212,112,13838
15000US060650456043,1159,171,230,110,39,36,191,108,929,177,188,103,741,160,13839
15000US060650456044,978,138,317,114,120,72,197,100,661,141,215,104,446,152,13840
15000US060650456051,733,134,178,91,18,23,160,88,555,139,125,83,430,132,13841
15000US060650456052,212,32,72,19,14,10,58,20,140,30,20,12,120,29,13842
15000US060650456053,256,43,92,27,20,12,72,23,164,34,38,15,126,29,13843
15000US060650456054,1019,147,66,59,37,41,29,44,953,142,188,79,765,141,13844
15000US060650456055,332,87,41,17,3,4,38,18,291,89,40,26,251,90,13845
15000US060650456061,239,68,9,13,0,12,9,13,230,69,154,58,76,38,13846
15000US060650456062,880,135,25,21,18,20,7,11,855,134,177,85,678,136,13847
15000US060650456081,550,98,0,12,0,12,0,12,550,98,114,53,436,97,13848
15000US060650456082,929,140,9,13,9,13,0,12,920,138,157,51,763,130,13849
15000US060650456091,663,116,108,70,35,35,73,64,555,123,184,108,371,121,13850
15000US060650456092,343,122,54,46,18,21,36,41,289,119,52,54,237,102,13851
15000US060650456093,422,116,87,75,26,43,61,59,335,109,64,57,271,121,13852
15000US060650457031,860,116,168,86,52,38,116,76,692,105,191,74,501,122,13853
15000US060650457032,800,117,111,75,9,22,102,77,689,128,116,71,573,126,13854
15000US060650457041,804,60,159,62,53,37,106,53,645,79,215,65,430,77,13855
15000US060650457051,2358,98,877,151,225,96,652,144,1481,177,247,103,1234,176,13856
15000US060650457061,894,102,253,89,70,50,183,76,641,118,161,72,480,120,13857
15000US060650457062,317,99,83,63,46,47,37,42,234,82,68,50,166,80,13858
15000US060650457071,450,86,129,69,67,53,62,49,321,98,126,62,195,84,13859
15000US060650457072,565,91,51,47,11,17,40,43,514,98,48,31,466,102,13860
15000US060650457073,771,96,131,59,62,46,69,41,640,103,232,87,408,100,13861
15000US060650459001,271,45,27,19,10,11,17,15,244,43,110,40,134,41,13862
15000US060650459002,249,66,54,35,29,29,25,20,195,60,78,44,117,53,13863
15000US060650461011,528,109,36,43,0,12,36,43,492,110,101,59,391,119,13864
15000US060650461012,776,120,173,99,75,57,98,84,603,121,152,87,451,119,13865
15000US060650461021,717,87,233,64,86,52,147,61,484,89,153,54,331,84,13866
15000US060650461031,633,78,41,39,30,35,11,19,592,81,136,57,456,88,13867
15000US060650461032,496,84,8,12,0,12,8,12,488,83,138,58,350,70,13868
15000US060650462001,566,125,157,92,77,64,80,59,409,116,132,73,277,103,13869
15000US060650462002,653,119,194,104,130,91,64,60,459,131,74,45,385,134,13870
15000US060650464011,649,129,93,62,76,59,17,23,556,133,177,86,379,119,13871
15000US060650464012,453,107,26,25,19,24,7,10,427,108,59,31,368,112,13872
15000US060650464021,805,91,107,43,52,39,55,31,698,93,184,71,514,103,13873
15000US060650464022,676,103,202,78,77,53,125,61,474,96,125,49,349,97,13874
15000US060650464031,1005,136,106,97,37,43,69,89,899,137,215,106,684,142,13875
15000US060650464032,544,125,0,12,0,12,0,12,544,125,174,96,370,105,13876
15000US060650464033,464,105,92,71,92,71,0,12,372,110,145,91,227,113,13877
15000US060650464041,1291,128,113,77,41,51,72,60,1178,136,175,83,1003,136,13878
15000US060650464042,643,108,197,83,76,56,121,73,446,117,179,81,267,112,13879
15000US060650464051,533,81,25,26,5,10,20,24,508,81,130,55,378,81,13880
15000US060650464052,545,81,75,57,16,18,59,55,470,83,116,43,354,76,13881
15000US060650465001,0,12,0,12,0,12,0,12,0,12,0,12,0,12,13882
15000US060650465002,157,50,26,20,5,8,21,18,131,53,14,16,117,50,13883
15000US060650465003,666,113,154,64,80,59,74,45,512,114,105,71,407,102,13884
15000US060650465004,430,89,20,35,0,12,20,35,410,87,57,64,353,84,13885
15000US060650466011,214,39,12,11,8,9,4,6,202,39,72,21,130,39,13886
15000US060650466021,295,76,12,18,10,17,2,7,283,74,83,47,200,72,13887
15000US060650466022,783,90,12,18,12,18,0,12,771,93,273,102,498,102,13888
15000US060650467001,552,86,27,33,7,11,20,31,525,83,218,73,307,74,13889
15000US060650467002,360,77,45,38,28,32,17,19,315,74,97,42,218,78,13890
15000US060650467003,463,88,100,56,26,20,74,51,363,94,84,58,279,94,13891
15000US060650468001,483,101,29,39,4,7,25,39,454,100,184,81,270,94,13892
15000US060650468002,688,113,154,93,41,37,113,89,534,128,197,97,337,114,13893
15000US060650468003,269,70,77,58,23,28,54,51,192,57,76,53,116,54,13894
15000US060650469001,567,94,100,39,42,25,58,31,467,91,109,47,358,72,13895
15000US060650470001,209,80,57,48,12,13,45,47,152,68,38,24,114,66,13896
15000US060650470002,384,93,18,18,12,14,6,11,366,92,132,68,234,77,13897
15000US060650472011,1025,175,142,80,42,33,100,66,883,162,277,93,606,147,13898
15000US060650472021,791,109,47,43,29,33,18,29,744,108,233,75,511,102,13899
15000US060650479001,676,124,0,12,0,12,0,12,676,124,153,98,523,134,13900
15000US060650479002,622,140,57,85,0,12,57,85,565,134,114,72,451,144,13901
15000US060650479003,736,134,31,37,0,12,31,37,705,133,117,71,588,127,13902
15000US060650479004,577,170,0,12,0,12,0,12,577,170,91,102,486,174,13903
15000US060650479005,1118,157,38,44,0,12,38,44,1080,157,137,103,943,156,13904
15000US060650481001,1980,70,43,36,32,31,11,17,1937,77,347,112,1590,148,13905
15000US060650482001,888,73,30,33,21,31,9,13,858,76,96,57,762,92,13906
15000US060650482002,436,78,26,39,0,12,26,39,410,77,88,41,322,76,13907
15000US060650483001,765,97,118,70,24,26,94,66,647,93,79,43,568,94,13908
15000US060650483002,962,118,50,48,2,8,48,48,912,131,205,85,707,140,13909
15000US060650487001,793,107,68,50,23,25,45,45,725,105,173,76,552,119,13910
15000US060650487002,325,107,46,52,46,52,0,12,279,99,124,83,155,70,13911
15000US060650488001,539,82,129,84,49,33,80,74,410,79,186,71,224,73,13912
15000US060650488002,569,86,62,49,8,16,54,47,507,98,95,51,412,102,13913
15000US060650489011,980,38,154,67,77,48,77,49,826,77,177,52,649,88,13914
15000US060650489021,1231,136,418,118,133,66,285,110,813,145,239,104,574,123,13915
15000US060650489022,655,142,135,72,21,20,114,70,520,136,139,82,381,107,13916
15000US060650490001,234,89,10,19,10,19,0,12,224,90,89,66,135,83,13917
15000US060650490002,1515,180,196,87,63,50,133,84,1319,209,146,82,1173,183,13918
15000US060650490003,435,127,24,37,24,37,0,12,411,126,73,56,338,126,13919
15000US060650491001,792,175,38,51,0,12,38,51,754,173,159,94,595,168,13920
15000US060650491002,1079,216,29,34,0,12,29,34,1050,217,310,148,740,237,13921
15000US060650491003,482,139,0,12,0,12,0,12,482,139,99,69,383,156,13922
15000US060650494001,454,87,47,44,6,15,41,39,407,83,71,41,336,80,13923
15000US060650494002,926,92,10,17,10,17,0,12,916,91,279,79,637,91,13924
15000US060650495001,1024,133,233,98,34,44,199,96,791,148,190,90,601,148,13925
15000US060650495002,1179,161,55,60,10,16,45,57,1124,154,177,114,947,161,13926
15000US060650496001,781,166,38,61,38,61,0,12,743,161,259,109,484,160,13927
15000US060650496002,1106,210,27,30,0,12,27,30,1079,214,91,65,988,211,13928
15000US060650496003,644,154,16,23,11,19,5,15,628,152,105,91,523,118,13929
15000US060650497001,475,89,0,12,0,12,0,12,475,89,120,87,355,95,13930
15000US060650497002,945,133,0,12,0,12,0,12,945,133,153,78,792,160,13931
15000US060650497003,1058,127,9,14,0,12,9,14,1049,130,169,72,880,135,13932
15000US060650498001,913,112,122,88,60,78,62,51,791,94,116,63,675,113,13933
15000US060650498002,570,91,40,36,13,21,27,33,530,92,54,38,476,100,13934
15000US060650503001,688,138,12,20,12,20,0,12,676,142,192,112,484,135,13935
15000US060650503002,1226,173,0,12,0,12,0,12,1226,173,320,125,906,205,13936
15000US060650503003,478,131,24,29,24,29,0,12,454,128,100,80,354,132,13937
15000US060650503004,563,136,33,42,18,34,15,24,530,137,49,47,481,138,13938
15000US060650504001,623,148,39,40,25,31,14,24,584,148,124,83,460,150,13939
15000US060650504002,299,91,9,16,9,16,0,12,290,91,84,56,206,88,13940
15000US060650504003,245,81,0,12,0,12,0,12,245,81,19,26,226,87,13941
15000US060650504004,653,149,69,102,0,12,69,102,584,124,200,93,384,106,13942
15000US060650504005,1228,173,15,25,0,12,15,25,1213,174,363,146,850,184,13943
15000US060650505001,905,167,56,50,20,32,36,40,849,176,184,78,665,193,13944
15000US060650505002,862,184,230,142,87,90,143,117,632,179,107,66,525,173,13945
15000US060650505003,524,180,77,100,15,26,62,96,447,140,69,68,378,138,13946
15000US060650505004,543,156,43,39,16,25,27,31,500,160,44,43,456,157,13947
15000US060650505005,1205,236,18,29,18,29,0,12,1187,231,197,104,990,205,13948
15000US060650506001,302,75,0,12,0,12,0,12,302,75,63,54,239,78,13949
15000US060650506002,313,79,16,25,0,12,16,25,297,84,86,78,211,70,13950
15000US060650506003,345,137,73,86,0,12,73,86,272,116,37,33,235,121,13951
15000US060650506004,1297,142,12,20,0,12,12,20,1285,141,450,146,835,193,13952
15000US060650507001,828,161,14,22,14,22,0,12,814,161,74,60,740,155,13953
15000US060650507002,521,134,29,35,14,23,15,25,492,135,176,115,316,107,13954
15000US060650507003,1141,220,75,60,24,37,51,50,1066,222,283,144,783,185,13955
15000US060650507004,824,189,22,31,0,12,22,31,802,192,192,135,610,185,13956
15000US060650509001,851,113,59,54,15,18,44,52,792,113,115,68,677,122,13957
15000US060650509002,681,136,0,12,0,12,0,12,681,136,149,108,532,117,13958
15000US060650509003,230,70,9,14,0,12,9,14,221,72,47,40,174,66,13959
15000US060650511001,766,136,97,68,38,40,59,55,669,124,155,72,514,108,13960
15000US060650511002,937,139,36,38,0,12,36,38,901,136,219,102,682,143,13961
15000US060650512001,1191,118,90,67,33,42,57,51,1101,109,266,73,835,110,13962
15000US060650512002,240,57,0,12,0,12,0,12,240,57,21,22,219,58,13963
15000US060650513001,1392,185,162,121,18,28,144,112,1230,182,561,191,669,164,13964
15000US060650513002,1313,170,235,93,126,75,109,66,1078,189,354,129,724,193,13965
15000US060650514001,1367,186,0,12,0,12,0,12,1367,186,561,175,806,184,13966
15000US060650514002,779,148,0,12,0,12,0,12,779,148,208,118,571,155,13967
15000US060650514003,1935,210,28,44,28,44,0,12,1907,215,682,209,1225,242,13968
15000US060659401001,26,21,0,12,0,12,0,12,26,21,26,21,0,12,13969
15000US060659401002,57,21,0,12,0,12,0,12,57,21,26,15,31,17,13970
15000US060659404001,1368,86,214,79,16,20,198,75,1154,114,263,89,891,135,13971
15000US060659404002,303,69,86,66,15,11,71,65,217,76,48,21,169,72,13972
15000US060659405001,589,71,11,7,5,4,6,6,578,72,206,71,372,64,13973
15000US060659405002,610,80,0,12,0,12,0,12,610,80,140,34,470,72,13974
15000US060659406001,857,104,4,4,2,3,2,3,853,103,130,39,723,111,13975
15000US060659406002,741,64,12,8,4,4,8,6,729,63,208,30,521,64,13976
15000US060659407001,582,57,36,18,18,15,18,13,546,51,167,38,379,48,13977
15000US060659407002,849,59,23,10,13,6,10,8,826,62,234,40,592,56,13978
15000US060659408001,936,58,57,18,25,11,32,16,879,57,295,42,584,49,13979
15000US060659408002,718,56,10,10,0,12,10,10,708,54,188,26,520,47,13980
15000US060659409001,624,51,14,14,14,14,0,12,610,53,212,33,398,47,13981
15000US060659409002,432,44,33,16,16,11,17,12,399,41,168,28,231,33,13982
15000US060659410001,657,108,16,13,5,5,11,11,641,107,352,114,289,87,13983
15000US060659410002,438,55,91,27,41,25,50,24,347,54,138,43,209,42,13984
15000US060659410003,606,126,14,20,0,12,14,20,592,125,221,98,371,82,13985
15000US060659410004,577,67,0,12,0,12,0,12,577,67,159,35,418,55,13986
15000US060659411001,302,31,6,5,2,3,4,4,296,32,77,19,219,29,13987
15000US060659411002,841,54,36,16,17,8,19,12,805,54,306,34,499,46,13988
15000US060659412001,368,74,32,19,20,15,12,15,336,73,107,54,229,63,13989
15000US060659412002,498,46,5,5,0,12,5,5,493,46,133,30,360,42,13990
15000US060659412003,301,31,5,5,5,5,0,12,296,32,81,21,215,30,13991
15000US060659413001,897,65,43,18,11,9,32,18,854,63,203,38,651,54,13992
15000US060659413002,815,65,41,19,13,9,28,15,774,64,225,40,549,55,13993
15000US060659414001,481,50,13,7,5,5,8,6,468,49,99,25,369,47,13994
15000US060659414002,794,57,149,41,31,17,118,37,645,63,160,43,485,62,13995
15000US060659414003,709,69,41,17,17,9,24,18,668,70,169,45,499,59,13996
15000US060659415001,1486,62,143,65,130,63,13,14,1343,86,473,119,870,132,13997
15000US060659800041,0,12,0,12,0,12,0,12,0,12,0,12,0,12,13998
15000US060659810001,0,17,0,17,0,17,0,17,0,17,0,17,0,17,13999
15000US060670001001,869,89,8,12,8,12,0,12,861,91,161,69,700,104,14000
15000US060670001002,510,82,9,14,9,14,0,12,501,83,76,41,425,95,14001
15000US060670001003,309,66,0,12,0,12,0,12,309,66,99,42,210,71,14002
15000US060670002001,380,51,0,12,0,12,0,12,380,51,49,32,331,61,14003
15000US060670002002,454,69,15,23,15,23,0,12,439,71,56,28,383,71,14004
15000US060670002003,507,75,27,25,0,12,27,25,480,75,144,53,336,80,14005
15000US060670002004,420,61,0,12,0,12,0,12,420,61,68,39,352,62,14006
15000US060670003001,398,60,0,12,0,12,0,12,398,60,64,46,334,66,14007
15000US060670003002,378,60,0,12,0,12,0,12,378,60,55,33,323,66,14008
15000US060670003003,810,77,18,20,0,12,18,20,792,79,110,55,682,83,14009
15000US060670004001,506,121,0,12,0,12,0,12,506,121,88,72,418,130,14010
15000US060670004002,548,116,38,46,0,12,38,46,510,114,66,56,444,118,14011
15000US060670004003,807,146,133,96,37,53,96,87,674,142,104,58,570,147,14012
15000US060670004004,387,87,12,21,12,21,0,12,375,85,65,43,310,94,14013
15000US060670005001,768,110,200,78,60,50,140,79,568,111,25,25,543,111,14014
15000US060670005002,563,86,30,22,0,12,30,22,533,88,63,43,470,92,14015
15000US060670005003,446,82,47,41,0,12,47,41,399,82,34,26,365,82,14016
15000US060670006001,305,73,37,36,21,27,16,24,268,69,39,22,229,67,14017
15000US060670006002,298,56,46,27,31,28,15,13,252,54,72,35,180,51,14018
15000US060670007001,522,45,58,28,53,29,5,8,464,50,248,51,216,48,14019
15000US060670008001,278,69,0,12,0,12,0,12,278,69,64,34,214,72,14020
15000US060670008002,811,107,16,17,8,12,8,13,795,106,166,70,629,89,14021
15000US060670011011,755,111,109,61,43,31,66,51,646,112,160,70,486,102,14022
15000US060670011012,880,120,136,77,81,62,55,43,744,124,152,76,592,116,14023
15000US060670012001,1216,164,69,50,40,36,29,34,1147,170,280,126,867,172,14024
15000US060670012002,581,124,106,90,58,54,48,79,475,134,128,91,347,120,14025
15000US060670012003,674,119,16,25,0,12,16,25,658,120,53,45,605,119,14026
15000US060670013001,597,94,80,66,0,12,80,66,517,99,27,24,490,101,14027
15000US060670013002,573,97,47,43,37,42,10,15,526,98,108,55,418,99,14028
15000US060670013003,829,103,55,41,17,28,38,30,774,105,61,45,713,102,14029
15000US060670014001,378,83,27,44,27,44,0,12,351,82,137,66,214,63,14030
15000US060670014002,665,92,105,77,19,21,86,73,560,89,171,67,389,91,14031
15000US060670014003,753,120,86,69,9,15,77,67,667,123,146,78,521,113,14032
15000US060670015001,581,103,19,33,0,12,19,33,562,105,127,80,435,93,14033
15000US060670015002,376,85,0,12,0,12,0,12,376,85,61,44,315,93,14034
15000US060670015003,336,100,0,12,0,12,0,12,336,100,25,30,311,97,14035
15000US060670015004,327,81,0,12,0,12,0,12,327,81,72,52,255,87,14036
15000US060670015005,665,130,15,25,0,12,15,25,650,137,96,83,554,134,14037
15000US060670016001,654,127,0,12,0,12,0,12,654,127,39,34,615,130,14038
15000US060670016002,611,145,24,41,0,12,24,41,587,146,43,41,544,144,14039
15000US060670016003,407,126,0,12,0,12,0,12,407,126,93,66,314,127,14040
15000US060670016004,422,106,0,12,0,12,0,12,422,106,94,55,328,108,14041
15000US060670016005,530,102,71,75,19,34,52,75,459,86,13,21,446,87,14042
15000US060670017001,688,133,16,26,16,26,0,12,672,137,227,116,445,126,14043
15000US060670017002,363,100,28,42,28,42,0,12,335,103,84,55,251,102,14044
15000US060670017003,526,146,35,43,12,18,23,39,491,150,229,110,262,116,14045
15000US060670017004,317,80,0,12,0,12,0,12,317,80,37,36,280,91,14046
15000US060670017005,543,142,21,23,0,12,21,23,522,143,34,34,488,144,14047
15000US060670018001,555,92,0,12,0,12,0,12,555,92,67,38,488,89,14048
15000US060670018002,320,81,50,44,7,11,43,43,270,72,40,39,230,74,14049
15000US060670018003,290,86,28,28,8,12,20,25,262,92,83,53,179,72,14050
15000US060670018004,494,121,97,55,68,51,29,32,397,125,170,87,227,98,14051
15000US060670018005,601,118,122,85,59,66,63,57,479,99,94,54,385,101,14052
15000US060670019001,584,86,26,28,0,12,26,28,558,90,74,44,484,101,14053
15000US060670019002,393,79,44,39,16,21,28,33,349,77,57,48,292,78,14054
15000US060670019003,734,110,17,18,8,12,9,13,717,113,139,60,578,110,14055
15000US060670020001,353,72,20,19,6,9,14,17,333,77,111,54,222,72,14056
15000US060670020002,634,86,18,19,18,19,0,12,616,87,113,52,503,96,14057
15000US060670020003,376,73,22,20,0,12,22,20,354,72,134,60,220,61,14058
15000US060670021001,390,82,21,33,0,12,21,33,369,85,66,57,303,79,14059
15000US060670021002,367,86,17,20,0,12,17,20,350,83,55,40,295,88,14060
15000US060670021003,310,82,9,16,0,12,9,16,301,80,62,37,239,81,14061
15000US060670022001,615,105,232,97,129,73,103,69,383,87,154,74,229,74,14062
15000US060670022002,319,98,219,68,76,56,143,69,100,80,65,59,35,45,14063
15000US060670022003,444,88,149,63,32,38,117,63,295,64,30,25,265,64,14064
15000US060670022004,403,67,0,12,0,12,0,12,403,67,85,43,318,66,14065
15000US060670023001,315,72,0,12,0,12,0,12,315,72,83,55,232,57,14066
15000US060670023002,427,62,0,12,0,12,0,12,427,62,30,25,397,61,14067
15000US060670023003,572,79,0,12,0,12,0,12,572,79,95,43,477,72,14068
15000US060670023004,337,65,0,12,0,12,0,12,337,65,50,27,287,72,14069
15000US060670024001,633,97,0,12,0,12,0,12,633,97,71,61,562,98,14070
15000US060670024002,664,113,27,25,15,23,12,19,637,110,140,100,497,97,14071
15000US060670024003,377,95,9,16,0,12,9,16,368,94,120,84,248,89,14072
15000US060670024004,318,62,0,12,0,12,0,12,318,62,68,49,250,64,14073
15000US060670025001,305,40,0,12,0,12,0,12,305,40,68,34,237,41,14074
15000US060670025002,355,52,6,9,0,12,6,9,349,52,38,21,311,54,14075
15000US060670026001,603,94,57,54,57,54,0,12,546,90,96,64,450,89,14076
15000US060670026002,348,66,0,12,0,12,0,12,348,66,25,24,323,71,14077
15000US060670026003,289,51,0,12,0,12,0,12,289,51,37,25,252,51,14078
15000US060670027001,239,60,17,20,7,12,10,16,222,62,36,39,186,56,14079
15000US060670027002,604,96,105,62,41,26,64,51,499,93,143,79,356,91,14080
15000US060670027003,261,78,96,70,27,37,69,59,165,61,15,24,150,61,14081
15000US060670027004,356,76,87,57,80,56,7,11,269,72,168,59,101,56,14082
15000US060670028001,391,99,88,47,44,49,44,42,303,85,140,79,163,58,14083
15000US060670028002,234,59,139,57,85,51,54,32,95,44,28,26,67,35,14084
15000US060670028003,441,81,174,76,91,51,83,60,267,83,72,44,195,76,14085
15000US060670029001,901,124,49,49,49,49,0,12,852,131,249,121,603,154,14086
15000US060670029002,458,85,21,31,21,31,0,12,437,85,59,46,378,86,14087
15000US060670029003,295,79,30,35,16,26,14,29,265,77,17,26,248,78,14088
15000US060670029004,676,139,59,58,0,12,59,58,617,142,124,64,493,156,14089
15000US060670030001,701,227,61,70,3,10,58,66,640,233,378,203,262,123,14090
15000US060670030002,618,166,85,72,0,12,85,72,533,170,134,82,399,158,14091
15000US060670030003,521,192,67,69,35,56,32,40,454,168,69,68,385,159,14092
15000US060670030004,510,109,49,48,6,12,43,47,461,111,108,59,353,127,14093
15000US060670030005,339,126,45,36,22,23,23,28,294,126,106,72,188,119,14094
15000US060670031011,254,69,26,33,5,9,21,32,228,66,85,55,143,60,14095
15000US060670031012,158,42,35,31,10,15,25,25,123,37,30,23,93,36,14096
15000US060670031013,497,78,49,36,20,19,29,32,448,79,177,67,271,79,14097
15000US060670031014,238,75,81,61,37,37,44,46,157,62,35,27,122,56,14098
15000US060670031021,331,67,38,22,14,12,24,19,293,75,99,45,194,58,14099
15000US060670031022,336,50,40,27,12,13,28,27,296,57,80,33,216,61,14100
15000US060670031023,296,66,83,45,32,29,51,39,213,57,54,37,159,53,14101
15000US060670032021,396,84,55,52,15,17,40,52,341,79,113,56,228,66,14102
15000US060670032022,942,115,356,109,74,61,282,97,586,120,222,78,364,95,14103
15000US060670032023,336,78,47,55,23,35,24,38,289,77,100,51,189,78,14104
15000US060670032031,270,52,103,40,39,38,64,36,167,52,61,30,106,50,14105
15000US060670032032,411,60,84,44,8,11,76,43,327,54,87,37,240,62,14106
15000US060670032041,573,85,91,48,50,33,41,36,482,76,193,69,289,76,14107
15000US060670032042,352,80,98,59,10,15,88,56,254,71,53,34,201,69,14108
15000US060670032043,595,96,122,71,38,42,84,55,473,111,177,80,296,111,14109
15000US060670033001,615,82,8,13,0,12,8,13,607,84,118,55,489,91,14110
15000US060670033002,576,91,65,42,40,34,25,31,511,88,106,42,405,88,14111
15000US060670033003,773,81,11,17,11,17,0,12,762,83,227,73,535,106,14112
15000US060670034001,424,83,136,66,60,37,76,58,288,71,91,41,197,59,14113
15000US060670034002,736,98,73,38,44,37,29,26,663,102,200,77,463,92,14114
15000US060670034003,639,83,10,16,0,12,10,16,629,84,226,74,403,88,14115
15000US060670035011,313,75,43,41,29,37,14,21,270,74,34,30,236,72,14116
15000US060670035012,445,79,52,51,31,47,21,26,393,81,171,64,222,68,14117
15000US060670035013,452,85,124,73,16,25,108,69,328,84,94,51,234,90,14118
15000US060670035021,538,85,19,23,19,23,0,12,519,87,133,61,386,84,14119
15000US060670035022,430,96,54,47,39,42,15,22,376,98,183,85,193,62,14120
15000US060670035023,312,60,20,22,20,22,0,12,292,65,38,28,254,65,14121
15000US060670036001,666,66,86,55,56,34,30,41,580,76,145,52,435,78,14122
15000US060670036002,324,63,85,46,36,33,49,37,239,69,51,29,188,72,14123
15000US060670037001,808,84,271,82,139,66,132,55,537,95,174,74,363,76,14124
15000US060670037002,495,68,138,62,86,47,52,41,357,73,92,43,265,70,14125
15000US060670038001,927,122,310,135,99,77,211,109,617,133,197,99,420,118,14126
15000US060670038002,380,103,53,53,43,52,10,17,327,102,150,77,177,73,14127
15000US060670038003,235,64,42,36,24,27,18,28,193,61,92,51,101,44,14128
15000US060670038004,232,56,22,23,10,15,12,18,210,53,102,42,108,46,14129
15000US060670039001,389,71,15,17,8,10,7,12,374,75,130,47,244,72,14130
15000US060670039002,518,78,35,39,0,12,35,39,483,77,131,55,352,72,14131
15000US060670039003,574,83,27,34,0,12,27,34,547,87,81,38,466,96,14132
15000US060670040011,543,166,18,28,18,28,0,12,525,164,131,71,394,153,14133
15000US060670040012,575,114,80,72,61,73,19,28,495,112,103,64,392,117,14134
15000US060670040013,774,138,0,12,0,12,0,12,774,138,259,108,515,119,14135
15000US060670040014,636,128,0,12,0,12,0,12,636,128,116,86,520,127,14136
15000US060670040041,833,126,0,12,0,12,0,12,833,126,155,98,678,119,14137
15000US060670040042,962,143,42,43,14,24,28,46,920,152,307,122,613,158,14138
15000US060670040043,814,122,40,41,31,37,9,14,774,126,192,81,582,134,14139
15000US060670040051,485,76,40,31,0,12,40,31,445,75,174,67,271,73,14140
15000US060670040052,910,100,63,43,16,25,47,39,847,103,133,61,714,105,14141
15000US060670040053,498,74,9,15,0,12,9,15,489,75,118,69,371,66,14142
15000US060670040061,528,141,49,54,0,12,49,54,479,136,29,34,450,137,14143
15000US060670040062,757,150,147,97,6,14,141,96,610,147,280,119,330,120,14144
15000US060670040063,457,106,0,12,0,12,0,12,457,106,110,77,347,106,14145
15000US060670040064,536,120,0,12,0,12,0,12,536,120,126,61,410,128,14146
15000US060670040081,996,66,26,23,10,15,16,20,970,64,142,56,828,82,14147
15000US060670040082,544,65,24,25,0,12,24,25,520,66,62,35,458,68,14148
15000US060670040091,463,115,0,12,0,12,0,12,463,115,65,35,398,117,14149
15000US060670040092,463,100,10,17,0,12,10,17,453,106,58,43,395,105,14150
15000US060670040093,631,134,86,115,76,114,10,18,545,90,45,42,500,98,14151
15000US060670040094,611,116,33,36,0,12,33,36,578,115,81,60,497,112,14152
15000US060670040101,1278,158,214,129,7,13,207,126,1064,184,377,141,687,186,14153
15000US060670040102,620,127,94,64,30,45,64,63,526,133,177,116,349,93,14154
15000US060670040103,498,117,68,78,50,73,18,27,430,127,122,74,308,118,14155
15000US060670040111,550,90,0,12,0,12,0,12,550,90,110,45,440,98,14156
15000US060670040112,862,98,4,7,4,7,0,12,858,95,168,63,690,108,14157
15000US060670040121,1020,76,16,17,0,12,16,17,1004,77,163,79,841,97,14158
15000US060670040122,310,58,0,12,0,12,0,12,310,58,89,56,221,61,14159
15000US060670041001,638,99,98,62,0,12,98,62,540,108,205,65,335,111,14160
15000US060670041002,235,69,71,55,39,26,32,51,164,50,49,32,115,47,14161
15000US060670041003,712,120,263,93,107,69,156,81,449,99,270,67,179,82,14162
15000US060670042011,282,65,15,18,7,12,8,13,267,65,128,58,139,60,14163
15000US060670042012,682,108,121,56,55,36,66,47,561,98,201,72,360,88,14164
15000US060670042013,607,85,69,47,32,32,37,39,538,95,252,71,286,88,14165
15000US060670042021,674,98,147,58,83,40,64,45,527,111,209,69,318,101,14166
15000US060670042022,513,86,82,63,29,31,53,54,431,93,167,74,264,80,14167
15000US060670042023,465,98,147,76,35,29,112,77,318,90,106,68,212,79,14168
15000US060670042031,904,118,386,113,26,24,360,114,518,118,197,77,321,102,14169
15000US060670042032,674,107,196,80,112,66,84,51,478,105,132,54,346,93,14170
15000US060670043001,555,119,142,81,35,40,107,72,413,119,138,87,275,121,14171
15000US060670043002,611,122,137,71,45,36,92,59,474,125,157,92,317,116,14172
15000US060670043003,574,170,138,118,138,118,0,12,436,139,131,92,305,130,14173
15000US060670043004,527,129,158,88,49,54,109,83,369,108,126,63,243,101,14174
15000US060670044011,272,85,7,12,7,12,0,12,265,87,154,78,111,51,14175
15000US060670044012,261,77,82,49,72,45,10,15,179,71,30,35,149,78,14176
15000US060670044013,477,98,91,67,69,57,22,34,386,101,119,61,267,100,14177
15000US060670044014,310,76,27,24,11,17,16,17,283,80,36,35,247,83,14178
15000US060670044021,337,100,204,92,122,64,82,75,133,52,32,27,101,45,14179
15000US060670044022,639,110,243,100,31,28,212,101,396,81,137,78,259,85,14180
15000US060670044023,330,94,82,45,21,20,61,40,248,91,53,35,195,87,14181
15000US060670045011,508,66,168,48,19,20,149,48,340,64,151,52,189,56,14182
15000US060670045012,488,76,126,53,51,27,75,44,362,73,87,44,275,81,14183
15000US060670045021,414,76,90,56,21,22,69,52,324,81,171,79,153,65,14184
15000US060670045022,533,112,371,108,108,64,263,91,162,60,54,47,108,49,14185
15000US060670045023,744,107,204,88,49,41,155,79,540,118,152,72,388,110,14186
15000US060670046011,366,111,52,46,15,26,37,42,314,109,123,97,191,99,14187
15000US060670046012,609,146,344,134,57,46,287,133,265,118,51,40,214,119,14188
15000US060670046013,270,106,112,68,13,20,99,69,158,87,88,67,70,71,14189
15000US060670046014,223,88,63,65,0,12,63,65,160,80,46,44,114,69,14190
15000US060670046015,903,128,203,97,100,71,103,75,700,146,208,96,492,160,14191
15000US060670046021,646,89,156,66,57,36,99,54,490,89,99,48,391,85,14192
15000US060670046022,241,56,40,25,33,23,7,11,201,55,66,34,135,51,14193
15000US060670046023,592,93,211,74,85,40,126,63,381,96,97,41,284,88,14194
15000US060670047011,347,60,50,38,27,34,23,26,297,59,73,30,224,58,14195
15000US060670047012,744,103,362,83,67,56,295,93,382,110,190,76,192,84,14196
15000US060670047021,926,86,331,100,107,66,224,84,595,103,198,67,397,96,14197
15000US060670047022,561,90,163,76,77,61,86,64,398,84,104,49,294,82,14198
15000US060670048011,397,102,123,63,17,15,106,63,274,75,124,51,150,70,14199
15000US060670048012,337,65,49,31,9,16,40,30,288,68,92,51,196,65,14200
15000US060670048013,480,91,46,33,15,19,31,27,434,97,199,82,235,91,14201
15000US060670048014,417,86,55,34,21,24,34,25,362,89,184,78,178,75,14202
15000US060670048021,907,88,308,110,80,58,228,98,599,126,136,64,463,103,14203
15000US060670048022,503,59,135,57,73,43,62,51,368,63,105,55,263,65,14204
15000US060670049031,798,117,157,83,114,79,43,36,641,118,215,78,426,105,14205
15000US060670049032,834,109,479,111,123,60,356,105,355,104,139,72,216,94,14206
15000US060670049033,360,85,71,42,25,26,46,35,289,80,77,51,212,72,14207
15000US060670049041,547,105,80,52,29,36,51,39,467,102,80,40,387,107,14208
15000US060670049042,768,103,149,68,25,29,124,67,619,113,205,86,414,105,14209
15000US060670049043,447,75,73,53,36,37,37,38,374,70,117,52,257,67,14210
15000US060670049051,945,149,155,85,67,46,88,79,790,145,259,102,531,158,14211
15000US060670049052,915,163,199,125,53,59,146,106,716,152,148,89,568,164,14212
15000US060670049053,478,137,149,114,117,105,32,51,329,122,82,66,247,129,14213
15000US060670049061,491,61,87,40,23,20,64,36,404,61,101,45,303,58,14214
15000US060670049062,373,69,89,54,61,48,28,26,284,56,68,37,216,57,14215
15000US060670050011,665,103,132,82,58,49,74,67,533,102,198,108,335,116,14216
15000US060670050012,913,174,285,146,57,50,228,146,628,200,112,72,516,188,14217
15000US060670050013,839,154,200,96,106,65,94,61,639,151,234,103,405,146,14218
15000US060670050021,753,130,294,126,147,97,147,90,459,132,210,98,249,110,14219
15000US060670050022,592,120,152,92,60,54,92,72,440,129,207,95,233,98,14220
15000US060670050023,1002,139,140,80,80,64,60,44,862,142,361,135,501,123,14221
15000US060670051011,670,77,199,82,138,76,61,42,471,99,192,75,279,84,14222
15000US060670051012,625,88,177,79,43,40,134,64,448,94,112,51,336,87,14223
15000US060670051021,706,105,173,80,35,27,138,76,533,99,131,66,402,89,14224
15000US060670051022,936,99,177,69,157,61,20,27,759,100,306,98,453,105,14225
15000US060670052011,513,73,97,39,8,12,89,38,416,71,98,48,318,68,14226
15000US060670052012,320,59,23,27,13,22,10,16,297,60,44,35,253,56,14227
15000US060670052021,889,84,47,34,9,14,38,30,842,91,148,52,694,103,14228
15000US060670052022,532,62,8,12,8,12,0,12,524,64,78,38,446,65,14229
15000US060670052041,282,54,0,12,0,12,0,12,282,54,93,53,189,57,14230
15000US060670052042,515,91,57,37,26,26,31,30,458,91,127,62,331,81,14231
15000US060670052043,433,68,0,12,0,12,0,12,433,68,80,37,353,70,14232
15000US060670052044,355,67,39,56,0,12,39,56,316,66,77,41,239,64,14233
15000US060670052045,274,56,0,12,0,12,0,12,274,56,61,32,213,59,14234
15000US060670052051,361,80,9,14,0,12,9,14,352,79,104,41,248,73,14235
15000US060670052052,576,93,60,36,26,27,34,26,516,96,91,53,425,97,14236
15000US060670053011,334,42,192,51,96,43,96,43,142,50,59,26,83,42,14237
15000US060670053012,76,31,25,24,12,12,13,21,51,23,32,22,19,16,14238
15000US060670054021,692,106,16,18,0,12,16,18,676,105,246,62,430,93,14239
15000US060670054022,771,113,10,16,0,12,10,16,761,112,64,41,697,112,14240
15000US060670054031,571,63,0,12,0,12,0,12,571,63,106,47,465,75,14241
15000US060670054032,692,74,9,16,0,12,9,16,683,75,129,53,554,90,14242
15000US060670054041,772,128,0,12,0,12,0,12,772,128,196,99,576,123,14243
15000US060670054042,352,83,0,12,0,12,0,12,352,83,51,40,301,89,14244
15000US060670054043,292,91,0,12,0,12,0,12,292,91,56,51,236,91,14245
15000US060670054044,917,160,106,90,0,12,106,90,811,171,127,62,684,179,14246
15000US060670054045,319,81,7,17,0,12,7,17,312,83,58,39,254,85,14247
15000US060670055021,442,88,171,81,32,27,139,79,271,91,37,50,234,79,14248
15000US060670055022,642,107,107,63,26,29,81,58,535,99,86,50,449,97,14249
15000US060670055023,933,136,250,82,79,52,171,75,683,137,129,55,554,134,14250
15000US060670055051,638,102,42,41,42,41,0,12,596,97,182,71,414,101,14251
15000US060670055052,571,146,161,93,38,39,123,87,410,142,85,58,325,135,14252
15000US060670055053,952,114,374,104,169,92,205,103,578,102,173,76,405,102,14253
15000US060670055061,546,114,200,84,43,47,157,69,346,100,29,30,317,95,14254
15000US060670055062,711,103,219,81,95,65,124,55,492,93,60,40,432,95,14255
15000US060670055081,390,83,36,47,8,13,28,46,354,79,60,49,294,80,14256
15000US060670055082,830,106,130,68,66,40,64,61,700,112,59,36,641,121,14257
15000US060670055083,581,110,63,55,8,13,55,53,518,106,45,42,473,111,14258
15000US060670055091,720,87,74,35,28,24,46,27,646,86,84,38,562,86,14259
15000US060670055092,130,51,34,30,21,28,13,15,96,43,12,13,84,43,14260
15000US060670055101,810,199,120,93,26,37,94,89,690,202,95,98,595,194,14261
15000US060670055102,449,161,57,71,0,12,57,71,392,154,56,37,336,146,14262
15000US060670055103,1202,219,116,105,0,12,116,105,1086,215,362,142,724,187,14263
15000US060670056011,464,114,46,75,0,12,46,75,418,92,160,86,258,100,14264
15000US060670056012,532,172,59,60,0,12,59,60,473,162,155,102,318,155,14265
15000US060670056013,605,149,348,146,56,53,292,147,257,95,102,73,155,65,14266
15000US060670056014,685,152,98,96,26,44,72,86,587,131,212,95,375,123,14267
15000US060670056051,647,90,179,73,7,11,172,72,468,89,116,51,352,89,14268
15000US060670056052,654,82,136,74,30,26,106,70,518,88,109,47,409,95,14269
15000US060670056061,368,75,0,12,0,12,0,12,368,75,71,36,297,79,14270
15000US060670056062,833,128,85,72,22,35,63,62,748,132,156,77,592,116,14271
15000US060670056063,332,94,26,28,17,24,9,14,306,91,57,44,249,85,14272
15000US060670056064,341,72,17,19,7,12,10,15,324,73,65,39,259,81,14273
15000US060670057011,545,85,11,15,4,8,7,12,534,86,71,40,463,92,14274
15000US060670057012,206,55,0,12,0,12,0,12,206,55,8,12,198,55,14275
15000US060670057013,470,75,17,19,17,19,0,12,453,75,117,58,336,81,14276
15000US060670057021,369,67,0,12,0,12,0,12,369,67,88,43,281,71,14277
15000US060670057022,401,65,0,12,0,12,0,12,401,65,67,36,334,78,14278
15000US060670057023,435,77,8,13,8,13,0,12,427,78,149,54,278,78,14279
15000US060670057024,249,57,0,12,0,12,0,12,249,57,69,40,180,51,14280
15000US060670057025,331,55,0,12,0,12,0,12,331,55,102,61,229,51,14281
15000US060670058011,301,75,0,12,0,12,0,12,301,75,149,49,152,73,14282
15000US060670058012,587,134,51,45,34,38,17,27,536,137,104,62,432,139,14283
15000US060670058013,840,117,0,12,0,12,0,12,840,117,169,72,671,127,14284
15000US060670058014,489,96,0,12,0,12,0,12,489,96,145,77,344,86,14285
15000US060670058031,600,64,0,12,0,12,0,12,600,64,153,55,447,68,14286
15000US060670058032,475,64,0,12,0,12,0,12,475,64,148,73,327,70,14287
15000US060670058033,365,44,0,12,0,12,0,12,365,44,55,27,310,50,14288
15000US060670058041,485,62,7,11,0,12,7,11,478,63,101,38,377,69,14289
15000US060670058042,593,66,8,11,0,12,8,11,585,68,115,48,470,76,14290
15000US060670059011,645,147,0,12,0,12,0,12,645,147,251,129,394,121,14291
15000US060670059012,646,158,0,12,0,12,0,12,646,158,161,94,485,168,14292
15000US060670059013,1114,130,12,19,12,19,0,12,1102,131,373,118,729,151,14293
15000US060670059031,894,100,112,64,52,45,60,51,782,111,157,72,625,119,14294
15000US060670059032,213,58,0,12,0,12,0,12,213,58,45,32,168,52,14295
15000US060670059041,407,100,67,66,0,12,67,66,340,102,50,35,290,106,14296
15000US060670059042,405,98,0,12,0,12,0,12,405,98,107,70,298,102,14297
15000US060670059043,320,85,118,84,66,66,52,63,202,62,37,37,165,61,14298
15000US060670059044,864,148,118,82,55,49,63,68,746,156,272,106,474,132,14299
15000US060670060021,324,100,92,98,13,20,79,96,232,64,72,44,160,55,14300
15000US060670060022,473,116,94,73,9,18,85,73,379,108,71,78,308,101,14301
15000US060670060023,327,95,22,35,0,12,22,35,305,97,85,53,220,106,14302
15000US060670060024,295,85,0,12,0,12,0,12,295,85,37,41,258,84,14303
15000US060670060025,457,112,106,56,28,34,78,53,351,108,38,35,313,109,14304
15000US060670060031,997,106,295,84,95,51,200,69,702,119,198,71,504,116,14305
15000US060670060032,781,88,114,51,45,29,69,47,667,90,151,51,516,95,14306
15000US060670060041,416,61,11,16,3,9,8,14,405,66,46,33,359,75,14307
15000US060670060042,388,63,14,19,0,12,14,19,374,64,99,52,275,72,14308
15000US060670060043,235,48,7,11,0,12,7,11,228,49,68,47,160,58,14309
15000US060670061011,813,156,173,129,29,39,144,122,640,140,287,114,353,128,14310
15000US060670061012,721,163,183,105,6,17,177,106,538,152,75,50,463,146,14311
15000US060670061013,587,118,131,86,37,49,94,78,456,94,149,83,307,92,14312
15000US060670061021,459,102,51,35,10,15,41,32,408,103,127,62,281,106,14313
15000US060670061022,887,112,243,89,32,27,211,88,644,107,242,89,402,81,14314
15000US060670061023,364,91,48,40,0,12,48,40,316,90,57,30,259,84,14315
15000US060670062011,464,141,212,130,19,24,193,135,252,131,34,28,218,130,14316
15000US060670062012,886,187,299,129,104,73,195,129,587,170,117,70,470,159,14317
15000US060670062013,554,136,97,84,51,53,46,63,457,122,136,72,321,115,14318
15000US060670062014,829,206,216,152,78,91,138,132,613,157,82,61,531,175,14319
15000US060670062021,429,112,174,88,38,39,136,87,255,94,82,53,173,84,14320
15000US060670062022,639,115,136,79,38,36,98,66,503,114,112,44,391,102,14321
15000US060670062023,335,90,156,85,13,15,143,89,179,71,58,47,121,66,14322
15000US060670063001,522,100,97,49,85,48,12,20,425,107,75,40,350,108,14323
15000US060670063002,502,111,128,81,48,49,80,61,374,99,157,69,217,76,14324
15000US060670063003,432,100,102,71,33,44,69,58,330,93,45,45,285,101,14325
15000US060670063004,213,77,40,36,5,9,35,35,173,66,56,53,117,46,14326
15000US060670064001,307,55,96,44,14,17,82,44,211,53,79,40,132,49,14327
15000US060670064002,362,94,55,50,19,29,36,39,307,84,110,57,197,73,14328
15000US060670064003,278,79,66,47,16,24,50,39,212,75,89,56,123,60,14329
15000US060670064004,479,84,155,76,51,50,104,63,324,87,82,44,242,86,14330
15000US060670064005,307,92,71,47,7,13,64,49,236,81,18,20,218,87,14331
15000US060670065001,219,60,34,35,27,33,7,11,185,66,79,54,106,60,14332
15000US060670065002,482,109,174,76,73,48,101,66,308,102,81,47,227,96,14333
15000US060670065003,328,86,59,43,14,18,45,39,269,82,89,37,180,78,14334
15000US060670065004,517,114,251,103,82,53,169,92,266,98,54,39,212,97,14335
15000US060670065005,385,83,52,42,29,27,23,27,333,84,94,52,239,76,14336
15000US060670066001,302,94,125,81,16,17,109,79,177,75,83,46,94,60,14337
15000US060670066002,379,94,174,78,67,45,107,72,205,64,41,30,164,57,14338
15000US060670066003,411,91,103,66,35,36,68,54,308,81,87,49,221,75,14339
15000US060670066004,341,92,60,48,25,29,35,38,281,90,82,52,199,85,14340
15000US060670066005,621,113,263,95,59,43,204,90,358,88,135,68,223,78,14341
15000US060670067011,716,178,161,97,38,42,123,87,555,171,98,59,457,161,14342
15000US060670067012,681,113,74,62,8,17,66,60,607,119,187,81,420,113,14343
15000US060670067013,491,105,47,46,30,34,17,30,444,118,78,66,366,126,14344
15000US060670067014,673,143,181,108,34,35,147,103,492,129,100,67,392,121,14345
15000US060670067021,494,90,232,78,78,41,154,76,262,79,76,47,186,75,14346
15000US060670067022,451,93,109,68,47,43,62,53,342,96,72,41,270,96,14347
15000US060670067023,311,80,63,41,15,17,48,40,248,76,57,32,191,70,14348
15000US060670067024,301,68,100,66,18,14,82,65,201,66,50,37,151,60,14349
15000US060670067025,362,86,141,70,43,33,98,64,221,70,89,51,132,64,14350
15000US060670068001,576,210,254,160,109,117,145,132,322,142,112,65,210,137,14351
15000US060670068002,540,139,178,99,73,51,105,96,362,138,145,54,217,125,14352
15000US060670068003,466,163,162,117,83,96,79,74,304,150,58,49,246,145,14353
15000US060670068004,554,146,162,106,44,59,118,87,392,132,181,103,211,88,14354
15000US060670069001,255,105,71,61,30,37,41,49,184,100,84,86,100,65,14355
15000US060670069002,464,154,234,145,15,25,219,143,230,106,169,96,61,50,14356
15000US060670069003,367,155,60,75,60,75,0,12,307,143,131,107,176,106,14357
15000US060670069004,545,143,173,145,64,84,109,125,372,113,101,96,271,83,14358
15000US060670069005,352,94,13,20,13,20,0,12,339,95,49,37,290,98,14359
15000US060670070011,560,86,108,74,31,43,77,56,452,104,98,57,354,97,14360
15000US060670070012,301,69,82,50,14,17,68,49,219,56,36,27,183,57,14361
15000US060670070013,267,75,136,59,36,34,100,52,131,73,15,19,116,71,14362
15000US060670070041,1289,187,206,124,14,22,192,122,1083,195,200,104,883,195,14363
15000US060670070042,735,135,47,42,0,12,47,42,688,136,146,68,542,131,14364
15000US060670070043,676,172,179,123,0,12,179,123,497,155,74,53,423,159,14365
15000US060670070071,612,86,60,62,0,12,60,62,552,79,191,53,361,78,14366
15000US060670070072,411,81,135,65,49,45,86,49,276,72,57,43,219,80,14367
15000US060670070073,589,95,124,67,5,9,119,67,465,88,118,51,347,87,14368
15000US060670070101,555,104,0,12,0,12,0,12,555,104,65,59,490,95,14369
15000US060670070102,804,103,106,65,0,12,106,65,698,97,76,45,622,95,14370
15000US060670070103,518,100,0,12,0,12,0,12,518,100,53,36,465,101,14371
15000US060670070111,1096,177,228,109,114,71,114,93,868,168,78,54,790,157,14372
15000US060670070112,361,114,92,86,20,29,72,77,269,92,13,21,256,92,14373
15000US060670070113,700,157,66,67,0,12,66,67,634,150,128,67,506,145,14374
15000US060670070114,288,100,93,87,37,59,56,67,195,88,82,76,113,63,14375
15000US060670070121,771,82,75,53,18,19,57,48,696,89,174,70,522,102,14376
15000US060670070122,608,94,135,67,11,17,124,65,473,83,123,62,350,81,14377
15000US060670070131,451,54,56,33,29,27,27,23,395,54,107,39,288,57,14378
15000US060670070132,592,59,84,45,11,13,73,44,508,60,110,35,398,63,14379
15000US060670070141,382,68,23,37,0,12,23,37,359,66,85,42,274,63,14380
15000US060670070142,921,138,79,64,10,16,69,61,842,142,111,73,731,134,14381
15000US060670070143,911,145,243,131,54,54,189,119,668,138,212,97,456,132,14382
15000US060670070144,487,124,27,34,11,21,16,27,460,124,101,75,359,125,14383
15000US060670070151,1364,173,156,94,14,24,142,90,1208,179,270,111,938,169,14384
15000US060670070152,649,132,55,46,22,27,33,34,594,124,95,59,499,128,14385
15000US060670070161,799,98,83,57,25,26,58,51,716,111,83,41,633,110,14386
15000US060670070162,1044,105,180,98,0,12,180,98,864,124,211,73,653,119,14387
15000US060670070171,397,81,0,12,0,12,0,12,397,81,64,41,333,88,14388
15000US060670070172,699,76,95,59,24,31,71,53,604,78,50,34,554,80,14389
15000US060670070181,1024,169,44,42,10,16,34,39,980,174,61,63,919,190,14390
15000US060670070182,1203,138,36,42,6,21,30,35,1167,140,343,76,824,147,14391
15000US060670070191,432,18,114,46,42,34,72,33,318,46,72,45,246,63,14392
15000US060670070201,1057,86,0,12,0,12,0,12,1057,86,176,70,881,102,14393
15000US060670070202,655,92,26,30,0,12,26,30,629,94,24,20,605,94,14394
15000US060670071011,120,49,8,9,0,12,8,9,112,53,15,18,97,52,14395
15000US060670071021,0,12,0,12,0,12,0,12,0,12,0,12,0,12,14396
15000US060670071022,1255,118,118,94,26,28,92,89,1137,112,85,54,1052,120,14397
15000US060670071023,745,111,0,12,0,12,0,12,745,111,144,75,601,122,14398
15000US060670071024,1092,128,53,45,40,40,13,20,1039,132,358,128,681,128,14399
15000US060670071031,938,114,34,33,10,15,24,28,904,114,134,58,770,109,14400
15000US060670071032,704,93,62,67,0,12,62,67,642,95,62,34,580,96,14401
15000US060670071041,1762,135,223,123,0,17,223,123,1539,151,176,89,1363,177,14402
15000US060670071042,805,127,66,64,49,56,17,30,739,124,50,48,689,120,14403
15000US060670071051,1005,121,170,97,78,80,92,64,835,144,190,102,645,133,14404
15000US060670071052,799,131,42,42,29,36,13,20,757,135,52,44,705,138,14405
15000US060670071053,448,107,38,41,15,24,23,33,410,112,27,32,383,116,14406
15000US060670071061,406,116,55,70,0,12,55,70,351,105,35,34,316,111,14407
15000US060670071062,1033,156,86,52,72,56,14,23,947,152,122,91,825,148,14408
15000US060670071063,579,128,23,28,0,12,23,28,556,126,63,45,493,132,14409
15000US060670071064,346,84,0,12,0,12,0,12,346,84,104,66,242,91,14410
15000US060670071071,305,75,0,12,0,12,0,12,305,75,42,38,263,72,14411
15000US060670071072,949,88,9,14,0,12,9,14,940,90,199,68,741,103,14412
15000US060670072021,495,96,89,56,43,42,46,54,406,97,142,48,264,91,14413
15000US060670072022,501,93,67,47,29,27,38,36,434,101,169,66,265,104,14414
15000US060670072023,275,75,53,39,23,26,30,30,222,80,64,39,158,80,14415
15000US060670072041,844,89,54,33,41,29,13,14,790,96,141,54,649,109,14416
15000US060670072042,614,92,20,18,20,18,0,12,594,94,181,63,413,97,14417
15000US060670072061,503,82,77,56,24,35,53,50,426,70,109,37,317,71,14418
15000US060670072062,798,87,58,34,38,28,20,19,740,92,148,44,592,99,14419
15000US060670072071,420,82,42,34,27,30,15,17,378,84,92,39,286,81,14420
15000US060670072072,479,90,23,26,11,18,12,19,456,92,155,59,301,80,14421
15000US060670072073,449,85,51,36,9,13,42,33,398,83,92,41,306,83,14422
15000US060670072081,283,73,33,40,23,37,10,17,250,72,48,25,202,75,14423
15000US060670072082,617,109,103,69,21,25,82,65,514,91,109,51,405,85,14424
15000US060670072083,517,120,96,52,52,39,44,39,421,120,76,37,345,119,14425
15000US060670072091,543,73,73,46,58,43,15,17,470,80,186,70,284,72,14426
15000US060670072092,667,75,68,36,40,27,28,26,599,77,219,70,380,87,14427
15000US060670073011,991,82,218,81,82,49,136,68,773,85,158,64,615,106,14428
15000US060670073012,393,74,78,47,38,25,40,39,315,75,108,58,207,71,14429
15000US060670073013,301,90,99,48,59,29,40,47,202,66,41,22,161,66,14430
15000US060670074021,618,108,135,64,78,54,57,45,483,106,113,44,370,117,14431
15000US060670074022,703,111,61,40,41,32,20,24,642,109,223,73,419,119,14432
15000US060670074023,377,86,98,51,33,24,65,45,279,80,107,61,172,64,14433
15000US060670074024,356,83,104,73,15,18,89,71,252,65,64,44,188,60,14434
15000US060670074031,581,94,148,67,29,26,119,70,433,85,150,53,283,81,14435
15000US060670074032,712,110,138,81,51,37,87,70,574,112,253,62,321,99,14436
15000US060670074061,687,116,112,97,0,12,112,97,575,108,199,83,376,110,14437
15000US060670074062,630,153,181,120,12,19,169,119,449,147,145,78,304,136,14438
15000US060670074063,880,164,193,117,19,32,174,116,687,157,267,104,420,145,14439
15000US060670074064,388,129,124,118,18,32,106,119,264,110,104,90,160,74,14440
15000US060670074131,702,137,277,125,73,59,204,116,425,135,203,100,222,106,14441
15000US060670074132,1013,189,308,120,79,57,229,114,705,167,302,115,403,173,14442
15000US060670074133,505,122,113,88,52,43,61,74,392,102,130,88,262,102,14443
15000US060670074141,760,96,123,70,24,18,99,66,637,106,167,67,470,109,14444
15000US060670074142,682,88,187,70,54,34,133,61,495,97,98,59,397,99,14445
15000US060670074151,396,56,25,24,6,10,19,22,371,61,139,43,232,55,14446
15000US060670074152,734,73,174,81,77,55,97,73,560,92,204,65,356,86,14447
15000US060670074161,825,107,62,39,35,30,27,32,763,112,191,65,572,119,14448
15000US060670074162,680,95,146,82,58,54,88,66,534,95,157,61,377,94,14449
15000US060670074171,280,44,33,22,16,17,17,14,247,47,60,30,187,48,14450
15000US060670074172,628,56,103,41,40,31,63,30,525,66,148,48,377,79,14451
15000US060670074211,734,105,28,44,28,44,0,12,706,102,230,92,476,122,14452
15000US060670074212,1265,172,89,75,72,70,17,27,1176,164,139,74,1037,180,14453
15000US060670074213,658,133,53,49,14,22,39,44,605,138,45,43,560,141,14454
15000US060670074221,504,61,89,49,23,21,66,45,415,61,90,38,325,71,14455
15000US060670074222,343,64,77,39,24,26,53,31,266,63,34,29,232,62,14456
15000US060670074231,799,122,315,82,89,52,226,67,484,107,102,48,382,105,14457
15000US060670074232,1024,108,462,108,144,86,318,95,562,105,89,45,473,100,14458
15000US060670074241,728,113,340,122,73,50,267,121,388,102,96,44,292,98,14459
15000US060670074242,520,89,116,71,5,8,111,70,404,87,138,50,266,86,14460
15000US060670074261,394,61,67,39,12,13,55,37,327,61,120,49,207,63,14461
15000US060670074262,350,56,49,37,27,36,22,17,301,58,34,26,267,62,14462
15000US060670074271,448,140,40,40,40,40,0,12,408,146,78,68,330,129,14463
15000US060670074272,567,124,51,57,51,57,0,12,516,130,128,90,388,121,14464
15000US060670074273,1201,156,208,134,110,93,98,96,993,180,273,107,720,171,14465
15000US060670074281,602,77,35,24,10,16,25,18,567,76,156,66,411,91,14466
15000US060670074282,680,81,84,81,50,49,34,47,596,90,133,56,463,96,14467
15000US060670074291,679,123,192,79,90,65,102,52,487,103,109,52,378,100,14468
15000US060670074292,450,104,92,95,0,12,92,95,358,89,104,65,254,91,14469
15000US060670074293,604,122,121,80,37,36,84,69,483,105,124,52,359,100,14470
15000US060670074301,537,108,29,36,0,12,29,36,508,108,110,70,398,112,14471
15000US060670074302,874,163,16,25,16,25,0,12,858,165,304,127,554,157,14472
15000US060670074303,1067,168,384,168,128,124,256,152,683,171,130,74,553,167,14473
15000US060670074311,496,84,10,13,10,13,0,12,486,86,122,58,364,97,14474
15000US060670074312,540,90,19,18,5,9,14,17,521,89,90,48,431,92,14475
15000US060670074321,688,109,88,51,35,30,53,36,600,103,129,57,471,110,14476
15000US060670074322,819,87,47,45,7,14,40,43,772,94,134,62,638,83,14477
15000US060670074331,736,151,92,96,0,12,92,96,644,138,247,130,397,116,14478
15000US060670074332,850,163,129,85,45,52,84,66,721,155,92,65,629,146,14479
15000US060670074333,1012,176,66,47,17,27,49,45,946,181,137,88,809,191,14480
15000US060670075011,460,120,47,56,15,26,32,50,413,125,148,64,265,96,14481
15000US060670075012,366,124,84,94,11,17,73,93,282,93,24,28,258,95,14482
15000US060670075013,224,66,0,12,0,12,0,12,224,66,104,68,120,55,14483
15000US060670075014,668,150,134,100,67,84,67,53,534,133,182,94,352,141,14484
15000US060670075015,675,142,133,80,43,40,90,75,542,133,127,66,415,130,14485
15000US060670075031,314,124,54,70,9,16,45,69,260,104,62,57,198,110,14486
15000US060670075032,986,149,209,109,129,98,80,73,777,165,120,79,657,173,14487
15000US060670075033,250,92,71,64,19,30,52,60,179,86,14,22,165,86,14488
15000US060670075034,479,123,121,64,84,53,37,42,358,135,49,54,309,119,14489
15000US060670075041,296,48,30,20,11,12,19,17,266,44,55,27,211,42,14490
15000US060670075042,493,64,97,49,8,12,89,47,396,66,97,42,299,63,14491
15000US060670076011,578,110,39,44,0,12,39,44,539,107,44,35,495,108,14492
15000US060670076012,710,126,190,95,11,18,179,94,520,112,81,37,439,117,14493
15000US060670076013,904,157,117,89,43,69,74,56,787,147,262,123,525,165,14494
15000US060670076014,593,95,59,73,19,29,40,67,534,95,118,60,416,89,14495
15000US060670076021,459,88,14,17,0,12,14,17,445,87,130,73,315,82,14496
15000US060670076022,575,105,33,41,0,12,33,41,542,110,177,94,365,97,14497
15000US060670076023,636,98,34,30,8,13,26,28,602,106,125,69,477,114,14498
15000US060670076024,359,88,55,50,0,12,55,50,304,80,92,44,212,81,14499
15000US060670077011,424,85,15,25,0,12,15,25,409,86,106,67,303,100,14500
15000US060670077012,664,135,99,85,34,28,65,81,565,126,104,71,461,122,14501
15000US060670077013,306,114,68,52,50,47,18,27,238,114,38,44,200,112,14502
15000US060670077014,342,127,47,77,0,12,47,77,295,111,75,58,220,101,14503
15000US060670077015,728,133,105,58,18,28,87,57,623,128,125,78,498,139,14504
15000US060670077021,947,99,81,64,67,65,14,13,866,101,270,85,596,108,14505
15000US060670077022,356,89,53,50,0,12,53,50,303,87,192,78,111,45,14506
15000US060670077023,598,77,34,25,0,12,34,25,564,74,101,47,463,77,14507
15000US060670078011,743,187,213,137,101,94,112,112,530,145,153,84,377,153,14508
15000US060670078012,635,115,133,76,92,84,41,34,502,111,106,65,396,116,14509
15000US060670078013,491,138,0,12,0,12,0,12,491,138,214,117,277,87,14510
15000US060670078014,578,121,25,32,25,32,0,12,553,123,189,119,364,116,14511
15000US060670078021,375,102,44,40,11,17,33,37,331,97,84,50,247,99,14512
15000US060670078022,409,89,15,25,15,25,0,12,394,90,134,79,260,102,14513
15000US060670078023,864,144,104,92,86,86,18,28,760,177,255,139,505,181,14514
15000US060670078024,253,68,0,12,0,12,0,12,253,68,53,39,200,67,14515
15000US060670079031,280,63,0,12,0,12,0,12,280,63,130,64,150,56,14516
15000US060670079032,387,78,22,28,22,28,0,12,365,82,60,35,305,90,14517
15000US060670079033,215,59,0,12,0,12,0,12,215,59,46,34,169,58,14518
15000US060670079034,552,99,78,50,53,44,25,27,474,93,207,68,267,86,14519
15000US060670079035,410,109,40,61,0,12,40,61,370,89,118,46,252,90,14520
15000US060670079041,669,89,75,47,51,44,24,25,594,82,101,43,493,93,14521
15000US060670079042,535,70,0,12,0,12,0,12,535,70,125,63,410,76,14522
15000US060670079043,433,76,11,16,0,12,11,16,422,76,115,38,307,81,14523
15000US060670079044,293,55,10,16,0,12,10,16,283,57,82,36,201,59,14524
15000US060670079051,906,81,72,43,29,25,43,33,834,90,223,84,611,95,14525
15000US060670079052,870,88,55,38,9,15,46,35,815,87,184,65,631,94,14526
15000US060670079061,1070,78,110,69,56,48,54,51,960,79,245,62,715,85,14527
15000US060670079062,546,74,56,35,47,33,9,13,490,77,140,70,350,88,14528
15000US060670080051,369,57,0,12,0,12,0,12,369,57,84,40,285,63,14529
15000US060670080052,860,84,33,29,33,29,0,12,827,94,231,77,596,101,14530
15000US060670080053,534,82,21,34,21,34,0,12,513,81,103,48,410,85,14531
15000US060670080061,755,91,64,54,22,27,42,47,691,99,262,79,429,104,14532
15000US060670080062,406,80,0,12,0,12,0,12,406,80,92,63,314,91,14533
15000US060670080063,710,113,12,19,0,12,12,19,698,115,105,60,593,108,14534
15000US060670080064,466,97,36,42,16,26,20,31,430,101,57,48,373,99,14535
15000US060670080071,688,101,17,14,8,13,9,15,671,104,56,27,615,104,14536
15000US060670080072,782,121,108,63,33,50,75,43,674,116,160,63,514,112,14537
15000US060670080081,618,77,33,26,33,26,0,12,585,83,153,48,432,93,14538
15000US060670080082,525,76,0,12,0,12,0,12,525,76,72,40,453,88,14539
15000US060670080083,741,76,20,23,0,12,20,23,721,84,117,49,604,89,14540
15000US060670080091,373,46,15,18,9,14,6,10,358,47,92,35,266,55,14541
15000US060670080092,365,72,0,12,0,12,0,12,365,72,81,37,284,74,14542
15000US060670080093,650,82,151,68,9,14,142,67,499,85,85,44,414,88,14543
15000US060670080094,489,80,9,14,0,12,9,14,480,78,63,39,417,75,14544
15000US060670080101,372,122,60,66,38,55,22,33,312,110,47,42,265,111,14545
15000US060670080102,613,124,15,23,0,12,15,23,598,124,142,73,456,103,14546
15000US060670080103,489,88,14,25,0,12,14,25,475,87,87,63,388,105,14547
15000US060670080104,500,107,61,61,8,15,53,59,439,120,63,40,376,122,14548
15000US060670081111,633,115,14,25,14,25,0,12,619,117,161,110,458,110,14549
15000US060670081112,643,111,88,72,42,39,46,59,555,107,250,102,305,86,14550
15000US060670081113,625,113,88,87,0,12,88,87,537,113,218,108,319,114,14551
15000US060670081114,462,103,21,31,0,12,21,31,441,108,225,89,216,102,14552
15000US060670081131,1070,89,203,79,121,66,82,43,867,97,248,82,619,104,14553
15000US060670081132,405,81,8,15,8,15,0,12,397,84,108,53,289,83,14554
15000US060670081171,277,47,6,9,6,9,0,12,271,45,67,33,204,44,14555
15000US060670081172,490,68,50,42,50,42,0,12,440,75,109,49,331,63,14556
15000US060670081191,531,118,196,105,152,97,44,49,335,120,68,67,267,104,14557
15000US060670081192,536,95,41,41,41,41,0,12,495,105,185,81,310,101,14558
15000US060670081193,341,100,19,30,0,12,19,30,322,99,19,30,303,96,14559
15000US060670081194,336,97,14,23,0,12,14,23,322,95,124,66,198,95,14560
15000US060670081195,391,89,0,12,0,12,0,12,391,89,171,79,220,89,14561
15000US060670081201,702,108,36,37,36,37,0,12,666,105,260,103,406,91,14562
15000US060670081202,524,99,16,26,16,26,0,12,508,97,192,86,316,76,14563
15000US060670081203,760,113,114,76,51,48,63,58,646,130,50,31,596,133,14564
15000US060670081221,337,78,0,12,0,12,0,12,337,78,75,53,262,66,14565
15000US060670081222,723,88,49,60,0,12,49,60,674,94,134,50,540,85,14566
15000US060670081223,351,59,16,18,16,18,0,12,335,62,69,40,266,64,14567
15000US060670081241,1017,88,24,22,9,13,15,18,993,90,222,86,771,112,14568
15000US060670081242,638,87,16,18,7,12,9,14,622,88,181,71,441,94,14569
15000US060670081251,1046,149,130,106,118,104,12,20,916,156,250,135,666,150,14570
15000US060670081252,327,97,31,39,31,39,0,12,296,97,76,55,220,88,14571
15000US060670081253,616,105,30,34,12,19,18,28,586,114,82,56,504,113,14572
15000US060670081271,712,97,74,46,43,38,31,29,638,106,96,51,542,103,14573
15000US060670081272,1034,88,213,92,50,38,163,81,821,101,169,69,652,92,14574
15000US060670081281,477,55,26,18,20,15,6,10,451,56,186,44,265,56,14575
15000US060670081282,448,51,15,14,15,14,0,12,433,51,114,39,319,51,14576
15000US060670081291,537,72,22,21,15,18,7,11,515,73,213,62,302,71,14577
15000US060670081292,701,82,15,18,15,18,0,12,686,83,195,75,491,89,14578
15000US060670081301,431,80,123,65,16,17,107,63,308,88,116,50,192,82,14579
15000US060670081302,517,87,58,43,30,30,28,24,459,94,126,57,333,93,14580
15000US060670081303,373,88,32,37,0,12,32,37,341,87,38,33,303,83,14581
15000US060670081311,415,100,19,23,0,12,19,23,396,101,87,73,309,102,14582
15000US060670081312,687,118,13,20,13,20,0,12,674,117,242,79,432,133,14583
15000US060670081313,449,102,74,64,50,58,24,27,375,105,78,62,297,116,14584
15000US060670081314,648,127,115,82,105,80,10,16,533,122,178,91,355,122,14585
15000US060670081321,839,83,17,19,8,13,9,14,822,88,278,87,544,91,14586
15000US060670081322,654,81,72,53,44,44,28,29,582,90,181,68,401,90,14587
15000US060670081331,747,88,123,60,33,30,90,51,624,108,302,98,322,84,14588
15000US060670081332,493,82,113,54,64,39,49,34,380,81,114,51,266,76,14589
15000US060670081341,513,89,21,22,15,20,6,10,492,90,181,79,311,77,14590
15000US060670081342,682,118,94,68,46,59,48,39,588,110,190,81,398,93,14591
15000US060670081343,656,124,60,36,0,12,60,36,596,118,186,83,410,103,14592
15000US060670081351,590,105,82,83,0,12,82,83,508,97,221,86,287,88,14593
15000US060670081352,588,131,85,62,16,24,69,63,503,140,15,23,488,142,14594
15000US060670081353,428,81,9,18,0,12,9,18,419,83,114,60,305,93,14595
15000US060670081354,540,105,15,24,15,24,0,12,525,111,179,75,346,104,14596
15000US060670081361,340,64,19,22,0,12,19,22,321,63,71,35,250,65,14597
15000US060670081362,754,70,31,29,22,25,9,14,723,74,118,58,605,82,14598
15000US060670081371,549,53,64,29,17,15,47,25,485,57,192,62,293,56,14599
15000US060670081372,434,52,21,17,11,12,10,11,413,51,118,46,295,53,14600
15000US060670081381,359,76,77,39,42,35,35,29,282,81,36,23,246,82,14601
15000US060670081382,621,89,85,62,0,12,85,62,536,100,151,68,385,105,14602
15000US060670081383,407,57,16,18,9,13,7,11,391,61,115,55,276,66,14603
15000US060670081391,829,94,146,60,75,51,71,45,683,95,236,71,447,93,14604
15000US060670081392,864,104,40,36,13,20,27,29,824,106,231,73,593,105,14605
15000US060670081401,470,89,12,19,12,19,0,12,458,89,126,59,332,77,14606
15000US060670081402,631,97,16,20,7,11,9,16,615,98,204,79,411,93,14607
15000US060670081411,302,78,0,12,0,12,0,12,302,78,83,53,219,74,14608
15000US060670081412,422,107,53,54,44,53,9,15,369,115,131,62,238,105,14609
15000US060670081413,278,107,98,77,16,27,82,78,180,90,56,65,124,67,14610
15000US060670081414,604,163,214,123,12,21,202,121,390,142,64,67,326,128,14611
15000US060670081415,1022,190,250,122,87,75,163,102,772,206,199,129,573,195,14612
15000US060670081421,894,85,134,62,31,31,103,55,760,92,158,57,602,108,14613
15000US060670081422,525,73,108,55,67,46,41,37,417,70,127,56,290,68,14614
15000US060670081431,1032,102,149,64,39,31,110,61,883,109,119,57,764,111,14615
15000US060670081432,627,89,60,51,8,13,52,49,567,97,176,69,391,97,14616
15000US060670081441,244,35,31,27,27,26,4,8,213,31,54,21,159,37,14617
15000US060670081442,681,46,39,22,10,12,29,21,642,53,144,50,498,67,14618
15000US060670081451,547,110,32,35,15,23,17,26,515,116,103,76,412,100,14619
15000US060670081452,605,128,120,108,35,41,85,99,485,117,135,87,350,91,14620
15000US060670081453,301,81,0,12,0,12,0,12,301,81,72,49,229,87,14621
15000US060670081454,447,104,44,37,25,24,19,30,403,108,83,53,320,110,14622
15000US060670081455,416,98,14,23,0,12,14,23,402,101,16,27,386,102,14623
15000US060670081456,345,115,0,12,0,12,0,12,345,115,39,36,306,115,14624
15000US060670082031,752,106,126,85,55,70,71,62,626,110,215,72,411,96,14625
15000US060670082032,1081,98,91,60,49,49,42,38,990,97,341,78,649,97,14626
15000US060670082041,909,103,43,38,0,12,43,38,866,105,243,91,623,84,14627
15000US060670082042,770,86,56,37,35,30,21,24,714,92,240,91,474,90,14628
15000US060670082061,460,99,31,47,31,47,0,12,429,106,110,97,319,114,14629
15000US060670082062,968,110,34,52,34,52,0,12,934,120,194,84,740,126,14630
15000US060670082063,827,118,52,61,0,12,52,61,775,124,205,80,570,116,14631
15000US060670082071,344,77,42,46,0,12,42,46,302,76,61,41,241,78,14632
15000US060670082072,248,48,10,15,0,12,10,15,238,48,69,38,169,43,14633
15000US060670082073,319,66,58,53,50,54,8,13,261,61,91,45,170,58,14634
15000US060670082074,302,67,0,12,0,12,0,12,302,67,121,64,181,52,14635
15000US060670082075,508,63,0,12,0,12,0,12,508,63,186,56,322,53,14636
15000US060670082081,290,62,25,23,0,12,25,23,265,66,67,33,198,60,14637
15000US060670082082,404,76,37,43,28,41,9,14,367,67,86,52,281,71,14638
15000US060670082083,606,95,36,48,29,46,7,11,570,93,200,88,370,81,14639
15000US060670082084,565,98,122,66,73,57,49,50,443,91,133,64,310,84,14640
15000US060670082091,878,89,76,57,0,12,76,57,802,86,153,59,649,91,14641
15000US060670082092,927,94,8,14,8,14,0,12,919,97,188,84,731,98,14642
15000US060670082101,1010,127,0,12,0,12,0,12,1010,127,149,91,861,123,14643
15000US060670082102,969,146,31,34,17,26,14,23,938,146,295,111,643,164,14644
15000US060670082103,631,118,0,12,0,12,0,12,631,118,230,103,401,117,14645
15000US060670082111,594,87,7,11,0,12,7,11,587,87,182,66,405,87,14646
15000US060670082112,381,64,19,22,0,12,19,22,362,65,32,27,330,74,14647
15000US060670084021,429,88,0,12,0,12,0,12,429,88,120,57,309,89,14648
15000US060670084022,703,132,0,12,0,12,0,12,703,132,220,102,483,148,14649
15000US060670084023,940,141,66,87,0,12,66,87,874,158,108,88,766,159,14650
15000US060670084031,798,127,14,22,0,12,14,22,784,130,102,76,682,134,14651
15000US060670084032,846,111,0,12,0,12,0,12,846,111,153,73,693,122,14652
15000US060670084033,694,110,0,12,0,12,0,12,694,110,208,106,486,104,14653
15000US060670084041,298,77,11,18,0,12,11,18,287,78,28,27,259,79,14654
15000US060670084042,490,91,31,32,23,26,8,15,459,90,63,42,396,95,14655
15000US060670084043,625,86,103,50,11,17,92,48,522,79,140,69,382,103,14656
15000US060670085011,857,132,69,95,0,12,69,95,788,126,57,38,731,131,14657
15000US060670085012,834,100,19,32,0,12,19,32,815,102,39,34,776,107,14658
15000US060670085013,609,101,0,12,0,12,0,12,609,101,131,69,478,105,14659
15000US060670085041,399,69,27,41,0,12,27,41,372,67,25,23,347,71,14660
15000US060670085042,984,74,6,10,6,10,0,12,978,73,96,40,882,73,14661
15000US060670085043,336,62,28,25,18,19,10,16,308,63,34,23,274,62,14662
15000US060670085051,313,39,0,12,0,12,0,12,313,39,61,28,252,44,14663
15000US060670085052,444,39,0,12,0,12,0,12,444,39,107,44,337,51,14664
15000US060670085061,1015,104,52,49,0,12,52,49,963,106,113,53,850,115,14665
15000US060670085062,478,91,11,17,11,17,0,12,467,90,183,57,284,80,14666
15000US060670085071,760,84,0,12,0,12,0,12,760,84,158,64,602,109,14667
15000US060670085072,833,97,19,25,0,12,19,25,814,102,103,46,711,103,14668
15000US060670085081,827,119,0,12,0,12,0,12,827,119,62,43,765,124,14669
15000US060670085082,738,120,0,12,0,12,0,12,738,120,120,97,618,123,14670
15000US060670085083,1012,120,0,12,0,12,0,12,1012,120,169,81,843,119,14671
15000US060670085091,1004,76,0,12,0,12,0,12,1004,76,126,61,878,84,14672
15000US060670085092,462,62,0,12,0,12,0,12,462,62,53,45,409,54,14673
15000US060670085101,964,60,0,12,0,12,0,12,964,60,155,55,809,76,14674
15000US060670085102,619,64,0,12,0,12,0,12,619,64,134,58,485,88,14675
15000US060670085121,816,64,9,14,9,14,0,12,807,66,71,42,736,64,14676
15000US060670085122,561,60,0,12,0,12,0,12,561,60,37,30,524,64,14677
15000US060670085131,779,61,12,16,0,12,12,16,767,60,55,31,712,61,14678
15000US060670085132,348,55,0,12,0,12,0,12,348,55,40,31,308,55,14679
15000US060670086001,457,96,0,12,0,12,0,12,457,96,140,63,317,93,14680
15000US060670086002,1029,121,15,23,15,23,0,12,1014,119,240,80,774,131,14681
15000US060670086003,1053,136,0,12,0,12,0,12,1053,136,190,99,863,134,14682
15000US060670086004,260,84,17,26,0,12,17,26,243,89,74,61,169,63,14683
15000US060670087021,660,65,0,12,0,12,0,12,660,65,83,49,577,76,14684
15000US060670087022,545,58,0,12,0,12,0,12,545,58,132,48,413,63,14685
15000US060670087031,710,95,0,12,0,12,0,12,710,95,243,87,467,108,14686
15000US060670087032,319,68,0,12,0,12,0,12,319,68,80,53,239,64,14687
15000US060670087033,1100,113,48,36,36,36,12,20,1052,116,250,99,802,122,14688
15000US060670087041,532,52,47,30,11,12,36,27,485,54,60,30,425,57,14689
15000US060670087042,480,44,3,5,3,5,0,12,477,44,50,32,427,47,14690
15000US060670087051,1273,114,52,51,9,14,43,49,1221,119,214,87,1007,154,14691
15000US060670087052,697,88,9,14,0,12,9,14,688,91,151,69,537,103,14692
15000US060670088011,388,100,158,84,15,20,143,82,230,72,12,19,218,72,14693
15000US060670088012,957,73,74,43,61,40,13,21,883,80,185,53,698,93,14694
15000US060670089051,503,92,46,60,0,12,46,60,457,79,161,64,296,90,14695
15000US060670089052,554,79,36,28,0,12,36,28,518,86,188,71,330,80,14696
15000US060670089053,626,106,132,80,21,24,111,77,494,125,78,47,416,127,14697
15000US060670089071,500,102,21,22,0,12,21,22,479,98,181,76,298,84,14698
15000US060670089072,675,98,119,67,59,47,60,49,556,115,181,77,375,111,14699
15000US060670089073,367,79,70,39,41,29,29,28,297,78,89,38,208,79,14700
15000US060670089074,363,77,45,34,36,30,9,14,318,72,174,58,144,72,14701
15000US060670089081,1002,103,193,97,36,37,157,105,809,129,304,93,505,134,14702
15000US060670089082,590,83,90,38,35,27,55,29,500,85,168,65,332,78,14703
15000US060670089083,439,83,20,22,20,22,0,12,419,82,219,66,200,67,14704
15000US060670089091,560,66,119,52,58,42,61,39,441,62,105,41,336,64,14705
15000US060670089092,309,63,76,54,50,43,26,36,233,64,57,28,176,64,14706
15000US060670089101,524,81,27,25,0,12,27,25,497,84,107,54,390,90,14707
15000US060670089102,749,82,192,79,77,56,115,59,557,110,164,63,393,101,14708
15000US060670089111,287,31,34,24,8,11,26,21,253,35,88,32,165,36,14709
15000US060670089112,507,55,150,51,29,25,121,44,357,60,108,47,249,61,14710
15000US060670089121,352,75,46,40,0,12,46,40,306,78,78,38,228,78,14711
15000US060670089122,528,75,35,27,20,18,15,24,493,78,90,41,403,81,14712
15000US060670089123,314,45,18,20,9,13,9,14,296,46,64,29,232,51,14713
15000US060670089131,366,71,77,55,32,36,45,57,289,62,102,50,187,65,14714
15000US060670089132,360,61,15,17,0,12,15,17,345,61,90,39,255,62,14715
15000US060670089133,853,97,148,82,59,42,89,70,705,100,177,70,528,100,14716
15000US060670090041,720,93,28,25,19,24,9,13,692,98,177,58,515,109,14717
15000US060670090042,448,84,116,66,26,28,90,64,332,66,126,50,206,73,14718
15000US060670090051,917,76,112,43,63,43,49,32,805,92,268,87,537,91,14719
15000US060670090052,286,63,31,24,9,14,22,25,255,60,57,36,198,65,14720
15000US060670090061,846,115,179,92,72,59,107,70,667,104,228,79,439,89,14721
15000US060670090062,818,94,155,74,44,28,111,68,663,111,189,66,474,109,14722
15000US060670090063,239,86,61,55,12,18,49,51,178,83,43,43,135,72,14723
15000US060670090071,463,84,68,45,13,20,55,40,395,83,116,55,279,84,14724
15000US060670090072,647,77,168,70,38,31,130,68,479,76,115,54,364,70,14725
15000US060670090081,465,97,111,72,43,39,68,59,354,94,146,53,208,86,14726
15000US060670090082,570,121,76,59,38,48,38,34,494,102,202,83,292,90,14727
15000US060670090083,632,99,257,85,30,30,227,88,375,90,125,55,250,89,14728
15000US060670090101,1173,162,123,129,0,12,123,129,1050,155,118,86,932,154,14729
15000US060670090102,550,141,26,32,15,25,11,20,524,141,40,35,484,139,14730
15000US060670090103,531,146,47,43,30,35,17,26,484,146,102,77,382,146,14731
15000US060670090111,717,72,13,15,6,9,7,11,704,73,140,47,564,81,14732
15000US060670090112,571,70,23,35,0,12,23,35,548,74,56,35,492,80,14733
15000US060670091031,648,89,40,35,23,33,17,20,608,93,203,69,405,89,14734
15000US060670091032,482,90,53,34,0,12,53,34,429,88,85,54,344,83,14735
15000US060670091051,421,99,105,55,34,34,71,55,316,100,61,53,255,87,14736
15000US060670091052,247,72,11,19,0,12,11,19,236,71,56,43,180,62,14737
15000US060670091053,239,65,47,34,30,27,17,21,192,50,96,50,96,37,14738
15000US060670091061,914,112,44,36,22,24,22,26,870,118,138,74,732,119,14739
15000US060670091062,504,74,19,22,19,22,0,12,485,78,142,60,343,70,14740
15000US060670091063,434,89,72,42,0,12,72,42,362,84,55,50,307,65,14741
15000US060670091071,354,68,20,23,11,17,9,15,334,67,87,44,247,69,14742
15000US060670091072,878,86,27,25,14,19,13,16,851,89,144,63,707,85,14743
15000US060670091081,491,59,38,40,0,12,38,40,453,63,136,51,317,70,14744
15000US060670091082,434,49,43,32,23,25,20,22,391,55,128,46,263,57,14745
15000US060670091083,516,65,15,18,0,12,15,18,501,64,155,70,346,72,14746
15000US060670091091,293,49,9,13,9,13,0,12,284,47,98,44,186,50,14747
15000US060670091092,537,83,18,29,18,29,0,12,519,84,168,60,351,77,14748
15000US060670091093,523,74,48,52,0,12,48,52,475,78,81,36,394,86,14749
15000US060670091094,337,75,0,12,0,12,0,12,337,75,44,29,293,81,14750
15000US060670091101,237,60,133,51,35,22,98,47,104,45,23,24,81,40,14751
15000US060670091102,442,70,107,40,15,18,92,38,335,61,51,27,284,61,14752
15000US060670091111,652,108,15,28,15,28,0,12,637,107,154,71,483,109,14753
15000US060670091112,726,158,24,31,0,12,24,31,702,163,135,72,567,163,14754
15000US060670091113,758,155,96,98,45,50,51,82,662,137,145,76,517,158,14755
15000US060670091121,731,88,101,66,0,12,101,66,630,80,103,44,527,76,14756
15000US060670091122,543,96,110,70,10,15,100,69,433,89,111,54,322,87,14757
15000US060670092011,305,60,18,16,12,14,6,9,287,60,104,45,183,65,14758
15000US060670092012,985,86,117,53,35,20,82,48,868,82,234,76,634,93,14759
15000US060670093071,639,99,118,66,63,51,55,47,521,104,188,82,333,85,14760
15000US060670093072,632,76,9,14,0,12,9,14,623,75,146,45,477,81,14761
15000US060670093073,522,74,10,15,0,12,10,15,512,76,141,51,371,90,14762
15000US060670093081,658,171,154,105,132,110,22,30,504,161,189,85,315,144,14763
15000US060670093082,920,158,19,31,19,31,0,12,901,158,325,141,576,152,14764
15000US060670093083,540,152,49,71,49,71,0,12,491,132,218,133,273,113,14765
15000US060670093091,654,49,5,8,0,12,5,8,649,50,293,43,356,52,14766
15000US060670093092,230,38,17,15,17,15,0,12,213,41,61,33,152,36,14767
15000US060670093101,579,146,104,79,43,65,61,44,475,140,127,76,348,133,14768
15000US060670093102,428,100,12,20,12,20,0,12,416,102,133,94,283,102,14769
15000US060670093103,501,116,0,12,0,12,0,12,501,116,79,73,422,89,14770
15000US060670093104,542,131,0,12,0,12,0,12,542,131,141,76,401,132,14771
15000US060670093105,487,116,95,80,37,48,58,64,392,126,89,76,303,116,14772
15000US060670093111,617,80,33,43,33,43,0,12,584,77,125,50,459,92,14773
15000US060670093112,1345,93,213,88,52,30,161,80,1132,121,220,79,912,132,14774
15000US060670093121,513,96,0,12,0,12,0,12,513,96,168,76,345,84,14775
15000US060670093122,1301,131,115,70,36,38,79,54,1186,144,164,77,1022,157,14776
15000US060670093123,218,83,10,17,0,12,10,17,208,81,67,44,141,79,14777
15000US060670093141,652,91,153,67,21,33,132,59,499,97,112,55,387,97,14778
15000US060670093142,697,81,32,25,19,19,13,20,665,82,170,57,495,90,14779
15000US060670093143,407,84,0,12,0,12,0,12,407,84,170,79,237,72,14780
15000US060670093161,818,83,126,59,62,48,64,51,692,91,93,63,599,95,14781
15000US060670093162,450,83,42,33,20,24,22,24,408,88,111,58,297,82,14782
15000US060670093171,775,94,138,70,17,19,121,66,637,110,198,79,439,102,14783
15000US060670093172,408,69,23,32,23,32,0,12,385,74,79,47,306,86,14784
15000US060670093173,601,108,0,12,0,12,0,12,601,108,127,69,474,108,14785
15000US060670093181,675,29,104,45,59,33,45,29,571,47,186,56,385,63,14786
15000US060670093191,714,92,99,71,59,65,40,37,615,96,164,79,451,109,14787
15000US060670093192,328,77,54,52,22,26,32,45,274,80,105,73,169,57,14788
15000US060670093193,216,69,56,49,0,12,56,49,160,62,63,40,97,64,14789
15000US060670093201,581,80,70,31,22,24,48,28,511,83,101,49,410,84,14790
15000US060670093202,526,75,74,43,26,25,48,33,452,86,97,55,355,78,14791
15000US060670093203,386,82,73,45,43,39,30,27,313,81,75,45,238,72,14792
15000US060670093211,601,90,89,55,39,29,50,47,512,89,171,60,341,82,14793
15000US060670093212,1035,92,149,69,75,55,74,47,886,103,166,72,720,102,14794
15000US060670093221,1103,158,158,100,76,74,82,74,945,158,293,111,652,149,14795
15000US060670093222,1207,137,55,58,16,25,39,54,1152,138,272,112,880,140,14796
15000US060670093223,691,106,9,16,9,16,0,12,682,105,122,69,560,114,14797
15000US060670093224,822,122,101,88,35,59,66,63,721,130,121,90,600,130,14798
15000US060670093231,839,91,17,21,7,13,10,16,822,90,166,70,656,98,14799
15000US060670093232,849,103,32,28,8,14,24,25,817,110,181,71,636,103,14800
15000US060670093241,333,47,9,10,5,8,4,6,324,49,92,30,232,45,14801
15000US060670093242,532,53,11,12,5,8,6,10,521,54,116,44,405,62,14802
15000US060670093251,323,16,3,6,0,12,3,6,320,18,48,29,272,36,14803
15000US060670093261,475,84,0,12,0,12,0,12,475,84,193,87,282,75,14804
15000US060670093262,369,81,0,12,0,12,0,12,369,81,43,28,326,84,14805
15000US060670093263,471,67,0,12,0,12,0,12,471,67,147,55,324,68,14806
15000US060670093281,187,64,31,47,0,12,31,47,156,53,17,19,139,50,14807
15000US060670093282,723,94,23,26,12,19,11,18,700,97,101,53,599,109,14808
15000US060670093283,425,94,0,12,0,12,0,12,425,94,100,55,325,101,14809
15000US060670093291,241,43,46,29,2,5,44,29,195,41,41,22,154,41,14810
15000US060670093292,425,56,50,27,23,18,27,21,375,61,41,33,334,63,14811
15000US060670093301,1108,43,32,29,9,13,23,26,1076,51,179,66,897,73,14812
15000US060670093311,575,93,26,31,26,31,0,12,549,105,166,71,383,99,14813
15000US060670093312,523,85,25,35,22,33,3,8,498,89,114,47,384,79,14814
15000US060670093313,958,97,46,52,18,27,28,42,912,103,211,89,701,110,14815
15000US060670093321,394,34,13,16,9,14,4,7,381,33,114,35,267,45,14816
15000US060670094031,666,51,43,37,5,9,38,36,623,57,152,38,471,58,14817
15000US060670094041,418,146,16,26,0,12,16,26,402,148,142,88,260,132,14818
15000US060670094042,656,155,0,12,0,12,0,12,656,155,123,81,533,155,14819
15000US060670094043,808,156,0,12,0,12,0,12,808,156,269,133,539,142,14820
15000US060670094061,375,57,6,9,0,12,6,9,369,57,75,34,294,58,14821
15000US060670094062,419,61,6,9,0,12,6,9,413,60,62,33,351,59,14822
15000US060670094071,948,162,92,84,15,25,77,81,856,180,253,114,603,184,14823
15000US060670094072,744,160,101,90,43,53,58,79,643,140,126,70,517,159,14824
15000US060670094073,1346,155,64,59,15,24,49,54,1282,162,278,112,1004,165,14825
15000US060670094081,469,67,22,21,12,15,10,14,447,68,129,35,318,72,14826
15000US060670095011,350,47,94,38,37,34,57,33,256,53,104,42,152,48,14827
15000US060670095012,438,49,75,40,37,32,38,29,363,48,106,38,257,48,14828
15000US060670095021,556,115,0,12,0,12,0,12,556,115,119,72,437,133,14829
15000US060670095022,883,176,171,103,0,12,171,103,712,151,225,131,487,144,14830
15000US060670095023,359,136,126,91,100,93,26,25,233,109,56,44,177,99,14831
15000US060670095024,585,129,59,61,7,14,52,66,526,135,92,68,434,142,14832
15000US060670095031,491,103,101,55,12,16,89,57,390,101,180,89,210,65,14833
15000US060670095032,287,72,54,47,7,10,47,45,233,69,103,51,130,61,14834
15000US060670095033,362,81,60,51,28,35,32,38,302,85,124,57,178,78,14835
15000US060670095041,702,61,166,64,79,42,87,50,536,82,163,52,373,82,14836
15000US060670096011,182,66,50,45,33,40,17,23,132,52,62,52,70,53,14837
15000US060670096012,739,106,105,54,66,48,39,34,634,119,160,66,474,118,14838
15000US060670096013,807,113,164,85,25,22,139,85,643,122,229,92,414,99,14839
15000US060670096061,481,149,156,109,0,12,156,109,325,127,108,83,217,114,14840
15000US060670096062,486,112,143,93,70,63,73,80,343,110,168,93,175,97,14841
15000US060670096063,996,160,118,78,61,60,57,59,878,151,368,143,510,158,14842
15000US060670096064,365,76,39,38,14,23,25,28,326,83,101,59,225,83,14843
15000US060670096081,596,150,133,89,22,32,111,85,463,135,98,65,365,134,14844
15000US060670096082,1570,171,253,127,168,110,85,71,1317,159,501,153,816,171,14845
15000US060670096091,914,102,56,36,29,25,27,25,858,101,285,96,573,112,14846
15000US060670096092,563,85,52,34,8,16,44,31,511,85,129,42,382,89,14847
15000US060670096101,512,103,96,49,21,19,75,46,416,113,77,49,339,108,14848
15000US060670096102,745,94,198,84,158,79,40,40,547,93,129,71,418,94,14849
15000US060670096103,518,94,56,35,7,12,49,31,462,92,75,42,387,96,14850
15000US060670096111,353,71,36,27,10,14,26,23,317,77,127,59,190,68,14851
15000US060670096112,725,82,29,26,10,16,19,21,696,82,201,65,495,83,14852
15000US060670096121,1444,110,146,63,56,41,90,52,1298,120,265,84,1033,127,14853
15000US060670096122,270,64,6,11,6,11,0,12,264,64,36,28,228,61,14854
15000US060670096141,1076,133,134,86,62,47,72,70,942,151,317,121,625,138,14855
15000US060670096142,782,129,71,86,0,12,71,86,711,140,108,86,603,138,14856
15000US060670096143,437,101,44,49,20,37,24,31,393,95,57,49,336,102,14857
15000US060670096151,417,106,31,38,31,38,0,12,386,109,148,105,238,86,14858
15000US060670096152,451,127,18,30,18,30,0,12,433,131,31,34,402,137,14859
15000US060670096153,716,113,21,36,21,36,0,12,695,113,82,64,613,114,14860
15000US060670096154,353,128,0,12,0,12,0,12,353,128,100,61,253,135,14861
15000US060670096155,800,159,0,12,0,12,0,12,800,159,140,102,660,157,14862
15000US060670096161,372,86,36,40,35,38,1,8,336,88,42,32,294,90,14863
15000US060670096162,293,73,20,32,0,12,20,32,273,78,52,49,221,77,14864
15000US060670096163,823,124,45,41,8,13,37,44,778,122,220,94,558,121,14865
15000US060670096164,475,92,10,16,0,12,10,16,465,93,49,42,416,94,14866
15000US060670096171,370,69,42,40,35,41,7,12,328,69,57,47,271,72,14867
15000US060670096172,978,64,11,17,0,12,11,17,967,67,212,64,755,84,14868
15000US060670096181,672,100,83,54,9,14,74,54,589,105,106,62,483,104,14869
15000US060670096182,858,101,34,30,7,10,27,28,824,103,294,75,530,113,14870
15000US060670096191,331,98,72,72,40,63,32,34,259,91,20,32,239,97,14871
15000US060670096192,1310,160,17,26,0,12,17,26,1293,163,267,103,1026,164,14872
15000US060670096193,1208,145,42,49,0,12,42,49,1166,150,373,117,793,164,14873
15000US060670096221,412,124,0,12,0,12,0,12,412,124,11,19,401,126,14874
15000US060670096222,1291,118,26,29,0,12,26,29,1265,120,380,114,885,145,14875
15000US060670096223,667,147,0,12,0,12,0,12,667,147,102,58,565,158,14876
15000US060670096224,313,99,0,12,0,12,0,12,313,99,12,18,301,103,14877
15000US060670096301,1283,159,92,58,49,47,43,41,1191,172,295,132,896,155,14878
15000US060670096302,717,128,21,33,21,33,0,12,696,127,180,100,516,133,14879
15000US060670096303,363,107,59,74,11,18,48,70,304,81,57,57,247,79,14880
15000US060670096304,539,119,51,59,28,46,23,36,488,122,100,76,388,108,14881
15000US060670096321,381,70,18,29,0,12,18,29,363,64,29,27,334,72,14882
15000US060670096322,657,94,6,12,0,12,6,12,651,96,231,78,420,92,14883
15000US060670096323,596,98,79,48,32,32,47,37,517,93,75,38,442,95,14884
15000US060670096324,363,76,0,12,0,12,0,12,363,76,56,44,307,71,14885
15000US060670096331,398,56,120,42,85,35,35,28,278,52,80,35,198,49,14886
15000US060670096332,657,61,108,59,69,47,39,29,549,79,175,63,374,83,14887
15000US060670096341,888,103,319,101,147,82,172,71,569,113,135,62,434,105,14888
15000US060670096342,201,65,8,12,0,12,8,12,193,66,43,38,150,58,14889
15000US060670096343,359,71,65,40,23,31,42,27,294,71,74,40,220,69,14890
15000US060670096351,892,80,60,57,0,12,60,57,832,82,142,72,690,85,14891
15000US060670096352,870,94,36,50,28,44,8,13,834,95,139,76,695,113,14892
15000US060670096353,22,15,0,12,0,12,0,12,22,15,14,13,8,14,14893
15000US060670096361,422,98,13,24,13,24,0,12,409,96,60,49,349,104,14894
15000US060670096362,749,164,64,72,5,11,59,70,685,147,158,76,527,154,14895
15000US060670096363,636,130,0,12,0,12,0,12,636,130,103,86,533,118,14896
15000US060670096364,500,105,15,23,0,12,15,23,485,106,110,78,375,114,14897
15000US060670096371,270,70,3,8,3,8,0,12,267,70,15,17,252,70,14898
15000US060670096372,774,96,0,12,0,12,0,12,774,96,235,118,539,101,14899
15000US060670096373,537,83,8,13,8,13,0,12,529,86,158,70,371,82,14900
15000US060670096381,1887,125,103,63,44,37,59,52,1784,129,460,134,1324,158,14901
15000US060670096382,345,90,11,18,11,18,0,12,334,92,59,47,275,100,14902
15000US060670096391,295,56,21,32,0,12,21,32,274,57,49,32,225,59,14903
15000US060670096392,298,58,70,38,61,35,9,14,228,59,26,23,202,59,14904
15000US060670096393,553,58,95,48,75,38,20,26,458,61,159,58,299,73,14905
15000US060670098001,796,79,96,51,43,24,53,40,700,85,245,60,455,75,14906
15000US060670099001,396,100,9,15,0,12,9,15,387,100,144,61,243,87,14907
15000US060670099002,457,108,27,26,0,12,27,26,430,108,115,79,315,91,14908
15000US060670099003,275,106,0,12,0,12,0,12,275,106,94,70,181,85,14909
15000US060670099004,313,84,41,35,7,12,34,32,272,80,63,47,209,83,14910
15000US060679883001,16,10,0,17,0,17,0,17,16,10,0,17,16,10,14911
15000US060690001001,357,64,0,12,0,12,0,12,357,64,72,34,285,68,14912
15000US060690001002,468,81,76,54,26,25,50,47,392,88,110,57,282,83,14913
15000US060690001003,422,78,25,24,7,12,18,21,397,74,81,48,316,77,14914
15000US060690001004,248,63,6,9,0,12,6,9,242,64,77,47,165,56,14915
15000US060690002001,652,93,93,45,63,43,30,27,559,92,160,69,399,84,14916
15000US060690002002,199,86,88,72,61,69,27,30,111,59,33,32,78,65,14917
15000US060690002003,267,82,24,21,11,18,13,23,243,84,50,36,193,79,14918
15000US060690002004,385,80,24,31,0,12,24,31,361,84,77,41,284,92,14919
15000US060690002005,407,93,0,12,0,12,0,12,407,93,109,58,298,113,14920
15000US060690002006,235,93,106,93,92,87,14,20,129,58,54,59,75,49,14921
15000US060690003001,330,53,81,37,27,20,54,35,249,57,100,42,149,48,14922
15000US060690003002,274,46,19,24,4,6,15,24,255,46,43,23,212,50,14923
15000US060690003003,438,61,96,46,11,13,85,44,342,56,85,31,257,59,14924
15000US060690004001,302,88,34,36,12,20,22,31,268,86,99,69,169,70,14925
15000US060690004002,353,88,0,12,0,12,0,12,353,88,76,53,277,88,14926
15000US060690004003,257,74,54,47,0,12,54,47,203,70,6,10,197,69,14927
15000US060690004004,435,96,85,49,12,14,73,48,350,84,49,38,301,83,14928
15000US060690004005,207,62,53,37,17,19,36,36,154,53,57,45,97,46,14929
15000US060690004006,330,73,20,30,20,30,0,12,310,73,84,50,226,71,14930
15000US060690005011,825,120,45,52,0,12,45,52,780,121,117,54,663,125,14931
15000US060690005012,541,101,108,75,38,41,70,54,433,100,70,37,363,101,14932
15000US060690005013,319,59,0,12,0,12,0,12,319,59,50,32,269,61,14933
15000US060690005021,405,91,0,12,0,12,0,12,405,91,105,71,300,81,14934
15000US060690005022,369,108,90,77,8,15,82,75,279,92,106,73,173,64,14935
15000US060690005023,711,112,118,82,78,70,40,44,593,139,153,71,440,140,14936
15000US060690005024,257,77,0,12,0,12,0,12,257,77,43,50,214,74,14937
15000US060690006001,487,130,71,84,14,21,57,80,416,119,47,37,369,123,14938
15000US060690006002,809,164,47,49,33,46,14,24,762,161,66,55,696,160,14939
15000US060690006003,660,165,81,76,21,33,60,69,579,157,157,86,422,146,14940
15000US060690006004,588,126,0,12,0,12,0,12,588,126,116,63,472,129,14941
15000US060690007011,451,66,115,45,19,22,96,45,336,65,92,44,244,64,14942
15000US060690007012,592,76,76,40,24,27,52,34,516,79,98,40,418,78,14943
15000US060690007021,430,90,9,14,0,12,9,14,421,90,96,52,325,88,14944
15000US060690007022,611,92,6,12,6,12,0,12,605,92,147,55,458,97,14945
15000US060690007023,613,102,127,72,55,48,72,58,486,95,102,50,384,92,14946
15000US060690008011,714,65,40,34,21,19,19,29,674,74,143,50,531,76,14947
15000US060690008012,526,65,9,9,7,9,2,3,517,66,158,48,359,68,14948
15000US060690008021,291,47,13,13,1,2,12,13,278,48,66,22,212,39,14949
15000US060690008022,207,43,12,11,0,12,12,11,195,44,34,15,161,41,14950
15000US060690008023,418,56,19,11,6,5,13,12,399,56,141,49,258,39,14951
15000US060710001031,375,69,6,11,0,12,6,11,369,70,51,32,318,77,14952
15000US060710001032,494,69,10,15,0,12,10,15,484,71,65,52,419,65,14953
15000US060710001033,819,117,39,39,6,9,33,39,780,119,78,48,702,125,14954
15000US060710001041,755,103,0,12,0,12,0,12,755,103,102,57,653,103,14955
15000US060710001042,528,91,0,12,0,12,0,12,528,91,92,46,436,94,14956
15000US060710001043,567,81,0,12,0,12,0,12,567,81,94,46,473,90,14957
15000US060710001051,494,77,10,15,0,12,10,15,484,80,92,65,392,75,14958
15000US060710001052,654,90,0,12,0,12,0,12,654,90,84,42,570,92,14959
15000US060710001053,759,98,13,16,0,12,13,16,746,97,97,42,649,105,14960
15000US060710001071,966,34,44,28,39,27,5,7,922,40,308,66,614,72,14961
15000US060710001081,437,81,0,12,0,12,0,12,437,81,64,39,373,77,14962
15000US060710001082,585,95,0,12,0,12,0,12,585,95,76,37,509,106,14963
15000US060710001083,791,105,9,14,0,12,9,14,782,105,80,43,702,106,14964
15000US060710001091,434,89,48,78,0,12,48,78,386,86,77,53,309,90,14965
15000US060710001092,240,69,0,12,0,12,0,12,240,69,52,51,188,65,14966
15000US060710001093,527,99,0,12,0,12,0,12,527,99,197,95,330,102,14967
15000US060710001094,588,119,52,81,52,81,0,12,536,120,213,137,323,97,14968
15000US060710001095,472,127,0,12,0,12,0,12,472,127,125,92,347,132,14969
15000US060710001111,785,64,4,7,4,7,0,12,781,64,141,47,640,75,14970
15000US060710001131,826,157,0,12,0,12,0,12,826,157,110,69,716,170,14971
15000US060710001132,537,208,134,155,0,12,134,155,403,172,0,12,403,172,14972
15000US060710001133,480,169,19,31,0,12,19,31,461,171,89,69,372,184,14973
15000US060710001134,901,157,37,43,19,31,18,29,864,155,140,72,724,160,14974
15000US060710001135,699,189,28,43,28,43,0,12,671,192,166,144,505,187,14975
15000US060710001151,717,148,0,12,0,12,0,12,717,148,223,114,494,129,14976
15000US060710001152,1519,159,7,12,0,12,7,12,1512,159,228,90,1284,164,14977
15000US060710001161,600,130,10,18,10,18,0,12,590,133,49,48,541,137,14978
15000US060710001162,1343,195,18,22,12,20,6,11,1325,196,262,123,1063,198,14979
15000US060710001163,333,97,0,12,0,12,0,12,333,97,55,59,278,91,14980
15000US060710001164,1251,172,56,86,0,12,56,86,1195,186,78,78,1117,179,14981
15000US060710001171,702,108,0,12,0,12,0,12,702,108,47,61,655,110,14982
15000US060710001172,789,142,0,12,0,12,0,12,789,142,153,70,636,159,14983
15000US060710001173,477,109,0,12,0,12,0,12,477,109,35,42,442,111,14984
15000US060710001174,342,84,14,21,14,21,0,12,328,83,58,56,270,97,14985
15000US060710001181,726,96,15,19,15,19,0,12,711,99,131,69,580,103,14986
15000US060710001182,713,94,0,12,0,12,0,12,713,94,105,49,608,97,14987
15000US060710002011,299,80,68,58,0,12,68,58,231,79,34,25,197,73,14988
15000US060710002012,873,102,71,47,50,38,21,25,802,100,71,48,731,116,14989
15000US060710002013,281,59,68,44,29,27,39,34,213,51,66,27,147,47,14990
15000US060710002031,567,91,88,82,0,12,88,82,479,81,113,50,366,102,14991
15000US060710002032,245,77,4,8,0,12,4,8,241,78,31,29,210,77,14992
15000US060710002033,383,94,0,12,0,12,0,12,383,94,57,47,326,85,14993
15000US060710002051,632,115,39,32,20,25,19,20,593,117,208,78,385,122,14994
15000US060710002052,662,115,37,41,37,41,0,12,625,124,158,73,467,124,14995
15000US060710002053,224,81,90,67,62,72,28,45,134,60,6,12,128,60,14996
15000US060710002071,303,83,27,27,0,12,27,27,276,85,81,58,195,69,14997
15000US060710002072,310,71,30,43,6,11,24,41,280,68,70,46,210,70,14998
15000US060710002073,528,97,57,44,8,15,49,43,471,106,89,69,382,114,14999
15000US060710002081,809,84,108,53,58,47,50,38,701,96,123,51,578,103,15000
15000US060710002082,373,71,25,25,19,25,6,10,348,79,72,46,276,86,15001
15000US060710003011,402,107,38,42,0,12,38,42,364,110,49,54,315,110,15002
15000US060710003012,670,128,84,79,19,33,65,74,586,134,53,47,533,140,15003
15000US060710003013,540,145,220,114,24,39,196,104,320,120,61,66,259,122,15004
15000US060710003014,813,147,109,86,0,12,109,86,704,138,152,64,552,142,15005
15000US060710003031,489,114,45,47,0,12,45,47,444,115,47,32,397,121,15006
15000US060710003032,417,103,48,41,10,15,38,38,369,108,80,52,289,101,15007
15000US060710003033,425,81,78,57,22,22,56,55,347,87,90,42,257,90,15008
15000US060710003034,476,103,138,67,36,28,102,65,338,95,90,46,248,94,15009
15000US060710003041,622,90,60,42,30,40,30,27,562,94,55,32,507,95,15010
15000US060710003042,523,88,9,14,9,14,0,12,514,88,182,58,332,92,15011
15000US060710003043,413,86,78,61,43,50,35,35,335,83,125,62,210,81,15012
15000US060710004011,444,108,61,51,7,13,54,49,383,105,162,94,221,80,15013
15000US060710004012,311,86,7,12,7,12,0,12,304,89,88,62,216,94,15014
15000US060710004013,362,96,55,56,8,12,47,56,307,90,95,44,212,91,15015
15000US060710004014,635,96,13,21,0,12,13,21,622,101,202,63,420,102,15016
15000US060710004031,255,77,33,31,9,14,24,28,222,77,68,42,154,67,15017
15000US060710004032,518,87,47,48,26,33,21,32,471,97,123,45,348,95,15018
15000US060710004033,569,106,73,61,32,41,41,46,496,95,101,47,395,101,15019
15000US060710004041,839,115,47,30,30,27,17,16,792,118,209,83,583,118,15020
15000US060710004042,736,99,27,25,10,16,17,19,709,100,146,64,563,89,15021
15000US060710005011,799,91,62,48,13,13,49,46,737,99,228,83,509,87,15022
15000US060710005012,440,85,63,46,63,46,0,12,377,78,84,49,293,73,15023
15000US060710005013,477,97,35,40,0,12,35,40,442,91,45,35,397,94,15024
15000US060710005031,374,77,50,42,0,12,50,42,324,70,72,45,252,72,15025
15000US060710005032,486,109,27,25,11,17,16,17,459,115,113,51,346,120,15026
15000US060710005033,589,106,41,37,5,10,36,36,548,104,88,47,460,101,15027
15000US060710005041,208,66,0,12,0,12,0,12,208,66,44,32,164,68,15028
15000US060710005042,428,77,19,22,8,13,11,17,409,78,88,53,321,70,15029
15000US060710005043,664,89,64,46,31,44,33,28,600,92,114,54,486,90,15030
15000US060710006031,768,88,64,38,34,31,30,26,704,91,177,58,527,97,15031
15000US060710006032,743,93,91,61,84,64,7,11,652,99,87,47,565,95,15032
15000US060710006041,595,77,64,41,19,13,45,39,531,82,152,53,379,78,15033
15000US060710006042,530,82,163,86,29,34,134,80,367,86,34,41,333,90,15034
15000US060710006043,494,82,37,39,9,14,28,36,457,83,89,41,368,86,15035
15000US060710006051,666,98,176,69,46,40,130,67,490,100,157,71,333,104,15036
15000US060710006052,484,79,43,38,16,18,27,33,441,78,110,55,331,74,15037
15000US060710006061,592,88,67,48,15,17,52,46,525,93,128,61,397,94,15038
15000US060710006062,448,97,25,24,7,11,18,21,423,98,51,39,372,102,15039
15000US060710008041,390,67,17,19,8,14,9,13,373,67,98,44,275,75,15040
15000US060710008042,799,85,19,16,0,12,19,16,780,84,138,58,642,90,15041
15000US060710008081,477,84,16,18,0,12,16,18,461,86,165,84,296,77,15042
15000US060710008082,717,92,96,58,34,40,62,59,621,95,198,67,423,98,15043
15000US060710008083,405,83,63,44,45,37,18,23,342,88,52,35,290,86,15044
15000US060710008084,419,73,41,24,15,17,26,20,378,75,72,37,306,76,15045
15000US060710008121,632,80,15,18,10,14,5,8,617,83,147,68,470,90,15046
15000US060710008122,258,74,0,12,0,12,0,12,258,74,64,65,194,54,15047
15000US060710008123,381,75,39,32,11,16,28,28,342,74,60,38,282,77,15048
15000US060710008131,624,89,19,22,7,11,12,19,605,90,99,67,506,104,15049
15000US060710008132,624,91,24,28,16,25,8,13,600,88,135,55,465,91,15050
15000US060710008141,310,60,0,12,0,12,0,12,310,60,116,44,194,65,15051
15000US060710008142,498,51,0,12,0,12,0,12,498,51,97,54,401,64,15052
15000US060710008143,264,56,0,12,0,12,0,12,264,56,0,12,264,56,15053
15000US060710008144,271,59,0,12,0,12,0,12,271,59,41,29,230,59,15054
15000US060710008151,594,75,0,12,0,12,0,12,594,75,40,34,554,80,15055
15000US060710008152,697,74,6,12,5,11,1,7,691,76,160,71,531,79,15056
15000US060710008161,309,53,0,12,0,12,0,12,309,53,68,44,241,58,15057
15000US060710008162,517,74,3,14,3,14,0,12,514,73,128,56,386,72,15058
15000US060710008163,591,72,0,12,0,12,0,12,591,72,187,58,404,82,15059
15000US060710008171,394,94,0,12,0,12,0,12,394,94,105,54,289,98,15060
15000US060710008172,602,81,24,28,0,12,24,28,578,81,114,59,464,94,15061
15000US060710008173,364,83,7,11,7,11,0,12,357,83,112,41,245,76,15062
15000US060710008181,429,81,0,12,0,12,0,12,429,81,81,46,348,84,15063
15000US060710008182,477,86,15,20,15,20,0,12,462,85,161,73,301,93,15064
15000US060710008183,600,97,55,42,13,18,42,38,545,105,172,88,373,101,15065
15000US060710008184,403,90,11,17,11,17,0,12,392,94,87,41,305,96,15066
15000US060710008191,453,75,0,12,0,12,0,12,453,75,162,83,291,68,15067
15000US060710008192,782,91,28,32,28,32,0,12,754,97,78,42,676,100,15068
15000US060710008193,662,86,17,19,0,12,17,19,645,88,87,43,558,99,15069
15000US060710008201,642,70,0,12,0,12,0,12,642,70,118,61,524,70,15070
15000US060710008202,304,59,10,18,10,18,0,12,294,59,62,37,232,62,15071
15000US060710008203,420,66,14,16,14,16,0,12,406,67,68,47,338,72,15072
15000US060710008211,1598,94,205,94,34,31,171,96,1393,139,177,73,1216,152,15073
15000US060710008231,797,207,116,114,8,20,108,111,681,182,100,57,581,181,15074
15000US060710008232,908,208,102,91,0,12,102,91,806,217,121,80,685,211,15075
15000US060710008233,981,201,168,133,72,84,96,99,813,200,158,98,655,196,15076
15000US060710008241,467,108,131,71,9,14,122,72,336,84,101,38,235,83,15077
15000US060710008242,454,110,49,35,28,28,21,22,405,115,178,90,227,88,15078
15000US060710008243,355,78,35,42,0,12,35,42,320,69,37,29,283,68,15079
15000US060710008244,599,124,132,79,5,9,127,79,467,121,117,67,350,116,15080
15000US060710008251,355,89,48,51,8,13,40,48,307,85,85,58,222,87,15081
15000US060710008252,883,130,166,81,87,68,79,65,717,122,65,55,652,120,15082
15000US060710008253,238,67,60,56,9,13,51,53,178,53,29,23,149,52,15083
15000US060710008261,430,98,22,25,22,25,0,12,408,99,155,76,253,86,15084
15000US060710008262,373,80,32,29,0,12,32,29,341,83,79,57,262,71,15085
15000US060710008263,519,97,38,41,15,16,23,37,481,99,105,53,376,103,15086
15000US060710009011,591,93,81,77,6,10,75,76,510,94,145,61,365,104,15087
15000US060710009012,700,106,53,31,44,32,9,15,647,109,88,57,559,103,15088
15000US060710009013,412,83,42,41,0,12,42,41,370,87,28,23,342,88,15089
15000US060710009031,402,76,45,41,6,11,39,40,357,76,47,29,310,82,15090
15000US060710009032,580,103,55,45,7,12,48,43,525,98,75,52,450,101,15091
15000US060710009033,487,97,106,59,49,40,57,41,381,95,46,31,335,95,15092
15000US060710009041,852,97,238,83,26,23,212,87,614,107,96,51,518,106,15093
15000US060710009042,325,82,32,38,0,12,32,38,293,82,68,47,225,84,15094
15000US060710010011,564,97,81,57,30,36,51,43,483,109,71,42,412,112,15095
15000US060710010012,535,68,96,50,53,42,43,35,439,71,176,69,263,69,15096
15000US060710010013,498,80,102,52,20,22,82,49,396,80,84,43,312,83,15097
15000US060710010021,306,87,50,48,2,10,48,45,256,93,42,28,214,92,15098
15000US060710010022,815,130,234,117,55,66,179,107,581,136,127,80,454,128,15099
15000US060710010023,392,88,0,12,0,12,0,12,392,88,46,36,346,98,15100
15000US060710011011,369,108,78,74,0,12,78,74,291,104,62,57,229,109,15101
15000US060710011012,599,107,49,53,9,14,40,51,550,113,118,60,432,115,15102
15000US060710011013,253,89,50,36,10,17,40,31,203,85,48,53,155,82,15103
15000US060710011031,628,109,83,50,26,31,57,37,545,115,175,87,370,102,15104
15000US060710011032,434,66,0,12,0,12,0,12,434,66,147,49,287,67,15105
15000US060710011033,431,111,77,70,6,10,71,69,354,93,39,29,315,95,15106
15000US060710011041,608,95,21,22,21,22,0,12,587,97,125,56,462,102,15107
15000US060710011042,405,84,72,47,9,13,63,47,333,90,101,46,232,89,15108
15000US060710011043,756,115,141,79,17,18,124,75,615,120,175,70,440,115,15109
15000US060710012001,464,70,0,12,0,12,0,12,464,70,81,37,383,77,15110
15000US060710012002,372,82,66,67,33,48,33,39,306,74,109,59,197,70,15111
15000US060710012003,433,84,36,34,19,26,17,20,397,87,85,37,312,86,15112
15000US060710012004,314,82,0,12,0,12,0,12,314,82,78,60,236,86,15113
15000US060710013051,576,132,60,38,20,22,40,31,516,126,142,66,374,118,15114
15000US060710013052,404,86,31,32,0,12,31,32,373,83,67,51,306,83,15115
15000US060710013053,344,94,175,71,32,38,143,64,169,74,51,46,118,66,15116
15000US060710013071,614,63,116,58,77,47,39,35,498,69,86,35,412,70,15117
15000US060710013072,424,64,67,47,24,20,43,43,357,65,74,33,283,66,15118
15000US060710013081,706,85,98,59,28,27,70,53,608,89,191,68,417,92,15119
15000US060710013082,594,92,169,78,52,48,117,69,425,114,49,38,376,114,15120
15000US060710013091,499,108,109,69,35,35,74,61,390,108,77,50,313,118,15121
15000US060710013092,278,92,29,43,0,12,29,43,249,92,87,52,162,85,15122
15000US060710013093,388,93,57,57,0,12,57,57,331,99,21,26,310,98,15123
15000US060710013101,510,89,58,46,50,43,8,16,452,96,72,39,380,97,15124
15000US060710013102,475,84,0,12,0,12,0,12,475,84,136,63,339,80,15125
15000US060710013103,306,82,43,34,14,22,29,27,263,81,75,45,188,75,15126
15000US060710013104,260,78,22,35,0,12,22,35,238,77,86,59,152,67,15127
15000US060710013111,946,43,51,43,20,29,31,30,895,60,188,53,707,70,15128
15000US060710013121,583,102,43,47,15,22,28,42,540,105,117,86,423,111,15129
15000US060710013122,819,120,132,88,67,49,65,73,687,136,193,87,494,134,15130
15000US060710014001,552,110,67,52,18,20,49,50,485,105,235,87,250,91,15131
15000US060710014002,654,117,25,23,0,12,25,23,629,113,101,61,528,113,15132
15000US060710015011,604,60,84,42,31,25,53,35,520,61,133,47,387,70,15133
15000US060710015012,354,66,128,51,21,16,107,48,226,57,33,19,193,59,15134
15000US060710015031,460,66,167,54,56,37,111,43,293,58,100,48,193,58,15135
15000US060710015032,466,63,88,42,11,12,77,44,378,68,61,31,317,74,15136
15000US060710015041,820,91,260,78,81,43,179,71,560,106,17,20,543,107,15137
15000US060710015042,886,84,60,43,39,36,21,22,826,84,212,71,614,104,15138
15000US060710016001,280,85,89,60,42,50,47,37,191,75,55,43,136,70,15139
15000US060710016002,88,49,55,35,16,25,39,31,33,40,0,12,33,40,15140
15000US060710016003,313,81,70,53,3,10,67,53,243,72,93,64,150,57,15141
15000US060710016004,418,89,59,42,10,14,49,42,359,100,80,62,279,87,15142
15000US060710016005,398,83,95,59,45,39,50,42,303,91,23,28,280,88,15143
15000US060710017021,640,109,109,71,48,47,61,53,531,106,80,47,451,112,15144
15000US060710017022,369,58,19,21,0,12,19,21,350,62,87,36,263,66,15145
15000US060710017023,641,79,28,27,0,12,28,27,613,88,183,58,430,92,15146
15000US060710017031,469,99,27,39,27,39,0,12,442,106,65,63,377,91,15147
15000US060710017032,231,52,0,12,0,12,0,12,231,52,65,39,166,51,15148
15000US060710017033,540,101,46,58,0,12,46,58,494,100,168,92,326,99,15149
15000US060710017034,395,76,25,24,19,22,6,10,370,77,131,52,239,76,15150
15000US060710017041,866,113,58,47,5,10,53,47,808,117,194,77,614,124,15151
15000US060710017042,552,103,79,56,26,26,53,49,473,100,102,60,371,92,15152
15000US060710017061,533,115,33,34,10,15,23,29,500,119,165,77,335,104,15153
15000US060710017062,204,73,52,51,8,13,44,49,152,61,0,12,152,61,15154
15000US060710017063,1102,135,101,61,30,26,71,55,1001,145,152,82,849,135,15155
15000US060710017071,418,102,62,52,36,45,26,24,356,105,122,60,234,93,15156
15000US060710017072,416,93,8,14,8,14,0,12,408,93,114,59,294,83,15157
15000US060710017073,674,112,127,87,37,40,90,77,547,116,154,71,393,116,15158
15000US060710018031,1072,99,121,67,32,34,89,67,951,116,290,88,661,137,15159
15000US060710018041,463,82,68,46,40,39,28,26,395,83,110,50,285,84,15160
15000US060710018042,1040,109,66,59,28,25,38,48,974,114,118,45,856,114,15161
15000US060710018061,374,88,10,15,1,6,9,13,364,88,36,32,328,92,15162
15000US060710018062,463,77,6,11,0,12,6,11,457,76,159,78,298,89,15163
15000US060710018063,516,74,75,61,46,47,29,36,441,71,76,38,365,77,15164
15000US060710018081,480,106,98,77,14,15,84,75,382,94,65,52,317,80,15165
15000US060710018082,379,106,0,12,0,12,0,12,379,106,106,55,273,112,15166
15000US060710018083,354,90,44,40,38,39,6,10,310,84,129,86,181,81,15167
15000US060710018091,373,92,63,56,8,14,55,58,310,93,31,24,279,94,15168
15000US060710018092,608,85,145,76,0,12,145,76,463,96,129,83,334,114,15169
15000US060710018093,213,63,0,12,0,12,0,12,213,63,53,45,160,68,15170
15000US060710018101,449,95,84,60,9,15,75,57,365,102,82,49,283,97,15171
15000US060710018102,466,76,60,45,0,12,60,45,406,88,42,39,364,90,15172
15000US060710018103,347,73,66,39,31,39,35,33,281,85,49,43,232,83,15173
15000US060710018121,552,105,29,36,0,12,29,36,523,102,92,50,431,110,15174
15000US060710018122,549,92,85,58,24,30,61,53,464,101,77,51,387,110,15175
15000US060710018131,444,62,100,48,34,25,66,40,344,74,117,51,227,72,15176
15000US060710018132,568,70,171,67,59,43,112,54,397,76,95,43,302,76,15177
15000US060710019011,504,84,36,29,28,26,8,12,468,84,126,50,342,81,15178
15000US060710019012,492,91,49,49,36,56,13,19,443,82,46,40,397,81,15179
15000US060710019013,451,77,0,12,0,12,0,12,451,77,102,39,349,83,15180
15000US060710019031,2280,172,92,61,38,50,54,39,2188,173,266,116,1922,189,15181
15000US060710019032,105,56,0,12,0,12,0,12,105,56,48,45,57,42,15182
15000US060710019051,688,97,12,18,0,12,12,18,676,97,85,41,591,106,15183
15000US060710019052,252,64,0,12,0,12,0,12,252,64,35,28,217,66,15184
15000US060710019053,250,92,65,50,7,12,58,50,185,86,49,47,136,74,15185
15000US060710019054,584,79,41,45,0,12,41,45,543,78,109,56,434,81,15186
15000US060710019061,1376,174,89,80,14,22,75,77,1287,177,178,82,1109,182,15187
15000US060710019062,1044,173,180,126,0,12,180,126,864,162,166,80,698,166,15188
15000US060710020101,1328,155,0,12,0,12,0,12,1328,155,202,98,1126,185,15189
15000US060710020102,570,132,13,22,13,22,0,12,557,131,78,53,479,127,15190
15000US060710020103,798,159,11,19,0,12,11,19,787,159,74,65,713,148,15191
15000US060710020111,669,76,9,15,0,12,9,15,660,76,192,58,468,77,15192
15000US060710020112,564,79,10,17,0,12,10,17,554,84,156,57,398,86,15193
15000US060710020131,941,116,115,86,0,12,115,86,826,113,143,53,683,109,15194
15000US060710020132,732,102,7,12,7,12,0,12,725,103,148,54,577,113,15195
15000US060710020141,708,79,9,15,9,15,0,12,699,80,131,58,568,79,15196
15000US060710020142,855,84,35,46,7,11,28,44,820,85,213,70,607,100,15197
15000US060710020151,838,87,48,49,8,13,40,41,790,94,132,63,658,108,15198
15000US060710020152,685,82,84,64,20,34,64,51,601,85,118,45,483,87,15199
15000US060710020161,680,79,53,33,0,12,53,33,627,79,212,74,415,87,15200
15000US060710020162,568,62,46,42,19,24,27,32,522,67,119,51,403,83,15201
15000US060710020171,698,80,11,17,0,12,11,17,687,81,179,68,508,90,15202
15000US060710020172,1068,97,16,18,0,12,16,18,1052,100,213,69,839,113,15203
15000US060710020181,954,107,38,35,11,17,27,26,916,106,167,80,749,113,15204
15000US060710020182,752,105,98,70,37,48,61,50,654,107,160,63,494,112,15205
15000US060710020191,696,97,43,55,10,17,33,52,653,75,170,57,483,78,15206
15000US060710020192,988,123,73,53,12,18,61,49,915,132,75,42,840,132,15207
15000US060710020211,532,101,10,17,0,12,10,17,522,101,65,43,457,103,15208
15000US060710020212,593,86,48,32,18,20,30,26,545,90,71,40,474,90,15209
15000US060710020213,481,87,33,25,20,22,13,20,448,91,90,50,358,95,15210
15000US060710020221,1081,135,30,33,15,24,15,23,1051,138,188,95,863,146,15211
15000US060710020222,2379,178,25,32,0,17,25,32,2354,175,461,153,1893,234,15212
15000US060710020231,1107,165,184,100,28,31,156,94,923,135,294,91,629,128,15213
15000US060710020232,1177,164,90,90,12,23,78,85,1087,165,111,67,976,177,15214
15000US060710020251,956,122,44,30,27,24,17,18,912,129,193,71,719,137,15215
15000US060710020252,855,124,29,30,7,11,22,24,826,133,238,82,588,119,15216
15000US060710020271,495,114,58,59,15,23,43,55,437,107,62,50,375,105,15217
15000US060710020272,701,134,86,79,0,12,86,79,615,140,102,83,513,145,15218
15000US060710020273,809,151,22,34,0,12,22,34,787,153,320,131,467,140,15219
15000US060710020281,794,105,84,53,15,18,69,51,710,108,137,66,573,115,15220
15000US060710020282,800,92,40,29,9,15,31,25,760,101,225,76,535,108,15221
15000US060710020291,478,80,0,12,0,12,0,12,478,80,130,50,348,84,15222
15000US060710020292,477,91,9,15,1,5,8,15,468,90,46,27,422,92,15223
15000US060710020293,400,95,0,12,0,12,0,12,400,95,61,52,339,91,15224
15000US060710020294,536,77,28,30,0,12,28,30,508,76,57,41,451,76,15225
15000US060710020311,491,87,0,12,0,12,0,12,491,87,33,31,458,92,15226
15000US060710020312,833,109,9,14,9,14,0,12,824,110,57,39,767,124,15227
15000US060710020313,540,83,47,61,47,61,0,12,493,72,118,55,375,79,15228
15000US060710020331,1397,132,0,12,0,12,0,12,1397,132,321,136,1076,146,15229
15000US060710020332,1045,137,48,56,0,12,48,56,997,144,130,89,867,157,15230
15000US060710020341,1906,278,46,57,46,57,0,17,1860,274,102,99,1758,292,15231
15000US060710020342,2918,285,139,174,31,52,108,165,2779,306,542,292,2237,331,15232
15000US060710020351,1444,147,122,76,13,24,109,74,1322,162,296,121,1026,185,15233
15000US060710020352,886,135,40,44,40,44,0,12,846,138,207,99,639,145,15234
15000US060710020361,3719,298,187,131,0,19,187,131,3532,315,425,184,3107,303,15235
15000US060710020362,906,212,152,142,0,12,152,142,754,196,47,55,707,192,15236
15000US060710020371,290,103,37,48,25,43,12,21,253,102,0,12,253,102,15237
15000US060710020372,497,120,0,12,0,12,0,12,497,120,54,50,443,121,15238
15000US060710020373,1346,142,162,123,0,17,162,123,1184,151,302,124,882,172,15239
15000US060710020381,718,92,42,38,42,38,0,12,676,89,175,62,501,94,15240
15000US060710020382,708,101,11,17,11,17,0,12,697,101,120,57,577,113,15241
15000US060710021011,688,92,130,54,30,25,100,52,558,95,149,76,409,108,15242
15000US060710021012,634,103,92,52,38,38,54,34,542,101,99,46,443,109,15243
15000US060710021031,521,101,151,75,36,46,115,72,370,97,130,63,240,89,15244
15000US060710021032,1364,122,165,87,26,23,139,84,1199,134,163,64,1036,127,15245
15000US060710021051,940,109,144,75,50,51,94,60,796,115,235,91,561,100,15246
15000US060710021052,299,80,53,38,18,20,35,35,246,77,56,30,190,79,15247
15000US060710021053,539,88,41,34,21,22,20,23,498,91,150,79,348,85,15248
15000US060710021071,210,90,50,43,9,23,41,41,160,79,53,42,107,71,15249
15000US060710021072,981,116,107,66,53,39,54,59,874,121,214,63,660,126,15250
15000US060710021073,716,99,92,66,25,39,67,57,624,100,140,63,484,107,15251
15000US060710021091,1732,161,148,83,11,18,137,79,1584,156,83,51,1501,168,15252
15000US060710021092,374,103,26,40,26,40,0,12,348,97,89,61,259,82,15253
15000US060710021101,3156,215,219,144,65,59,154,128,2937,241,199,121,2738,288,15254
15000US060710022041,183,72,21,33,21,33,0,12,162,78,59,61,103,68,15255
15000US060710022042,535,105,84,56,19,30,65,48,451,99,106,75,345,92,15256
15000US060710022043,873,113,159,73,49,42,110,51,714,101,122,61,592,105,15257
15000US060710022061,593,101,45,29,24,27,21,24,548,104,89,60,459,106,15258
15000US060710022062,303,83,36,48,0,12,36,48,267,83,56,34,211,88,15259
15000US060710022063,373,92,16,21,0,12,16,21,357,94,80,66,277,80,15260
15000US060710022064,789,116,67,58,13,20,54,56,722,125,105,53,617,123,15261
15000US060710022071,666,51,126,67,17,16,109,69,540,78,119,61,421,77,15262
15000US060710022072,0,12,0,12,0,12,0,12,0,12,0,12,0,12,15263
15000US060710023011,253,93,13,34,0,12,13,34,240,89,71,59,169,79,15264
15000US060710023012,952,236,215,163,23,33,192,162,737,173,174,101,563,170,15265
15000US060710023013,847,227,140,119,0,12,140,119,707,206,60,51,647,206,15266
15000US060710023014,511,194,115,107,0,12,115,107,396,151,92,82,304,120,15267
15000US060710023041,1235,230,130,100,32,37,98,96,1105,236,223,167,882,230,15268
15000US060710023042,2714,324,101,129,0,19,101,129,2613,360,417,223,2196,378,15269
15000US060710023043,1150,259,0,17,0,17,0,17,1150,259,209,121,941,252,15270
15000US060710023051,1395,170,84,86,11,17,73,83,1311,181,285,120,1026,204,15271
15000US060710023052,308,103,0,12,0,12,0,12,308,103,74,56,234,91,15272
15000US060710023053,355,124,49,60,12,22,37,55,306,134,103,104,203,96,15273
15000US060710023054,638,142,68,52,52,48,16,19,570,148,78,55,492,144,15274
15000US060710023061,302,92,23,30,0,12,23,30,279,85,101,49,178,75,15275
15000US060710023062,669,102,80,58,29,32,51,47,589,114,120,55,469,109,15276
15000US060710023071,575,97,149,89,33,38,116,81,426,95,145,78,281,83,15277
15000US060710023072,548,77,102,55,57,48,45,31,446,81,99,46,347,80,15278
15000US060710024011,495,86,74,54,10,16,64,52,421,88,146,49,275,89,15279
15000US060710024012,362,86,46,42,46,42,0,12,316,90,136,67,180,78,15280
15000US060710024013,303,73,61,44,13,21,48,41,242,66,43,38,199,68,15281
15000US060710024014,205,64,7,13,0,12,7,13,198,64,43,23,155,62,15282
15000US060710024015,614,93,138,66,48,31,90,62,476,107,129,66,347,97,15283
15000US060710024021,695,125,71,60,7,10,64,60,624,133,158,86,466,134,15284
15000US060710024022,555,93,123,66,10,13,113,65,432,94,125,64,307,85,15285
15000US060710024023,319,78,40,43,15,16,25,39,279,73,59,39,220,70,15286
15000US060710024024,483,98,154,83,0,12,154,83,329,92,45,28,284,95,15287
15000US060710025011,262,75,24,27,16,22,8,13,238,78,90,63,148,67,15288
15000US060710025012,451,104,93,67,9,16,84,67,358,101,84,61,274,94,15289
15000US060710025013,404,111,82,57,24,21,58,59,322,108,52,38,270,106,15290
15000US060710025014,242,81,78,62,25,40,53,48,164,64,26,34,138,54,15291
15000US060710025021,411,91,4,10,4,10,0,12,407,92,52,38,355,92,15292
15000US060710025022,467,110,131,74,70,61,61,47,336,110,161,90,175,76,15293
15000US060710025023,596,104,103,73,53,56,50,45,493,114,65,35,428,117,15294
15000US060710025024,217,81,18,20,12,18,6,12,199,82,61,48,138,74,15295
15000US060710026011,664,160,136,114,11,18,125,112,528,153,174,100,354,139,15296
15000US060710026012,1675,194,141,106,89,86,52,64,1534,183,424,156,1110,186,15297
15000US060710026021,456,92,37,28,10,15,27,22,419,94,87,38,332,101,15298
15000US060710026022,349,71,42,39,29,34,13,20,307,71,73,38,234,67,15299
15000US060710026023,777,111,62,60,0,12,62,60,715,119,146,65,569,122,15300
15000US060710026024,411,92,20,31,0,12,20,31,391,92,27,25,364,94,15301
15000US060710026041,394,65,55,42,0,12,55,42,339,67,49,40,290,70,15302
15000US060710026042,433,74,64,46,28,26,36,34,369,83,121,60,248,81,15303
15000US060710026043,232,64,0,12,0,12,0,12,232,64,89,47,143,63,15304
15000US060710026044,497,94,7,12,7,12,0,12,490,93,60,54,430,102,15305
15000US060710026061,713,104,36,26,20,21,16,18,677,109,189,79,488,105,15306
15000US060710026062,738,110,155,92,8,12,147,91,583,133,92,51,491,134,15307
15000US060710026063,491,94,62,49,0,12,62,49,429,92,66,44,363,92,15308
15000US060710026071,632,96,7,11,0,12,7,11,625,96,129,62,496,101,15309
15000US060710026072,463,90,20,31,0,12,20,31,443,93,71,47,372,90,15310
15000US060710026073,390,102,14,18,0,12,14,18,376,101,63,43,313,99,15311
15000US060710026074,567,114,0,12,0,12,0,12,567,114,112,68,455,100,15312
15000US060710027031,642,100,29,45,29,45,0,12,613,103,121,62,492,96,15313
15000US060710027032,458,86,16,19,16,19,0,12,442,88,198,87,244,85,15314
15000US060710027033,420,100,31,29,0,12,31,29,389,101,60,42,329,97,15315
15000US060710027041,461,147,58,63,0,12,58,63,403,147,78,52,325,150,15316
15000US060710027042,1931,222,169,101,87,65,82,74,1762,235,384,163,1378,231,15317
15000US060710027043,420,122,130,97,130,97,0,12,290,104,92,60,198,96,15318
15000US060710027051,367,68,23,25,10,15,13,20,344,69,111,51,233,69,15319
15000US060710027052,353,74,69,49,22,24,47,43,284,76,54,33,230,84,15320
15000US060710027053,415,84,45,39,20,27,25,28,370,94,88,44,282,109,15321
15000US060710027054,291,80,15,16,7,11,8,13,276,81,50,45,226,90,15322
15000US060710027061,988,125,51,49,43,47,8,13,937,126,221,61,716,131,15323
15000US060710027062,455,102,68,67,31,47,37,46,387,95,89,47,298,90,15324
15000US060710027063,658,133,56,46,20,19,36,42,602,126,137,73,465,119,15325
15000US060710028011,535,88,66,37,20,18,46,33,469,81,118,53,351,88,15326
15000US060710028012,430,80,148,67,24,28,124,62,282,78,41,38,241,79,15327
15000US060710028013,307,75,107,50,29,26,78,45,200,75,18,28,182,77,15328
15000US060710028031,494,57,145,51,17,19,128,46,349,67,97,46,252,60,15329
15000US060710028032,254,45,50,24,6,9,44,23,204,46,54,26,150,46,15330
15000US060710028033,277,44,67,35,33,28,34,25,210,48,92,34,118,46,15331
15000US060710028041,550,72,195,72,73,54,122,71,355,82,51,42,304,77,15332
15000US060710028042,305,64,101,60,12,20,89,59,204,66,23,27,181,64,15333
15000US060710028043,498,81,212,76,43,37,169,72,286,77,46,42,240,77,15334
15000US060710029011,256,72,37,39,14,17,23,35,219,75,62,46,157,65,15335
15000US060710029012,522,95,100,71,77,62,23,38,422,96,156,77,266,82,15336
15000US060710029013,277,82,89,56,6,10,83,54,188,71,41,34,147,68,15337
15000US060710029021,217,68,47,39,8,14,39,37,170,66,59,33,111,68,15338
15000US060710029022,637,85,176,64,41,29,135,68,461,94,203,71,258,81,15339
15000US060710029023,397,92,38,55,0,12,38,55,359,94,53,42,306,102,15340
15000US060710029024,257,75,60,60,13,18,47,57,197,68,82,41,115,59,15341
15000US060710029025,350,88,71,59,11,14,60,64,279,102,61,51,218,98,15342
15000US060710030001,503,87,118,62,89,62,29,29,385,86,145,59,240,79,15343
15000US060710030002,559,81,151,83,91,62,60,53,408,83,174,77,234,80,15344
15000US060710031011,170,54,18,20,0,12,18,20,152,54,75,40,77,53,15345
15000US060710031012,622,87,75,47,23,21,52,42,547,95,78,52,469,97,15346
15000US060710031013,383,83,119,72,17,28,102,68,264,88,29,38,235,89,15347
15000US060710031021,499,98,92,65,9,16,83,64,407,104,25,32,382,103,15348
15000US060710031022,306,86,53,30,21,24,32,34,253,92,19,30,234,88,15349
15000US060710031023,629,123,155,86,18,20,137,82,474,106,157,84,317,89,15350
15000US060710032001,431,135,169,108,67,61,102,89,262,122,42,45,220,100,15351
15000US060710032002,337,98,0,12,0,12,0,12,337,98,122,58,215,98,15352
15000US060710032003,532,108,90,66,47,53,43,50,442,101,164,97,278,101,15353
15000US060710032004,285,91,80,69,54,62,26,40,205,88,104,63,101,87,15354
15000US060710032005,203,83,99,88,16,27,83,85,104,55,63,52,41,38,15355
15000US060710032006,299,97,111,89,73,81,38,43,188,113,51,79,137,79,15356
15000US060710033011,641,107,147,77,33,33,114,71,494,110,167,78,327,95,15357
15000US060710033012,241,66,76,45,45,47,31,35,165,59,30,23,135,60,15358
15000US060710033013,667,98,168,80,57,46,111,71,499,117,133,69,366,105,15359
15000US060710033021,438,90,23,23,23,23,0,12,415,91,110,57,305,90,15360
15000US060710033022,340,75,22,35,0,12,22,35,318,74,65,30,253,80,15361
15000US060710033023,634,126,103,66,31,37,72,56,531,122,148,73,383,112,15362
15000US060710033024,350,83,62,44,21,36,41,46,288,81,68,47,220,91,15363
15000US060710034011,461,113,109,78,13,19,96,77,352,94,116,68,236,85,15364
15000US060710034012,345,90,32,28,15,16,17,23,313,88,87,54,226,89,15365
15000US060710034013,519,86,59,48,16,18,43,44,460,86,180,75,280,88,15366
15000US060710034014,458,84,139,59,63,47,76,53,319,90,91,55,228,90,15367
15000US060710034031,271,91,78,63,59,58,19,21,193,88,96,62,97,68,15368
15000US060710034032,508,94,88,56,15,15,73,54,420,97,129,58,291,103,15369
15000US060710034033,229,74,62,55,27,39,35,43,167,58,48,37,119,61,15370
15000US060710034041,624,79,255,75,76,49,179,66,369,77,98,53,271,85,15371
15000US060710034042,364,63,63,36,6,10,57,35,301,68,44,31,257,68,15372
15000US060710034043,293,86,26,30,0,12,26,30,267,81,24,26,243,80,15373
15000US060710034051,312,71,61,42,18,14,43,40,251,70,58,42,193,69,15374
15000US060710034052,392,74,86,52,37,38,49,38,306,84,41,38,265,78,15375
15000US060710034053,768,94,226,74,52,38,174,70,542,99,90,49,452,104,15376
15000US060710035031,502,84,34,33,13,23,21,26,468,86,81,48,387,88,15377
15000US060710035032,493,82,79,54,38,36,41,40,414,77,93,45,321,88,15378
15000US060710035033,318,77,81,55,0,12,81,55,237,76,72,45,165,74,15379
15000US060710035051,582,116,319,105,88,65,231,93,263,81,41,34,222,73,15380
15000US060710035052,552,120,174,90,48,47,126,75,378,102,46,33,332,100,15381
15000US060710035053,470,118,84,77,12,18,72,75,386,93,110,46,276,89,15382
15000US060710035061,256,88,205,90,69,70,136,76,51,41,6,10,45,40,15383
15000US060710035062,465,101,147,68,25,27,122,71,318,90,141,57,177,83,15384
15000US060710035063,559,103,98,65,38,43,60,59,461,111,160,80,301,90,15385
15000US060710035071,753,73,148,70,51,50,97,61,605,93,90,68,515,87,15386
15000US060710035072,356,69,75,43,44,34,31,23,281,65,101,49,180,60,15387
15000US060710035091,524,98,176,75,0,12,176,75,348,94,55,37,293,96,15388
15000US060710035092,650,92,261,102,71,54,190,92,389,77,85,41,304,77,15389
15000US060710035101,819,96,269,107,84,53,185,91,550,129,145,53,405,118,15390
15000US060710035102,332,77,63,46,11,13,52,45,269,87,125,69,144,76,15391
15000US060710036031,504,69,104,52,9,12,95,53,400,74,104,43,296,73,15392
15000US060710036032,440,69,45,25,12,13,33,23,395,63,87,38,308,64,15393
15000US060710036051,522,80,44,32,17,14,27,30,478,85,149,74,329,88,15394
15000US060710036052,512,73,54,44,7,11,47,45,458,77,45,36,413,81,15395
15000US060710036061,345,100,51,45,0,12,51,45,294,104,130,87,164,86,15396
15000US060710036062,217,78,30,30,21,22,9,19,187,71,61,41,126,69,15397
15000US060710036063,802,119,331,121,145,86,186,108,471,98,104,48,367,99,15398
15000US060710036071,912,101,219,83,91,58,128,68,693,100,202,71,491,101,15399
15000US060710036072,572,97,153,73,14,15,139,71,419,106,116,57,303,101,15400
15000US060710036091,184,65,45,47,0,12,45,47,139,49,57,34,82,43,15401
15000US060710036092,571,93,132,77,56,56,76,56,439,91,98,55,341,85,15402
15000US060710036093,554,85,100,63,50,45,50,42,454,99,125,62,329,97,15403
15000US060710036111,816,115,162,84,65,49,97,75,654,113,138,77,516,117,15404
15000US060710036112,568,104,137,85,70,72,67,49,431,102,91,57,340,102,15405
15000US060710036121,570,103,52,51,13,13,39,50,518,105,127,59,391,97,15406
15000US060710036122,442,87,151,92,75,62,76,65,291,94,132,62,159,88,15407
15000US060710037001,365,89,166,74,39,28,127,72,199,70,34,30,165,72,15408
15000US060710037002,831,92,265,99,120,68,145,67,566,99,177,74,389,89,15409
15000US060710038011,248,54,7,12,0,12,7,12,241,53,74,41,167,55,15410
15000US060710038012,468,85,53,38,32,35,21,25,415,88,60,45,355,84,15411
15000US060710038013,563,90,74,52,26,32,48,46,489,87,102,45,387,96,15412
15000US060710038031,499,92,142,71,64,49,78,59,357,82,111,56,246,89,15413
15000US060710038032,696,90,174,65,59,46,115,57,522,100,205,70,317,86,15414
15000US060710038041,301,91,106,63,50,53,56,43,195,71,37,24,158,72,15415
15000US060710038042,340,84,24,25,24,25,0,12,316,82,92,53,224,79,15416
15000US060710038043,483,88,81,66,21,27,60,56,402,83,133,57,269,91,15417
15000US060710039001,623,78,177,69,69,46,108,69,446,83,102,39,344,84,15418
15000US060710039002,460,78,108,51,29,26,79,45,352,85,76,47,276,88,15419
15000US060710039003,313,68,21,18,21,18,0,12,292,67,104,57,188,62,15420
15000US060710040011,644,72,120,50,33,27,87,43,524,76,183,55,341,85,15421
15000US060710040012,356,67,66,42,24,22,42,35,290,66,130,43,160,63,15422
15000US060710040031,449,99,58,51,12,20,46,47,391,94,113,55,278,95,15423
15000US060710040032,914,103,262,108,103,67,159,80,652,141,180,89,472,120,15424
15000US060710040041,801,94,190,86,116,66,74,58,611,104,170,70,441,106,15425
15000US060710040042,707,102,101,62,26,26,75,59,606,101,280,94,326,104,15426
15000US060710041011,701,93,134,62,51,46,83,58,567,101,42,34,525,96,15427
15000US060710041012,635,102,228,79,125,72,103,64,407,114,42,38,365,111,15428
15000US060710041031,447,79,158,68,51,30,107,67,289,79,111,58,178,80,15429
15000US060710041032,310,94,125,70,48,48,77,60,185,79,27,24,158,79,15430
15000US060710041033,499,104,131,69,21,28,110,64,368,110,66,40,302,104,15431
15000US060710041041,537,94,235,85,30,25,205,82,302,97,100,48,202,88,15432
15000US060710041042,602,97,195,88,100,65,95,70,407,95,140,62,267,92,15433
15000US060710042011,312,90,110,75,68,65,42,43,202,77,101,57,101,57,15434
15000US060710042012,294,91,98,66,27,36,71,55,196,73,42,39,154,68,15435
15000US060710042013,495,122,260,116,98,77,162,89,235,73,84,41,151,58,15436
15000US060710042014,504,116,178,68,38,37,140,80,326,106,98,53,228,101,15437
15000US060710042021,547,92,165,70,106,57,59,55,382,77,174,53,208,77,15438
15000US060710042022,461,80,159,66,93,57,66,41,302,79,131,63,171,65,15439
15000US060710042023,384,85,96,69,23,35,73,61,288,75,82,54,206,71,15440
15000US060710043011,443,110,117,82,32,48,85,66,326,89,97,64,229,72,15441
15000US060710043012,175,74,70,59,21,36,49,51,105,46,27,26,78,45,15442
15000US060710043013,454,102,164,79,83,59,81,58,290,81,114,54,176,70,15443
15000US060710043021,331,75,150,77,24,24,126,76,181,58,69,37,112,55,15444
15000US060710043022,168,64,33,29,11,18,22,24,135,61,27,24,108,59,15445
15000US060710043023,614,104,192,80,74,57,118,70,422,106,150,62,272,96,15446
15000US060710044011,358,80,148,66,68,54,80,47,210,77,52,34,158,72,15447
15000US060710044012,418,76,116,57,47,39,69,45,302,85,79,49,223,80,15448
15000US060710044013,332,85,62,56,7,14,55,54,270,83,40,40,230,76,15449
15000US060710044031,477,98,51,45,7,11,44,44,426,96,64,40,362,98,15450
15000US060710044032,207,60,45,31,29,27,16,17,162,61,91,53,71,49,15451
15000US060710044033,701,108,234,101,91,66,143,75,467,118,56,42,411,110,15452
15000US060710044041,548,80,238,86,143,72,95,59,310,92,131,66,179,74,15453
15000US060710044042,265,64,92,60,0,12,92,60,173,56,47,26,126,49,15454
15000US060710044043,618,89,189,65,39,32,150,56,429,87,73,48,356,94,15455
15000US060710045031,684,74,8,12,0,12,8,12,676,75,154,73,522,95,15456
15000US060710045032,354,80,8,18,7,11,1,12,346,83,142,64,204,78,15457
15000US060710045041,659,159,132,100,41,67,91,88,527,151,106,81,421,140,15458
15000US060710045042,584,107,18,24,6,13,12,21,566,109,143,75,423,115,15459
15000US060710045043,1134,164,178,100,105,81,73,64,956,181,187,101,769,162,15460
15000US060710045051,529,76,67,50,17,25,50,43,462,83,71,41,391,82,15461
15000US060710045052,444,84,133,61,30,36,103,55,311,86,144,84,167,64,15462
15000US060710045053,540,92,275,93,146,81,129,69,265,72,66,32,199,67,15463
15000US060710045071,413,89,81,61,35,43,46,44,332,82,57,35,275,87,15464
15000US060710045072,625,108,234,95,70,63,164,80,391,117,97,56,294,113,15465
15000US060710045073,485,94,118,71,42,41,76,61,367,83,84,47,283,81,15466
15000US060710045091,471,70,145,61,44,37,101,57,326,69,72,38,254,64,15467
15000US060710045092,470,78,98,60,37,28,61,51,372,76,121,65,251,73,15468
15000US060710045093,471,70,34,26,19,20,15,16,437,75,179,62,258,76,15469
15000US060710045101,252,67,58,45,25,34,33,36,194,65,27,23,167,67,15470
15000US060710045102,432,108,80,57,9,15,71,55,352,111,16,23,336,114,15471
15000US060710045103,377,96,120,73,33,33,87,67,257,86,56,51,201,85,15472
15000US060710046011,453,121,54,56,41,52,13,19,399,117,117,78,282,121,15473
15000US060710046012,486,128,85,89,56,82,29,32,401,140,19,33,382,142,15474
15000US060710046013,490,141,17,26,0,12,17,26,473,138,17,28,456,139,15475
15000US060710046014,386,102,96,62,47,46,49,62,290,99,87,61,203,103,15476
15000US060710046015,281,95,0,12,0,12,0,12,281,95,75,48,206,96,15477
15000US060710046031,291,81,0,12,0,12,0,12,291,81,60,38,231,82,15478
15000US060710046032,289,91,45,43,12,22,33,38,244,88,41,38,203,84,15479
15000US060710046033,867,138,217,115,59,62,158,100,650,143,183,86,467,135,15480
15000US060710046034,653,136,108,71,77,64,31,31,545,133,222,98,323,156,15481
15000US060710046041,350,79,144,66,67,55,77,43,206,81,87,56,119,68,15482
15000US060710046042,359,84,143,64,28,35,115,56,216,61,97,54,119,49,15483
15000US060710046043,324,68,33,28,13,18,20,21,291,71,92,42,199,75,15484
15000US060710046044,413,87,88,55,79,54,9,14,325,88,96,39,229,73,15485
15000US060710047001,286,62,116,62,11,19,105,60,170,52,77,36,93,50,15486
15000US060710047002,247,73,97,55,24,26,73,52,150,62,46,34,104,55,15487
15000US060710047003,257,79,41,39,6,10,35,38,216,74,56,48,160,72,15488
15000US060710047004,257,60,88,53,36,35,52,44,169,59,12,13,157,59,15489
15000US060710047005,287,74,111,64,28,37,83,62,176,61,48,30,128,55,15490
15000US060710048001,469,66,177,46,78,41,99,41,292,71,104,43,188,56,15491
15000US060710048002,339,58,177,50,36,26,141,45,162,54,49,31,113,49,15492
15000US060710049001,265,52,68,43,0,12,68,43,197,47,80,38,117,48,15493
15000US060710049002,433,95,145,62,35,27,110,56,288,88,94,57,194,75,15494
15000US060710049003,698,79,392,92,90,57,302,88,306,77,126,60,180,71,15495
15000US060710049004,364,68,162,69,62,42,100,55,202,60,47,34,155,58,15496
15000US060710051001,335,79,11,18,0,12,11,18,324,80,124,83,200,73,15497
15000US060710051002,364,157,0,12,0,12,0,12,364,157,49,43,315,161,15498
15000US060710051003,298,110,11,18,0,12,11,18,287,114,96,79,191,89,15499
15000US060710051004,458,136,64,60,27,38,37,50,394,149,145,134,249,107,15500
15000US060710051005,330,112,76,69,76,69,0,12,254,87,94,54,160,88,15501
15000US060710051006,467,137,211,107,141,100,70,61,256,117,42,41,214,112,15502
15000US060710051007,368,128,81,83,0,12,81,83,287,122,108,90,179,104,15503
15000US060710052001,457,117,90,89,0,12,90,89,367,118,142,90,225,85,15504
15000US060710052002,354,82,55,42,32,40,23,28,299,80,98,57,201,68,15505
15000US060710052003,273,90,0,12,0,12,0,12,273,90,86,68,187,93,15506
15000US060710052004,215,52,32,32,24,27,8,15,183,47,51,34,132,47,15507
15000US060710053001,377,87,74,48,0,12,74,48,303,79,79,48,224,68,15508
15000US060710053002,362,73,118,64,30,25,88,55,244,80,68,48,176,72,15509
15000US060710053003,315,63,99,47,40,33,59,41,216,61,48,29,168,59,15510
15000US060710053004,303,80,70,50,46,43,24,28,233,74,77,44,156,70,15511
15000US060710053005,204,62,78,53,23,24,55,49,126,42,51,36,75,42,15512
15000US060710054001,483,93,213,77,103,61,110,59,270,80,117,65,153,67,15513
15000US060710054002,305,69,146,59,91,55,55,40,159,56,69,43,90,57,15514
15000US060710054003,465,84,170,75,73,54,97,56,295,76,43,34,252,80,15515
15000US060710054004,580,101,183,76,90,56,93,53,397,103,232,84,165,70,15516
15000US060710055001,576,159,274,115,115,81,159,98,302,128,141,88,161,93,15517
15000US060710055002,514,142,300,133,72,70,228,117,214,93,99,76,115,88,15518
15000US060710055003,559,135,242,118,143,81,99,87,317,144,119,73,198,125,15519
15000US060710055004,422,129,224,106,106,84,118,82,198,86,50,33,148,84,15520
15000US060710055005,215,95,145,91,54,57,91,89,70,64,14,20,56,58,15521
15000US060710056001,191,72,71,50,10,16,61,48,120,68,28,29,92,62,15522
15000US060710056002,394,104,257,110,25,34,232,104,137,72,52,45,85,53,15523
15000US060710056003,389,103,110,63,31,21,79,58,279,97,94,49,185,88,15524
15000US060710056004,507,94,199,78,80,50,119,63,308,98,118,64,190,95,15525
15000US060710056005,324,90,185,86,62,43,123,78,139,69,23,24,116,66,15526
15000US060710057011,534,76,136,48,78,40,58,37,398,66,196,56,202,75,15527
15000US060710057012,338,68,158,60,30,31,128,59,180,57,32,27,148,53,15528
15000US060710058001,472,70,254,66,116,61,138,62,218,66,82,43,136,61,15529
15000US060710058002,307,66,107,51,53,39,54,40,200,70,41,32,159,64,15530
15000US060710058003,337,68,112,53,20,20,92,52,225,58,46,30,179,62,15531
15000US060710061001,154,51,12,19,0,12,12,19,142,51,54,31,88,46,15532
15000US060710061002,250,102,72,71,0,12,72,71,178,82,46,55,132,73,15533
15000US060710061003,556,157,103,97,31,36,72,89,453,138,199,111,254,129,15534
15000US060710061004,397,161,149,120,0,12,149,120,248,127,151,116,97,82,15535
15000US060710061005,412,156,137,111,60,88,77,71,275,126,54,40,221,127,15536
15000US060710061006,453,170,84,65,79,65,5,11,369,177,74,48,295,171,15537
15000US060710061007,292,91,26,33,0,12,26,33,266,96,69,66,197,93,15538
15000US060710062011,233,62,27,31,16,25,11,18,206,51,70,52,136,43,15539
15000US060710062012,216,65,21,24,7,15,14,20,195,66,82,45,113,56,15540
15000US060710062013,509,85,133,61,20,23,113,53,376,87,166,68,210,87,15541
15000US060710062031,702,109,274,80,87,58,187,70,428,113,167,76,261,97,15542
15000US060710062032,770,114,361,98,152,72,209,82,409,90,188,75,221,73,15543
15000US060710062041,632,99,233,81,40,34,193,76,399,92,171,78,228,70,15544
15000US060710062042,624,107,340,93,196,80,144,76,284,82,110,50,174,73,15545
15000US060710063011,277,61,66,44,21,24,45,36,211,66,53,29,158,62,15546
15000US060710063012,244,64,59,44,33,29,26,34,185,58,124,62,61,32,15547
15000US060710063013,620,89,176,68,102,53,74,50,444,90,274,71,170,65,15548
15000US060710063014,305,82,89,52,19,30,70,45,216,73,100,50,116,64,15549
15000US060710063021,598,128,38,41,21,34,17,27,560,128,230,101,330,115,15550
15000US060710063022,451,128,65,62,16,25,49,56,386,125,139,92,247,112,15551
15000US060710063023,631,157,429,158,202,120,227,118,202,90,36,37,166,89,15552
15000US060710063024,489,116,117,90,46,59,71,72,372,132,249,115,123,88,15553
15000US060710063025,236,108,0,12,0,12,0,12,236,108,79,66,157,99,15554
15000US060710064011,245,51,175,49,49,30,126,40,70,30,60,31,10,8,15555
15000US060710064012,603,65,210,54,57,33,153,47,393,68,87,40,306,70,15556
15000US060710064021,726,109,320,115,139,81,181,87,406,110,132,75,274,91,15557
15000US060710064022,575,103,208,96,50,43,158,85,367,105,69,40,298,105,15558
15000US060710065001,394,87,224,84,69,49,155,73,170,61,60,46,110,51,15559
15000US060710065002,332,73,151,64,49,30,102,56,181,67,46,33,135,64,15560
15000US060710065003,576,115,332,112,80,64,252,106,244,85,112,61,132,77,15561
15000US060710065004,511,94,168,72,41,37,127,62,343,81,136,73,207,77,15562
15000US060710066011,588,104,146,76,86,64,60,48,442,118,108,61,334,117,15563
15000US060710066012,404,106,52,40,52,40,0,12,352,105,38,47,314,104,15564
15000US060710066013,390,106,80,48,28,23,52,41,310,108,33,30,277,109,15565
15000US060710066031,598,102,225,101,74,56,151,89,373,87,121,60,252,83,15566
15000US060710066032,841,105,80,39,63,36,17,19,761,110,106,49,655,105,15567
15000US060710066041,657,134,117,76,31,30,86,70,540,128,114,66,426,126,15568
15000US060710066042,468,113,97,63,22,22,75,56,371,106,81,45,290,102,15569
15000US060710067001,405,88,97,59,42,28,55,52,308,75,74,44,234,74,15570
15000US060710067002,257,83,81,62,11,19,70,60,176,65,34,32,142,64,15571
15000US060710067003,244,60,54,43,23,20,31,37,190,56,54,33,136,53,15572
15000US060710067004,306,83,89,54,61,45,28,33,217,77,49,35,168,80,15573
15000US060710070001,605,171,131,79,32,34,99,75,474,155,172,92,302,159,15574
15000US060710070002,522,179,116,118,0,12,116,118,406,156,143,134,263,129,15575
15000US060710070003,705,160,164,118,48,46,116,114,541,163,147,96,394,150,15576
15000US060710070004,322,110,41,51,30,48,11,18,281,107,91,56,190,105,15577
15000US060710071041,300,83,0,12,0,12,0,12,300,83,35,27,265,86,15578
15000US060710071042,316,71,17,28,0,12,17,28,299,69,35,29,264,69,15579
15000US060710071043,585,85,14,15,14,15,0,12,571,85,121,64,450,91,15580
15000US060710071044,263,51,12,19,12,19,0,12,251,51,61,39,190,59,15581
15000US060710071051,537,95,83,47,18,22,65,42,454,105,36,27,418,106,15582
15000US060710071052,605,86,64,53,23,30,41,42,541,90,169,76,372,82,15583
15000US060710071061,231,66,11,17,0,12,11,17,220,62,40,29,180,65,15584
15000US060710071062,291,69,29,25,11,13,18,20,262,68,100,52,162,54,15585
15000US060710071063,384,79,37,46,8,14,29,44,347,84,55,34,292,85,15586
15000US060710071064,464,82,34,30,13,18,21,22,430,86,104,53,326,81,15587
15000US060710071071,851,114,202,93,32,37,170,90,649,126,81,54,568,131,15588
15000US060710071072,242,58,92,46,15,17,77,47,150,51,42,34,108,45,15589
15000US060710071081,1002,80,142,54,51,33,91,42,860,98,154,59,706,96,15590
15000US060710071091,1043,152,78,52,28,34,50,40,965,158,123,100,842,159,15591
15000US060710071092,351,77,50,53,50,53,0,12,301,76,86,60,215,71,15592
15000US060710071093,581,193,151,121,32,57,119,105,430,189,77,96,353,156,15593
15000US060710071094,610,184,22,37,0,12,22,37,588,180,34,36,554,176,15594
15000US060710071101,416,99,25,32,17,28,8,14,391,95,19,23,372,94,15595
15000US060710071102,511,96,34,38,24,36,10,17,477,102,76,52,401,106,15596
15000US060710071103,541,97,51,38,29,34,22,20,490,93,39,29,451,93,15597
15000US060710072001,412,70,82,44,47,36,35,26,330,65,124,60,206,66,15598
15000US060710072002,317,77,142,72,62,45,80,58,175,71,42,37,133,71,15599
15000US060710072003,472,92,180,80,82,63,98,55,292,79,80,42,212,72,15600
15000US060710072004,407,68,55,43,24,28,31,29,352,78,72,34,280,83,15601
15000US060710073021,779,153,72,53,58,55,14,21,707,158,316,140,391,147,15602
15000US060710073022,315,72,16,25,0,12,16,25,299,76,118,59,181,78,15603
15000US060710073023,780,115,49,46,17,26,32,39,731,126,194,90,537,129,15604
15000US060710073024,727,115,51,38,51,38,0,12,676,129,191,77,485,135,15605
15000US060710073025,638,122,0,12,0,12,0,12,638,122,101,90,537,123,15606
15000US060710073026,277,72,0,12,0,12,0,12,277,72,105,55,172,66,15607
15000US060710073031,642,112,189,81,33,36,156,83,453,136,94,66,359,128,15608
15000US060710073032,670,115,91,62,52,56,39,31,579,110,86,65,493,103,15609
15000US060710073033,555,89,37,36,10,16,27,31,518,97,39,35,479,100,15610
15000US060710073051,1059,97,283,100,141,87,142,78,776,122,207,82,569,143,15611
15000US060710073052,443,96,126,61,8,13,118,59,317,96,59,55,258,90,15612
15000US060710073061,1046,196,0,12,0,12,0,12,1046,196,243,105,803,177,15613
15000US060710073062,1033,147,59,60,0,12,59,60,974,152,135,89,839,141,15614
15000US060710074031,521,144,78,87,0,12,78,87,443,143,141,107,302,111,15615
15000US060710074032,537,169,120,107,0,12,120,107,417,146,104,85,313,148,15616
15000US060710074033,520,178,171,131,51,77,120,110,349,171,63,57,286,164,15617
15000US060710074034,503,152,97,88,86,83,11,19,406,128,70,55,336,136,15618
15000US060710074035,273,90,62,56,48,55,14,24,211,86,61,52,150,94,15619
15000US060710074041,244,59,19,20,11,18,8,12,225,58,90,55,135,43,15620
15000US060710074042,390,74,29,25,11,17,18,18,361,77,155,67,206,59,15621
15000US060710074043,245,64,0,12,0,12,0,12,245,64,92,36,153,61,15622
15000US060710074044,369,75,28,22,2,7,26,20,341,80,143,78,198,74,15623
15000US060710074045,211,59,10,15,10,15,0,12,201,63,55,42,146,55,15624
15000US060710074071,327,49,181,48,45,24,136,48,146,43,67,36,79,34,15625
15000US060710074072,334,56,49,25,11,11,38,24,285,59,68,41,217,54,15626
15000US060710074073,156,34,76,30,14,16,62,29,80,26,20,14,60,23,15627
15000US060710074081,414,92,88,64,8,13,80,62,326,84,143,75,183,80,15628
15000US060710074082,822,112,272,108,118,77,154,87,550,115,74,44,476,109,15629
15000US060710074091,662,110,106,69,75,60,31,28,556,117,147,54,409,110,15630
15000US060710074092,550,93,164,84,63,43,101,75,386,100,39,28,347,105,15631
15000US060710074093,465,85,20,17,14,17,6,9,445,83,114,50,331,80,15632
15000US060710074101,255,76,23,31,11,18,12,24,232,80,60,57,172,84,15633
15000US060710074102,653,97,7,15,7,15,0,12,646,98,302,88,344,103,15634
15000US060710074103,984,193,159,105,24,32,135,109,825,204,57,51,768,210,15635
15000US060710076011,633,105,289,91,98,76,191,83,344,97,94,66,250,77,15636
15000US060710076012,566,124,256,101,56,37,200,99,310,117,78,55,232,106,15637
15000US060710076013,425,99,197,86,48,43,149,75,228,85,37,40,191,80,15638
15000US060710076014,300,75,58,45,8,13,50,44,242,77,55,48,187,72,15639
15000US060710076031,419,109,172,82,43,38,129,85,247,73,61,41,186,69,15640
15000US060710076032,459,89,73,46,29,26,44,39,386,84,145,62,241,91,15641
15000US060710076033,564,105,153,82,0,12,153,82,411,126,90,49,321,126,15642
15000US060710076041,251,57,62,50,62,50,0,12,189,58,82,35,107,52,15643
15000US060710076042,388,113,55,51,46,49,9,16,333,102,111,69,222,92,15644
15000US060710076043,652,112,86,60,0,12,86,60,566,119,238,79,328,121,15645
15000US060710078001,712,197,103,91,42,47,61,81,609,193,81,83,528,191,15646
15000US060710078002,1026,190,51,43,51,43,0,12,975,185,159,96,816,179,15647
15000US060710078003,460,155,123,110,15,26,108,109,337,115,70,62,267,94,15648
15000US060710079011,277,97,17,26,0,12,17,26,260,96,76,51,184,81,15649
15000US060710079012,399,84,0,12,0,12,0,12,399,84,61,51,338,80,15650
15000US060710079013,541,85,0,12,0,12,0,12,541,85,157,72,384,102,15651
15000US060710079014,1326,135,13,22,0,12,13,22,1313,136,215,78,1098,152,15652
15000US060710079031,527,90,24,26,0,12,24,26,503,92,67,47,436,92,15653
15000US060710079032,460,71,19,21,9,13,10,16,441,66,100,42,341,71,15654
15000US060710079033,421,80,79,57,11,17,68,53,342,91,95,56,247,88,15655
15000US060710079041,404,101,0,12,0,12,0,12,404,101,57,52,347,104,15656
15000US060710079042,616,127,15,24,15,24,0,12,601,130,102,72,499,138,15657
15000US060710079043,1020,144,86,96,0,12,86,96,934,136,180,114,754,132,15658
15000US060710080011,340,85,60,56,20,20,40,50,280,77,153,52,127,65,15659
15000US060710080012,517,107,77,56,27,27,50,50,440,107,67,51,373,103,15660
15000US060710080013,1247,114,75,59,9,15,66,57,1172,123,249,75,923,113,15661
15000US060710080021,165,77,28,33,28,33,0,12,137,87,49,67,88,54,15662
15000US060710080022,237,88,77,65,20,27,57,69,160,64,115,66,45,40,15663
15000US060710080023,262,83,99,65,32,37,67,68,163,85,34,33,129,82,15664
15000US060710080024,620,119,284,119,26,29,258,120,336,114,15,25,321,112,15665
15000US060710080025,370,116,75,51,14,23,61,50,295,118,73,51,222,122,15666
15000US060710080026,438,112,68,43,13,23,55,43,370,114,88,60,282,106,15667
15000US060710081001,393,86,11,15,3,7,8,13,382,89,37,43,345,86,15668
15000US060710081002,1040,127,212,90,68,37,144,88,828,144,246,90,582,141,15669
15000US060710082001,1040,181,126,94,0,12,126,94,914,170,174,91,740,162,15670
15000US060710082002,623,112,0,12,0,12,0,12,623,112,234,89,389,104,15671
15000US060710082003,282,94,0,12,0,12,0,12,282,94,45,36,237,90,15672
15000US060710082004,550,112,46,73,0,12,46,73,504,102,80,52,424,108,15673
15000US060710083011,280,93,16,27,16,27,0,12,264,89,70,53,194,82,15674
15000US060710083012,386,102,18,29,18,29,0,12,368,98,26,29,342,96,15675
15000US060710083013,840,165,0,12,0,12,0,12,840,165,166,102,674,155,15676
15000US060710083014,393,82,0,12,0,12,0,12,393,82,66,46,327,86,15677
15000US060710083015,400,117,20,32,0,12,20,32,380,117,91,60,289,123,15678
15000US060710083021,322,59,51,43,40,49,11,18,271,57,53,32,218,64,15679
15000US060710083022,316,69,29,44,29,44,0,12,287,68,54,36,233,64,15680
15000US060710083023,527,76,0,12,0,12,0,12,527,76,152,60,375,70,15681
15000US060710084011,646,151,13,20,13,20,0,12,633,152,55,57,578,145,15682
15000US060710084012,502,110,0,12,0,12,0,12,502,110,145,78,357,111,15683
15000US060710084013,728,158,14,24,0,12,14,24,714,159,65,56,649,142,15684
15000US060710084014,454,115,34,39,16,25,18,30,420,115,73,48,347,128,15685
15000US060710084015,565,108,41,39,27,30,14,23,524,109,67,55,457,112,15686
15000US060710084021,262,104,54,59,0,12,54,59,208,87,58,47,150,73,15687
15000US060710084022,765,136,25,33,25,33,0,12,740,139,106,77,634,137,15688
15000US060710084023,547,133,20,31,20,31,0,12,527,130,186,108,341,103,15689
15000US060710084024,477,92,51,45,33,35,18,28,426,87,125,72,301,99,15690
15000US060710084031,462,102,0,12,0,12,0,12,462,102,128,77,334,109,15691
15000US060710084032,655,111,75,56,0,12,75,56,580,126,159,114,421,115,15692
15000US060710084033,529,120,0,12,0,12,0,12,529,120,85,66,444,116,15693
15000US060710084034,417,104,57,58,0,12,57,58,360,110,19,30,341,120,15694
15000US060710084041,294,74,70,41,49,38,21,25,224,74,27,24,197,72,15695
15000US060710084042,704,97,188,64,34,24,154,61,516,88,140,67,376,85,15696
15000US060710085001,955,108,0,12,0,12,0,12,955,108,192,75,763,130,15697
15000US060710085002,342,68,0,12,0,12,0,12,342,68,45,34,297,72,15698
15000US060710085003,728,101,35,39,35,39,0,12,693,108,102,54,591,122,15699
15000US060710085004,602,115,12,20,12,20,0,12,590,116,80,51,510,125,15700
15000US060710085005,202,56,0,12,0,12,0,12,202,56,55,37,147,56,15701
15000US060710086011,389,94,49,50,20,32,29,46,340,86,58,37,282,92,15702
15000US060710086012,363,100,70,62,33,49,37,38,293,92,80,43,213,89,15703
15000US060710086013,596,87,27,26,18,21,9,14,569,89,105,49,464,100,15704
15000US060710086014,667,118,39,31,21,23,18,20,628,117,111,56,517,126,15705
15000US060710086021,758,93,85,63,50,43,35,44,673,100,136,68,537,93,15706
15000US060710086022,634,80,77,38,13,18,64,39,557,85,167,78,390,91,15707
15000US060710087031,717,119,21,32,0,12,21,32,696,123,175,82,521,110,15708
15000US060710087032,484,100,43,49,15,24,28,40,441,98,135,66,306,107,15709
15000US060710087033,814,146,17,28,0,12,17,28,797,147,171,83,626,142,15710
15000US060710087034,612,130,29,33,0,12,29,33,583,131,108,55,475,129,15711
15000US060710087041,554,127,20,33,0,12,20,33,534,126,165,78,369,122,15712
15000US060710087042,492,125,0,12,0,12,0,12,492,125,32,43,460,133,15713
15000US060710087043,501,121,103,80,42,51,61,66,398,122,180,71,218,127,15714
15000US060710087044,831,153,107,77,45,38,62,72,724,142,200,83,524,145,15715
15000US060710087045,383,130,82,91,0,12,82,91,301,122,95,79,206,109,15716
15000US060710087051,423,94,98,63,69,50,29,36,325,98,162,85,163,66,15717
15000US060710087052,367,97,26,25,18,21,8,14,341,98,143,71,198,86,15718
15000US060710087053,429,93,68,42,39,32,29,26,361,90,123,67,238,87,15719
15000US060710087054,410,88,46,35,28,33,18,20,364,86,125,53,239,87,15720
15000US060710087061,703,145,60,59,40,48,20,32,643,154,205,112,438,147,15721
15000US060710087062,1520,267,105,107,29,50,76,116,1415,255,550,271,865,257,15722
15000US060710087063,1188,244,86,86,53,60,33,62,1102,268,196,143,906,277,15723
15000US060710087064,437,119,0,12,0,12,0,12,437,119,77,69,360,123,15724
15000US060710087065,555,165,61,72,20,33,41,63,494,166,38,43,456,174,15725
15000US060710087081,411,72,54,44,0,12,54,44,357,82,120,56,237,76,15726
15000US060710087082,548,70,41,33,12,20,29,26,507,74,72,39,435,80,15727
15000US060710087083,397,76,53,44,16,18,37,40,344,79,67,42,277,78,15728
15000US060710087091,223,69,13,16,5,9,8,13,210,70,90,55,120,57,15729
15000US060710087092,518,88,158,66,28,25,130,66,360,84,104,69,256,76,15730
15000US060710087093,423,100,109,66,20,24,89,64,314,89,144,56,170,82,15731
15000US060710087094,357,76,34,30,8,12,26,27,323,80,82,35,241,77,15732
15000US060710087101,633,121,114,62,30,28,84,56,519,115,239,94,280,96,15733
15000US060710087102,700,124,240,91,94,54,146,80,460,120,153,83,307,97,15734
15000US060710087103,519,95,73,57,8,12,65,60,446,87,119,52,327,78,15735
15000US060710088001,493,122,36,40,19,28,17,28,457,127,87,58,370,129,15736
15000US060710088002,807,184,155,94,16,26,139,87,652,197,128,100,524,189,15737
15000US060710088003,676,149,120,94,43,42,77,89,556,137,104,66,452,145,15738
15000US060710088004,233,69,20,34,0,12,20,34,213,66,51,44,162,75,15739
15000US060710089011,315,65,49,35,30,32,19,14,266,64,66,29,200,57,15740
15000US060710089012,165,55,53,46,53,46,0,12,112,37,22,16,90,36,15741
15000US060710089013,383,54,59,31,23,16,36,27,324,57,118,40,206,46,15742
15000US060710091071,1097,204,59,60,32,51,27,34,1038,199,328,136,710,203,15743
15000US060710091072,525,136,164,95,82,78,82,73,361,130,91,81,270,132,15744
15000US060710091073,805,169,101,81,32,50,69,64,704,158,225,112,479,139,15745
15000US060710091081,655,164,131,86,51,51,80,74,524,172,76,60,448,175,15746
15000US060710091082,700,176,214,149,81,89,133,121,486,154,76,79,410,152,15747
15000US060710091083,816,180,129,108,63,91,66,59,687,187,231,145,456,161,15748
15000US060710091091,537,135,90,68,18,26,72,66,447,135,130,86,317,118,15749
15000US060710091092,528,133,46,74,0,12,46,74,482,138,69,58,413,143,15750
15000US060710091093,405,131,85,67,41,66,44,71,320,121,152,88,168,106,15751
15000US060710091094,556,142,139,99,53,47,86,87,417,124,87,60,330,134,15752
15000US060710091101,2543,279,472,200,250,134,222,137,2071,285,505,154,1566,280,15753
15000US060710091102,1706,262,434,163,104,99,330,149,1272,257,335,166,937,254,15754
15000US060710091121,2177,167,707,158,375,134,332,159,1470,190,540,155,930,207,15755
15000US060710091141,1506,180,638,226,312,183,326,145,868,219,246,102,622,195,15756
15000US060710091142,1138,213,251,122,94,69,157,101,887,203,244,90,643,196,15757
15000US060710091161,345,93,201,95,55,50,146,82,144,55,79,42,65,38,15758
15000US060710091162,475,127,312,114,101,69,211,99,163,81,90,60,73,68,15759
15000US060710091163,858,129,603,127,231,98,372,114,255,81,110,59,145,69,15760
15000US060710091164,446,129,229,108,108,71,121,83,217,76,104,58,113,56,15761
15000US060710091171,1007,135,357,118,107,59,250,96,650,151,175,77,475,132,15762
15000US060710091172,321,81,47,43,14,17,33,39,274,80,90,65,184,76,15763
15000US060710091173,300,84,127,72,44,42,83,59,173,83,12,19,161,81,15764
15000US060710091181,890,321,118,114,29,51,89,102,772,308,228,185,544,272,15765
15000US060710091182,2027,439,511,252,171,118,340,242,1516,390,254,140,1262,409,15766
15000US060710091183,3028,418,745,403,49,84,696,397,2283,480,574,379,1709,449,15767
15000US060710091191,521,127,54,43,38,49,16,25,467,128,102,67,365,116,15768
15000US060710091192,551,96,37,33,0,12,37,33,514,102,105,71,409,119,15769
15000US060710091193,662,137,64,48,20,22,44,43,598,139,235,94,363,113,15770
15000US060710092011,518,149,65,56,10,15,55,54,453,139,102,64,351,127,15771
15000US060710092012,633,139,126,83,21,35,105,83,507,128,93,58,414,118,15772
15000US060710092013,546,129,25,41,0,12,25,41,521,129,92,59,429,131,15773
15000US060710092021,529,65,21,16,14,11,7,10,508,64,93,39,415,68,15774
15000US060710092022,433,79,54,41,11,12,43,40,379,80,144,67,235,69,15775
15000US060710093001,456,58,126,67,21,18,105,59,330,68,109,44,221,69,15776
15000US060710094001,531,120,228,102,49,40,179,85,303,98,44,44,259,93,15777
15000US060710094002,704,124,339,98,210,76,129,71,365,111,143,73,222,93,15778
15000US060710095001,588,145,321,162,92,90,229,143,267,114,136,83,131,92,15779
15000US060710095002,309,102,136,97,96,77,40,64,173,72,107,61,66,48,15780
15000US060710095003,503,138,121,96,44,40,77,86,382,123,58,45,324,128,15781
15000US060710095004,692,172,399,163,115,85,284,156,293,118,122,59,171,109,15782
15000US060710095005,439,141,67,49,40,38,27,30,372,141,186,123,186,102,15783
15000US060710097071,1859,161,98,55,74,48,24,28,1761,165,837,159,924,188,15784
15000US060710097072,1034,138,109,116,38,46,71,98,925,150,136,70,789,142,15785
15000US060710097081,508,101,156,79,65,48,91,72,352,89,86,40,266,89,15786
15000US060710097082,901,127,227,94,55,54,172,79,674,134,168,69,506,125,15787
15000US060710097083,423,123,40,32,20,24,20,21,383,116,142,77,241,96,15788
15000US060710097091,897,118,346,99,107,51,239,104,551,135,239,85,312,119,15789
15000US060710097092,286,71,37,41,37,41,0,12,249,70,130,55,119,57,15790
15000US060710097093,691,106,141,53,72,45,69,44,550,102,221,95,329,95,15791
15000US060710097101,1229,197,578,161,188,109,390,160,651,151,356,136,295,124,15792
15000US060710097102,484,138,99,81,29,33,70,72,385,137,183,97,202,123,15793
15000US060710097103,330,108,140,90,84,81,56,50,190,82,61,45,129,77,15794
15000US060710097111,800,132,89,83,32,37,57,76,711,117,192,75,519,123,15795
15000US060710097112,934,149,52,43,14,22,38,37,882,145,300,119,582,121,15796
15000US060710097113,498,108,173,99,61,71,112,87,325,80,130,58,195,86,15797
15000US060710097114,870,157,133,77,29,36,104,70,737,153,358,134,379,126,15798
15000US060710097121,444,93,197,84,50,36,147,77,247,86,139,85,108,54,15799
15000US060710097122,641,98,83,52,23,22,60,49,558,104,119,53,439,116,15800
15000US060710097123,436,98,43,39,21,20,22,34,393,104,102,48,291,97,15801
15000US060710097124,522,97,154,86,22,24,132,84,368,80,123,67,245,75,15802
15000US060710097131,504,106,100,76,34,35,66,68,404,105,25,27,379,109,15803
15000US060710097132,469,104,32,42,14,25,18,35,437,101,203,92,234,114,15804
15000US060710097133,831,124,109,64,82,60,27,30,722,135,265,94,457,105,15805
15000US060710097134,369,97,79,43,23,33,56,31,290,96,116,81,174,73,15806
15000US060710097141,436,81,67,47,29,26,38,39,369,85,55,42,314,83,15807
15000US060710097142,303,89,97,65,44,30,53,58,206,73,64,43,142,67,15808
15000US060710097143,461,107,40,37,7,11,33,36,421,102,150,72,271,98,15809
15000US060710097151,531,128,170,107,102,78,68,82,361,115,105,61,256,107,15810
15000US060710097152,751,140,135,100,40,59,95,76,616,150,218,106,398,149,15811
15000US060710097153,388,117,14,24,0,12,14,24,374,124,125,80,249,122,15812
15000US060710097154,554,107,17,26,17,26,0,12,537,105,113,66,424,107,15813
15000US060710097155,598,124,0,12,0,12,0,12,598,124,215,81,383,113,15814
15000US060710097161,1140,165,295,126,96,62,199,112,845,181,224,91,621,172,15815
15000US060710097162,614,181,296,139,97,75,199,128,318,131,92,74,226,118,15816
15000US060710097163,568,161,211,125,147,96,64,77,357,131,149,71,208,108,15817
15000US060710097171,535,104,70,51,23,22,47,51,465,106,150,77,315,80,15818
15000US060710097172,792,94,64,43,11,14,53,43,728,105,200,71,528,100,15819
15000US060710098001,324,92,206,86,25,23,181,81,118,64,33,37,85,55,15820
15000US060710098002,250,71,113,73,15,17,98,71,137,53,60,48,77,46,15821
15000US060710098003,481,91,132,65,61,50,71,57,349,82,146,57,203,78,15822
15000US060710098004,369,91,97,46,23,26,74,40,272,87,77,50,195,78,15823
15000US060710099041,841,203,232,132,64,45,168,122,609,187,76,81,533,177,15824
15000US060710099042,720,166,253,110,58,64,195,100,467,145,183,76,284,129,15825
15000US060710099043,2255,261,697,207,278,116,419,194,1558,279,303,118,1255,274,15826
15000US060710099051,950,157,500,173,162,108,338,139,450,143,89,59,361,136,15827
15000US060710099052,431,118,63,42,13,23,50,35,368,118,116,60,252,122,15828
15000US060710099053,651,127,168,98,31,46,137,89,483,107,169,84,314,104,15829
15000US060710099061,440,80,52,61,5,8,47,61,388,78,153,67,235,75,15830
15000US060710099062,834,112,231,102,67,37,164,95,603,112,86,42,517,108,15831
15000US060710099081,744,114,191,69,46,43,145,67,553,100,186,64,367,94,15832
15000US060710099082,622,107,27,30,0,12,27,30,595,101,159,66,436,98,15833
15000US060710099101,515,83,87,61,44,42,43,45,428,90,83,46,345,96,15834
15000US060710099102,863,95,304,102,101,54,203,100,559,112,215,76,344,95,15835
15000US060710099111,1152,113,250,96,76,56,174,85,902,133,175,65,727,127,15836
15000US060710099112,751,107,136,62,14,16,122,61,615,116,123,69,492,123,15837
15000US060710099121,575,130,240,113,124,76,116,93,335,122,168,93,167,83,15838
15000US060710099122,540,121,165,97,91,68,74,79,375,86,181,62,194,78,15839
15000US060710099123,556,110,108,74,45,37,63,62,448,101,138,63,310,87,15840
15000US060710099131,737,121,220,76,82,50,138,70,517,123,240,96,277,101,15841
15000US060710099132,873,142,204,83,67,41,137,71,669,125,161,67,508,115,15842
15000US060710100041,476,137,11,18,11,18,0,12,465,140,131,105,334,125,15843
15000US060710100042,500,146,0,12,0,12,0,12,500,146,136,86,364,153,15844
15000US060710100043,281,101,29,46,0,12,29,46,252,110,57,54,195,112,15845
15000US060710100044,813,160,39,43,39,43,0,12,774,167,105,82,669,168,15846
15000US060710100045,559,167,43,52,0,12,43,52,516,173,78,59,438,171,15847
15000US060710100091,615,95,86,69,65,64,21,22,529,96,156,74,373,90,15848
15000US060710100092,498,107,99,69,17,27,82,65,399,104,92,64,307,97,15849
15000US060710100101,353,100,62,50,6,10,56,49,291,98,95,82,196,75,15850
15000US060710100102,464,95,92,66,19,32,73,57,372,83,144,74,228,68,15851
15000US060710100103,606,121,169,75,72,55,97,69,437,135,51,40,386,131,15852
15000US060710100104,468,103,154,84,74,54,80,64,314,82,138,54,176,70,15853
15000US060710100111,390,102,156,75,41,34,115,69,234,89,102,62,132,69,15854
15000US060710100112,536,100,218,82,55,35,163,74,318,90,72,42,246,91,15855
15000US060710100113,441,91,162,81,52,45,110,69,279,86,50,40,229,84,15856
15000US060710100121,302,91,120,79,56,58,64,59,182,61,28,26,154,56,15857
15000US060710100122,493,91,105,51,45,33,60,45,388,90,62,35,326,93,15858
15000US060710100123,558,75,112,58,57,38,55,54,446,82,130,61,316,87,15859
15000US060710100131,600,143,263,130,92,58,171,121,337,109,68,49,269,107,15860
15000US060710100132,590,159,71,58,30,35,41,48,519,157,218,131,301,119,15861
15000US060710100133,423,103,14,21,14,21,0,12,409,109,186,105,223,90,15862
15000US060710100134,624,158,229,140,11,19,218,138,395,112,146,72,249,99,15863
15000US060710100141,263,64,65,51,16,20,49,47,198,56,16,18,182,56,15864
15000US060710100142,575,106,243,108,63,42,180,101,332,105,93,77,239,93,15865
15000US060710100143,458,102,168,89,36,30,132,89,290,90,29,20,261,88,15866
15000US060710100151,752,106,193,88,48,46,145,81,559,108,119,53,440,106,15867
15000US060710100152,872,111,111,55,39,27,72,48,761,121,283,92,478,127,15868
15000US060710100161,848,111,216,99,35,34,181,95,632,142,185,75,447,121,15869
15000US060710100162,660,112,106,69,77,64,29,29,554,122,101,59,453,125,15870
15000US060710100171,649,248,97,109,36,44,61,99,552,240,99,81,453,237,15871
15000US060710100172,2731,285,309,164,171,148,138,107,2422,330,445,229,1977,322,15872
15000US060710100173,849,267,101,121,101,121,0,12,748,259,237,161,511,251,15873
15000US060710100181,1145,112,193,75,103,56,90,57,952,126,281,93,671,126,15874
15000US060710100182,797,91,186,73,84,49,102,58,611,107,219,73,392,98,15875
15000US060710100191,552,75,62,43,35,35,27,33,490,81,84,49,406,89,15876
15000US060710100192,562,94,149,63,57,44,92,57,413,93,97,39,316,89,15877
15000US060710100193,364,66,75,42,22,22,53,38,289,64,52,33,237,66,15878
15000US060710100201,529,102,40,47,0,12,40,47,489,112,190,87,299,105,15879
15000US060710100202,1107,195,331,132,58,57,273,119,776,158,162,90,614,152,15880
15000US060710100203,934,147,330,146,64,57,266,131,604,146,231,88,373,133,15881
15000US060710100211,550,119,29,35,29,35,0,12,521,113,119,68,402,120,15882
15000US060710100212,752,145,121,72,64,48,57,55,631,149,165,63,466,153,15883
15000US060710100213,789,144,119,67,50,46,69,52,670,156,226,101,444,164,15884
15000US060710100221,886,114,194,83,110,71,84,56,692,109,263,77,429,121,15885
15000US060710100222,544,96,40,31,33,29,7,11,504,94,74,39,430,95,15886
15000US060710100231,711,101,93,57,24,23,69,54,618,106,112,46,506,109,15887
15000US060710100232,1037,107,138,80,54,56,84,60,899,120,221,75,678,128,15888
15000US060710100241,269,76,86,62,36,34,50,55,183,69,24,22,159,72,15889
15000US060710100242,736,81,68,49,28,28,40,41,668,89,165,78,503,104,15890
15000US060710100243,709,99,9,12,4,7,5,8,700,99,214,78,486,95,15891
15000US060710100251,1146,198,222,147,84,65,138,135,924,189,214,92,710,179,15892
15000US060710100252,1101,171,217,113,86,64,131,98,884,195,313,157,571,182,15893
15000US060710100261,1974,244,533,204,154,119,379,177,1441,226,290,128,1151,233,15894
15000US060710100262,1294,181,207,113,136,101,71,48,1087,169,475,138,612,129,15895
15000US060710103001,253,56,62,35,33,28,29,21,191,56,7,7,184,55,15896
15000US060710103002,423,106,19,23,11,19,8,12,404,107,73,53,331,108,15897
15000US060710103003,231,88,28,25,20,22,8,12,203,83,38,37,165,82,15898
15000US060710103004,309,73,10,15,0,12,10,15,299,74,101,55,198,70,15899
15000US060710104021,1694,150,0,17,0,17,0,17,1694,150,104,78,1590,155,15900
15000US060710104091,755,117,72,45,45,34,27,26,683,125,169,71,514,124,15901
15000US060710104092,459,129,157,77,68,35,89,66,302,113,149,97,153,75,15902
15000US060710104101,703,97,103,60,68,52,35,34,600,88,220,85,380,100,15903
15000US060710104102,602,108,149,90,98,89,51,35,453,108,132,74,321,93,15904
15000US060710104111,407,110,31,36,16,25,15,25,376,107,73,49,303,97,15905
15000US060710104112,1192,172,348,152,151,101,197,122,844,192,136,93,708,167,15906
15000US060710104113,584,154,87,72,36,39,51,61,497,140,170,91,327,118,15907
15000US060710104114,639,157,77,93,64,90,13,21,562,133,313,127,249,108,15908
15000US060710104121,997,213,137,88,48,51,89,87,860,221,220,92,640,221,15909
15000US060710104122,532,129,77,89,21,32,56,86,455,127,181,104,274,115,15910
15000US060710104123,1466,213,81,78,25,41,56,85,1385,201,497,180,888,174,15911
15000US060710104131,931,192,71,54,44,43,27,33,860,198,408,182,452,172,15912
15000US060710104132,238,110,0,12,0,12,0,12,238,110,98,73,140,88,15913
15000US060710104133,796,190,64,55,12,20,52,49,732,187,292,132,440,186,15914
15000US060710104134,604,139,107,94,107,94,0,12,497,160,121,99,376,128,15915
15000US060710104151,560,166,42,57,42,57,0,12,518,175,120,101,398,147,15916
15000US060710104152,1036,198,177,100,111,86,66,70,859,202,317,143,542,194,15917
15000US060710104153,546,128,159,123,72,81,87,78,387,140,189,114,198,101,15918
15000US060710104161,748,122,48,50,12,19,36,51,700,120,162,78,538,126,15919
15000US060710104162,250,91,57,57,23,24,34,52,193,88,62,53,131,69,15920
15000US060710104163,527,135,92,65,49,55,43,46,435,130,211,106,224,90,15921
15000US060710104171,728,99,89,48,82,48,7,10,639,100,141,61,498,108,15922
15000US060710104172,351,83,15,16,6,10,9,13,336,86,122,56,214,78,15923
15000US060710104173,261,76,8,12,8,12,0,12,253,74,85,61,168,63,15924
15000US060710104191,650,139,85,85,31,35,54,75,565,146,258,110,307,134,15925
15000US060710104192,491,147,36,59,36,59,0,12,455,145,290,132,165,85,15926
15000US060710104193,673,134,104,74,15,26,89,69,569,143,71,56,498,143,15927
15000US060710104201,571,143,120,93,9,14,111,91,451,134,145,81,306,126,15928
15000US060710104202,499,116,80,46,30,28,50,35,419,122,144,81,275,98,15929
15000US060710104203,619,133,235,99,121,67,114,86,384,123,174,81,210,105,15930
15000US060710104211,882,167,295,180,15,27,280,178,587,196,216,149,371,159,15931
15000US060710104212,1698,237,427,148,67,107,360,188,1271,268,425,177,846,251,15932
15000US060710104221,124,50,50,39,0,12,50,39,74,42,8,11,66,43,15933
15000US060710104222,468,71,43,27,26,19,17,20,425,72,115,48,310,63,15934
15000US060710104231,607,131,89,50,31,23,58,48,518,123,212,98,306,101,15935
15000US060710104232,501,129,97,62,69,53,28,28,404,110,184,80,220,81,15936
15000US060710104233,416,103,40,32,33,31,7,12,376,102,165,68,211,84,15937
15000US060710104241,206,57,89,47,41,28,48,39,117,43,62,33,55,38,15938
15000US060710104242,654,93,37,27,24,24,13,15,617,87,219,61,398,75,15939
15000US060710107001,314,90,69,46,37,29,32,32,245,89,126,60,119,69,15940
15000US060710107002,739,143,159,83,131,83,28,32,580,151,233,87,347,138,15941
15000US060710107003,544,95,95,58,23,23,72,56,449,109,115,71,334,118,15942
15000US060710108021,459,118,109,83,15,22,94,83,350,105,127,80,223,101,15943
15000US060710108022,362,121,15,25,15,25,0,12,347,120,131,84,216,112,15944
15000US060710108023,327,120,30,49,0,12,30,49,297,114,125,83,172,96,15945
15000US060710108024,304,117,31,46,0,12,31,46,273,122,123,87,150,108,15946
15000US060710108025,512,161,87,80,27,44,60,66,425,148,114,78,311,133,15947
15000US060710108031,262,83,29,26,0,12,29,26,233,82,21,24,212,82,15948
15000US060710108032,246,91,5,9,0,12,5,9,241,90,31,28,210,86,15949
15000US060710108033,304,96,18,28,0,12,18,28,286,99,164,82,122,68,15950
15000US060710108034,329,89,24,37,24,37,0,12,305,88,82,62,223,73,15951
15000US060710108041,449,102,40,45,22,36,18,28,409,113,91,64,318,96,15952
15000US060710108042,496,110,66,45,10,15,56,43,430,106,115,61,315,96,15953
15000US060710108043,132,60,0,12,0,12,0,12,132,60,31,36,101,55,15954
15000US060710109011,270,102,0,12,0,12,0,12,270,102,89,75,181,104,15955
15000US060710109012,221,104,29,47,0,12,29,47,192,93,48,57,144,80,15956
15000US060710109013,825,182,61,60,61,60,0,12,764,182,266,130,498,147,15957
15000US060710109014,205,128,0,12,0,12,0,12,205,128,46,56,159,115,15958
15000US060710109015,322,144,0,12,0,12,0,12,322,144,126,92,196,113,15959
15000US060710109021,278,106,0,12,0,12,0,12,278,106,53,49,225,94,15960
15000US060710109022,219,81,26,31,18,28,8,13,193,75,0,12,193,75,15961
15000US060710109023,185,82,24,38,0,12,24,38,161,73,69,56,92,58,15962
15000US060710109024,306,104,0,12,0,12,0,12,306,104,60,48,246,94,15963
15000US060710109025,140,64,19,29,19,29,0,12,121,60,18,19,103,57,15964
15000US060710110011,222,72,20,22,10,15,10,17,202,69,52,37,150,58,15965
15000US060710110012,288,70,20,22,9,14,11,17,268,68,48,28,220,64,15966
15000US060710110013,335,80,72,39,10,16,62,36,263,71,62,33,201,62,15967
15000US060710110021,269,43,12,12,5,7,7,9,257,43,69,29,188,44,15968
15000US060710110022,287,76,35,31,12,18,23,26,252,71,82,51,170,61,15969
15000US060710111011,347,100,0,12,0,12,0,12,347,100,85,46,262,97,15970
15000US060710111012,346,87,15,25,0,12,15,25,331,84,62,34,269,86,15971
15000US060710111013,339,84,28,32,0,12,28,32,311,80,85,45,226,68,15972
15000US060710111014,386,104,8,12,8,12,0,12,378,102,100,64,278,83,15973
15000US060710111021,266,66,18,21,0,12,18,21,248,64,56,33,192,58,15974
15000US060710111022,368,84,43,33,10,16,33,29,325,85,93,47,232,78,15975
15000US060710111023,124,57,11,18,0,12,11,18,113,54,41,32,72,44,15976
15000US060710112031,360,85,9,14,9,14,0,12,351,85,106,46,245,67,15977
15000US060710112032,180,53,37,28,28,24,9,14,143,50,13,16,130,51,15978
15000US060710112041,89,43,0,12,0,12,0,12,89,43,24,23,65,38,15979
15000US060710112042,202,67,10,15,0,12,10,15,192,66,72,38,120,50,15980
15000US060710112043,266,62,5,7,0,12,5,7,261,63,80,40,181,47,15981
15000US060710112051,228,60,20,21,10,15,10,15,208,58,49,30,159,61,15982
15000US060710112052,376,58,56,29,18,20,38,22,320,58,51,31,269,58,15983
15000US060710112061,174,61,0,12,0,12,0,12,174,61,49,41,125,50,15984
15000US060710112062,306,71,33,19,9,8,24,18,273,72,75,41,198,64,15985
15000US060710113001,154,76,0,12,0,12,0,12,154,76,37,33,117,70,15986
15000US060710113002,404,69,5,8,0,12,5,8,399,69,94,39,305,79,15987
15000US060710114011,594,138,61,51,19,23,42,46,533,134,232,100,301,104,15988
15000US060710114012,601,158,102,60,32,39,70,54,499,154,150,81,349,137,15989
15000US060710114013,250,102,8,12,0,12,8,12,242,103,91,64,151,87,15990
15000US060710114014,660,149,151,110,39,44,112,105,509,114,179,80,330,96,15991
15000US060710114031,338,119,32,37,0,12,32,37,306,114,85,59,221,105,15992
15000US060710114032,420,112,77,58,21,33,56,51,343,104,111,70,232,96,15993
15000US060710114033,331,77,35,40,0,12,35,40,296,69,110,46,186,65,15994
15000US060710114034,342,125,49,51,29,39,20,32,293,124,141,98,152,80,15995
15000US060710114041,758,124,0,12,0,12,0,12,758,124,216,84,542,109,15996
15000US060710114042,834,151,89,58,27,24,62,53,745,150,278,116,467,117,15997
15000US060710115001,291,68,18,21,18,21,0,12,273,70,61,35,212,64,15998
15000US060710115002,529,86,51,33,36,29,15,15,478,86,158,56,320,67,15999
15000US060710116001,568,189,184,119,86,81,98,89,384,165,194,98,190,146,16000
15000US060710116002,1435,245,52,65,16,26,36,59,1383,247,369,123,1014,250,16001
15000US060710116003,912,198,31,54,31,54,0,12,881,189,205,124,676,179,16002
15000US060710117001,454,65,94,38,33,23,61,31,360,55,146,45,214,59,16003
15000US060710118001,509,138,141,88,89,63,52,60,368,137,73,49,295,134,16004
15000US060710118002,385,129,71,59,24,37,47,48,314,132,89,57,225,120,16005
15000US060710118003,715,140,266,140,66,55,200,139,449,144,95,69,354,136,16006
15000US060710118004,649,129,25,30,9,15,16,25,624,124,149,79,475,140,16007
15000US060710119001,214,84,9,16,9,16,0,12,205,86,40,49,165,77,16008
15000US060710119002,94,61,0,12,0,12,0,12,94,61,10,16,84,59,16009
15000US060710119003,427,89,180,106,30,44,150,95,247,83,38,30,209,77,16010
15000US060710119004,376,102,9,15,9,15,0,12,367,100,117,54,250,98,16011
15000US060710120011,548,96,45,53,0,12,45,53,503,105,93,57,410,95,16012
15000US060710120012,779,121,159,75,80,49,79,53,620,126,160,80,460,120,16013
15000US060710120013,389,95,154,77,77,57,77,57,235,69,84,43,151,62,16014
15000US060710120021,50,37,0,12,0,12,0,12,50,37,0,12,50,37,16015
15000US060710120022,392,104,47,29,22,21,25,22,345,103,52,36,293,102,16016
15000US060710120023,357,85,133,78,63,51,70,63,224,69,95,51,129,63,16017
15000US060710120024,919,114,220,79,134,72,86,53,699,111,284,84,415,96,16018
15000US060710121011,272,82,37,43,18,29,19,32,235,77,67,45,168,67,16019
15000US060710121012,1478,162,147,95,40,31,107,85,1331,163,288,116,1043,185,16020
15000US060710121013,259,105,109,91,30,33,79,83,150,80,105,73,45,39,16021
15000US060710121031,582,159,142,81,39,33,103,76,440,140,222,100,218,101,16022
15000US060710121032,769,130,116,70,71,56,45,43,653,127,347,122,306,114,16023
15000US060710121041,668,154,224,100,158,95,66,52,444,140,192,79,252,108,16024
15000US060710121042,928,148,71,50,17,21,54,45,857,151,153,60,704,151,16025
15000US060710122001,777,65,21,22,0,19,21,22,756,69,58,40,698,73,16026
15000US060710123001,0,12,0,12,0,12,0,12,0,12,0,12,0,12,16027
15000US060710124001,430,61,99,49,10,13,89,47,331,58,120,42,211,47,16028
15000US060710124002,240,51,101,44,53,31,48,30,139,45,53,26,86,39,16029
15000US060710124003,248,48,74,35,37,22,37,28,174,44,63,35,111,42,16030
15000US060710125001,250,112,99,70,79,77,20,40,151,82,31,29,120,82,16031
15000US060710125002,349,108,77,69,55,60,22,35,272,111,85,72,187,107,16032
15000US060710125003,286,113,66,60,19,24,47,54,220,93,77,65,143,88,16033
15000US060710125004,377,118,186,103,51,53,135,92,191,85,31,41,160,80,16034
15000US060710127001,636,102,20,22,0,12,20,22,616,102,118,53,498,96,16035
15000US060710127002,639,83,77,59,37,38,40,50,562,96,66,36,496,103,16036
15000US060710250001,2337,195,34,39,0,17,34,39,2303,194,280,157,2023,230,16037
15000US060710251001,345,65,41,17,19,13,22,15,304,62,181,53,123,32,16038
15000US060710251002,300,54,59,20,31,16,28,16,241,52,120,40,121,45,16039
15000US060719401001,300,42,12,13,0,12,12,13,288,41,116,33,172,46,16040
15000US060719401002,405,58,60,28,31,19,29,21,345,52,134,37,211,47,16041
15000US060719801001,0,12,0,12,0,12,0,12,0,12,0,12,0,12,16042
15000US060719802001,0,12,0,12,0,12,0,12,0,12,0,12,0,12,16043
15000US060730001001,568,66,8,13,8,13,0,12,560,68,58,30,502,67,16044
15000US060730001002,720,74,0,12,0,12,0,12,720,74,155,56,565,84,16045
15000US060730002011,1043,61,20,21,10,15,10,15,1023,64,192,61,831,86,16046
15000US060730002021,734,161,13,21,13,21,0,12,721,164,106,70,615,169,16047
15000US060730002022,341,113,0,12,0,12,0,12,341,113,58,69,283,111,16048
15000US060730002023,1257,178,13,22,0,12,13,22,1244,182,77,57,1167,176,16049
15000US060730003001,285,90,0,12,0,12,0,12,285,90,58,31,227,88,16050
15000US060730003002,461,143,47,62,0,12,47,62,414,141,66,85,348,123,16051
15000US060730003003,885,163,28,32,13,20,15,24,857,163,150,124,707,145,16052
15000US060730003004,702,138,0,12,0,12,0,12,702,138,108,51,594,140,16053
15000US060730003005,473,107,0,12,0,12,0,12,473,107,41,51,432,106,16054
15000US060730004001,1076,142,31,46,31,46,0,12,1045,139,123,93,922,141,16055
15000US060730004002,414,118,0,12,0,12,0,12,414,118,0,12,414,118,16056
15000US060730004003,684,135,44,54,32,50,12,20,640,142,0,12,640,142,16057
15000US060730005001,442,70,19,21,19,21,0,12,423,68,67,37,356,73,16058
15000US060730005002,676,74,39,30,19,20,20,22,637,80,78,44,559,81,16059
15000US060730005003,526,68,0,12,0,12,0,12,526,68,23,18,503,69,16060
15000US060730006001,466,81,10,15,0,12,10,15,456,84,14,15,442,85,16061
15000US060730006002,651,75,33,30,0,12,33,30,618,75,73,38,545,82,16062
15000US060730006003,620,88,0,12,0,12,0,12,620,88,167,62,453,83,16063
15000US060730007001,803,146,15,24,15,24,0,12,788,144,59,63,729,142,16064
15000US060730007002,987,177,17,27,17,27,0,12,970,173,83,56,887,177,16065
15000US060730007003,553,111,0,12,0,12,0,12,553,111,128,67,425,103,16066
15000US060730008001,380,114,0,12,0,12,0,12,380,114,122,99,258,122,16067
15000US060730008002,384,117,24,37,24,37,0,12,360,122,46,55,314,125,16068
15000US060730008003,594,132,0,12,0,12,0,12,594,132,43,43,551,133,16069
15000US060730008004,1095,148,93,83,69,76,24,31,1002,146,161,78,841,152,16070
15000US060730009001,705,139,46,55,0,12,46,55,659,154,126,118,533,122,16071
15000US060730009002,469,111,0,12,0,12,0,12,469,111,29,33,440,113,16072
15000US060730009003,478,163,39,23,12,19,27,22,439,161,44,40,395,165,16073
15000US060730009004,492,122,45,43,15,25,30,35,447,120,118,59,329,108,16074
15000US060730009005,435,139,0,12,0,12,0,12,435,139,33,30,402,138,16075
15000US060730009006,401,127,58,37,0,12,58,37,343,121,31,35,312,119,16076
15000US060730010001,738,165,44,58,33,55,11,18,694,164,72,54,622,176,16077
15000US060730010002,633,114,0,12,0,12,0,12,633,114,105,60,528,129,16078
15000US060730010003,750,168,0,12,0,12,0,12,750,168,84,67,666,177,16079
15000US060730010004,510,166,63,79,11,18,52,85,447,152,80,90,367,136,16080
15000US060730011001,623,89,38,41,11,16,27,39,585,91,67,38,518,92,16081
15000US060730011002,702,113,106,80,52,62,54,50,596,123,78,34,518,125,16082
15000US060730011003,366,74,16,17,8,12,8,12,350,78,49,32,301,80,16083
15000US060730012001,603,152,128,110,13,20,115,108,475,132,59,44,416,134,16084
15000US060730012002,609,136,49,29,26,31,23,29,560,135,112,57,448,133,16085
15000US060730012003,860,179,8,15,8,15,0,12,852,178,118,78,734,175,16086
15000US060730012004,899,156,61,48,16,27,45,41,838,156,90,60,748,156,16087
15000US060730013001,456,99,14,21,0,12,14,21,442,101,50,42,392,105,16088
15000US060730013002,1068,169,45,48,18,27,27,40,1023,171,131,58,892,176,16089
15000US060730013003,572,115,0,12,0,12,0,12,572,115,78,65,494,123,16090
15000US060730013004,533,115,36,57,0,12,36,57,497,119,25,21,472,120,16091
15000US060730013005,691,141,30,31,0,12,30,31,661,138,52,58,609,136,16092
15000US060730014001,257,96,37,43,0,12,37,43,220,96,9,13,211,97,16093
15000US060730014002,312,82,14,21,14,21,0,12,298,81,28,26,270,82,16094
15000US060730014003,1007,103,15,22,15,22,0,12,992,103,94,49,898,104,16095
15000US060730015001,568,93,26,24,17,18,9,15,542,102,70,40,472,102,16096
15000US060730015002,449,77,23,37,0,12,23,37,426,84,70,48,356,86,16097
15000US060730015003,389,70,0,12,0,12,0,12,389,70,32,32,357,75,16098
15000US060730015004,362,72,9,13,9,13,0,12,353,71,25,23,328,72,16099
15000US060730016001,519,132,105,79,10,17,95,79,414,130,87,75,327,133,16100
15000US060730016002,623,152,62,63,0,12,62,63,561,151,81,73,480,149,16101
15000US060730016003,504,149,51,64,0,12,51,64,453,147,98,69,355,141,16102
15000US060730016004,539,137,29,33,12,19,17,28,510,141,49,47,461,133,16103
15000US060730017001,925,153,50,52,50,52,0,12,875,153,103,75,772,153,16104
15000US060730017002,536,129,11,17,11,17,0,12,525,135,48,40,477,140,16105
15000US060730017003,454,111,42,40,0,12,42,40,412,105,38,36,374,111,16106
15000US060730017004,307,102,30,35,17,27,13,22,277,106,0,12,277,106,16107
15000US060730018001,349,94,0,12,0,12,0,12,349,94,59,47,290,99,16108
15000US060730018002,567,120,86,67,0,12,86,67,481,116,66,50,415,117,16109
15000US060730018003,301,102,53,65,53,65,0,12,248,89,32,36,216,86,16110
15000US060730018004,431,141,21,34,0,12,21,34,410,138,12,20,398,141,16111
15000US060730018005,543,103,12,22,0,12,12,22,531,104,31,35,500,108,16112
15000US060730018006,362,118,66,68,0,12,66,68,296,106,52,46,244,108,16113
15000US060730019001,517,66,8,12,0,12,8,12,509,67,76,46,433,86,16114
15000US060730019002,598,76,15,17,7,10,8,12,583,78,122,45,461,72,16115
15000US060730019003,357,76,7,10,7,10,0,12,350,77,12,17,338,78,16116
15000US060730020011,424,55,0,12,0,12,0,12,424,55,65,32,359,64,16117
15000US060730020012,699,79,9,14,0,12,9,14,690,81,144,50,546,92,16118
15000US060730020013,406,50,0,12,0,12,0,12,406,50,52,33,354,58,16119
15000US060730020021,425,68,36,39,5,8,31,37,389,72,47,27,342,78,16120
15000US060730020022,621,84,9,15,0,12,9,15,612,85,79,53,533,92,16121
15000US060730021001,532,100,56,53,56,53,0,12,476,113,49,42,427,120,16122
15000US060730021002,538,127,38,60,0,12,38,60,500,131,32,31,468,136,16123
15000US060730021003,402,108,84,95,0,12,84,95,318,94,23,26,295,99,16124
15000US060730021004,496,133,23,26,12,19,11,18,473,137,42,36,431,138,16125
15000US060730021005,483,121,13,20,0,12,13,20,470,121,128,73,342,122,16126
15000US060730022011,553,106,169,58,37,39,132,55,384,95,80,50,304,93,16127
15000US060730022012,617,90,168,87,10,13,158,85,449,92,82,54,367,82,16128
15000US060730022021,589,110,111,57,49,37,62,42,478,120,189,75,289,104,16129
15000US060730022022,731,122,230,79,33,33,197,79,501,128,105,50,396,126,16130
15000US060730022023,360,79,114,50,38,37,76,45,246,76,31,21,215,76,16131
15000US060730023011,424,90,30,37,20,33,10,15,394,88,75,48,319,98,16132
15000US060730023012,470,88,95,60,11,17,84,58,375,83,61,43,314,80,16133
15000US060730023013,301,66,72,40,14,19,58,39,229,62,57,41,172,62,16134
15000US060730023021,1108,155,247,99,84,77,163,109,861,170,342,124,519,181,16135
15000US060730023022,517,138,139,87,27,32,112,86,378,129,121,75,257,114,16136
15000US060730023023,573,156,138,100,0,12,138,100,435,146,184,76,251,127,16137
15000US060730024011,289,87,56,49,32,41,24,26,233,87,14,17,219,87,16138
15000US060730024012,707,109,156,81,23,35,133,74,551,129,99,46,452,132,16139
15000US060730024013,641,86,88,49,47,42,41,29,553,86,124,58,429,90,16140
15000US060730024021,839,102,220,88,52,40,168,81,619,119,130,65,489,122,16141
15000US060730024022,696,89,177,75,93,52,84,55,519,95,63,54,456,95,16142
15000US060730025011,580,89,184,76,18,21,166,73,396,87,151,61,245,83,16143
15000US060730025012,495,88,64,50,41,39,23,37,431,88,98,62,333,86,16144
15000US060730025013,504,94,76,61,0,12,76,61,428,96,48,35,380,95,16145
15000US060730025021,944,88,71,71,71,71,0,12,873,89,243,76,630,114,16146
15000US060730025022,779,99,210,92,62,49,148,77,569,108,61,60,508,100,16147
15000US060730025023,305,79,11,16,0,12,11,16,294,78,99,47,195,75,16148
15000US060730026011,543,116,128,61,42,29,86,61,415,116,34,31,381,114,16149
15000US060730026012,538,111,81,59,34,45,47,33,457,119,89,50,368,112,16150
15000US060730026013,512,91,96,73,10,16,86,72,416,86,72,43,344,93,16151
15000US060730026021,321,74,89,51,57,42,32,31,232,62,9,14,223,62,16152
15000US060730026022,434,87,74,41,0,12,74,41,360,85,25,25,335,87,16153
15000US060730026023,403,78,102,51,23,28,79,40,301,78,56,47,245,67,16154
15000US060730027021,490,86,9,14,0,12,9,14,481,86,103,51,378,80,16155
15000US060730027022,561,77,54,30,42,28,12,18,507,77,70,50,437,80,16156
15000US060730027023,910,111,87,48,51,41,36,29,823,109,131,58,692,120,16157
15000US060730027031,810,177,32,45,32,45,0,12,778,178,33,42,745,183,16158
15000US060730027032,402,142,56,54,24,37,32,39,346,132,115,68,231,143,16159
15000US060730027033,485,144,43,55,4,14,39,53,442,157,35,44,407,157,16160
15000US060730027034,572,167,90,64,30,42,60,47,482,160,211,132,271,127,16161
15000US060730027051,680,92,82,46,9,15,73,42,598,107,168,95,430,131,16162
15000US060730027052,587,99,32,37,0,12,32,37,555,97,147,66,408,101,16163
15000US060730027071,482,84,126,58,29,34,97,50,356,83,35,37,321,83,16164
15000US060730027072,293,75,49,40,4,7,45,38,244,76,57,35,187,68,16165
15000US060730027073,284,78,114,63,14,17,100,59,170,77,0,12,170,77,16166
15000US060730027074,523,93,207,81,47,36,160,73,316,103,56,42,260,104,16167
15000US060730027081,565,91,156,71,53,44,103,56,409,94,115,58,294,71,16168
15000US060730027082,163,47,61,41,13,21,48,35,102,43,53,31,49,36,16169
15000US060730027083,700,112,229,83,31,33,198,80,471,100,92,57,379,98,16170
15000US060730027084,574,101,169,80,26,40,143,72,405,92,79,62,326,88,16171
15000US060730027091,618,95,259,96,79,58,180,84,359,98,59,36,300,101,16172
15000US060730027092,519,96,153,75,34,35,119,69,366,78,90,37,276,77,16173
15000US060730027101,432,75,109,49,25,29,84,44,323,78,79,45,244,71,16174
15000US060730027102,768,75,222,65,68,39,154,54,546,92,145,47,401,85,16175
15000US060730027111,486,65,42,31,6,11,36,29,444,68,26,19,418,69,16176
15000US060730027112,391,58,52,35,18,20,34,29,339,60,78,36,261,69,16177
15000US060730027121,580,97,79,62,0,12,79,62,501,106,181,81,320,94,16178
15000US060730027122,447,75,16,19,0,12,16,19,431,79,167,67,264,79,16179
15000US060730027123,700,100,173,71,25,24,148,71,527,95,149,72,378,108,16180
15000US060730028011,662,88,0,12,0,12,0,12,662,88,189,77,473,93,16181
15000US060730028012,250,68,7,12,0,12,7,12,243,68,7,11,236,68,16182
15000US060730028031,770,173,54,48,36,34,18,28,716,178,116,90,600,165,16183
15000US060730028032,694,164,0,12,0,12,0,12,694,164,98,97,596,154,16184
15000US060730028033,411,128,16,24,16,24,0,12,395,132,148,104,247,95,16185
15000US060730028034,523,120,0,12,0,12,0,12,523,120,70,56,453,114,16186
15000US060730028041,393,78,0,12,0,12,0,12,393,78,55,37,338,80,16187
15000US060730028042,571,81,19,21,0,12,19,21,552,82,122,52,430,78,16188
15000US060730028043,370,70,36,29,19,20,17,21,334,72,26,24,308,75,16189
15000US060730029021,1099,133,82,49,55,44,27,25,1017,137,218,81,799,145,16190
15000US060730029022,1347,138,195,114,52,80,143,80,1152,164,264,114,888,158,16191
15000US060730029031,414,101,58,56,46,52,12,16,356,86,82,43,274,91,16192
15000US060730029032,411,93,27,43,0,12,27,43,384,88,138,61,246,74,16193
15000US060730029033,481,100,38,37,25,36,13,19,443,101,97,57,346,102,16194
15000US060730029041,925,131,46,54,15,15,31,51,879,130,117,58,762,131,16195
15000US060730029042,376,104,0,12,0,12,0,12,376,104,59,44,317,111,16196
15000US060730029043,599,132,14,24,0,12,14,24,585,132,0,12,585,132,16197
15000US060730029044,222,73,20,24,20,24,0,12,202,76,48,39,154,73,16198
15000US060730029051,527,132,78,65,58,56,20,29,449,130,140,106,309,98,16199
15000US060730029052,454,117,66,57,28,30,38,48,388,117,70,46,318,117,16200
15000US060730029053,598,107,95,71,0,12,95,71,503,105,97,65,406,95,16201
15000US060730030011,238,59,6,14,6,14,0,12,232,60,91,51,141,47,16202
15000US060730030012,469,93,136,74,3,6,133,74,333,96,104,67,229,66,16203
15000US060730030013,435,92,92,69,49,39,43,56,343,94,137,53,206,74,16204
15000US060730030031,574,120,11,18,0,12,11,18,563,119,96,57,467,120,16205
15000US060730030032,610,116,91,66,0,12,91,66,519,106,106,48,413,107,16206
15000US060730030033,366,89,68,54,14,17,54,50,298,96,60,39,238,96,16207
15000US060730030041,691,78,134,63,38,35,96,55,557,89,141,50,416,86,16208
15000US060730030042,675,90,78,53,27,32,51,43,597,91,167,75,430,94,16209
15000US060730031011,251,66,13,17,9,14,4,9,238,66,29,30,209,66,16210
15000US060730031012,347,72,45,32,19,19,26,31,302,70,163,64,139,53,16211
15000US060730031013,455,79,28,30,16,24,12,17,427,79,110,48,317,83,16212
15000US060730031031,668,90,60,33,46,34,14,16,608,92,138,59,470,100,16213
15000US060730031032,559,102,52,38,20,29,32,31,507,91,144,55,363,85,16214
15000US060730031033,378,70,37,29,27,23,10,15,341,69,107,42,234,70,16215
15000US060730031051,758,104,190,85,29,32,161,84,568,109,205,93,363,114,16216
15000US060730031052,363,104,0,12,0,12,0,12,363,104,141,68,222,94,16217
15000US060730031071,820,112,76,45,38,29,38,35,744,111,238,105,506,91,16218
15000US060730031072,564,102,45,47,45,47,0,12,519,97,167,73,352,88,16219
15000US060730031073,260,76,16,19,8,14,8,13,244,74,92,50,152,73,16220
15000US060730031081,626,67,87,45,34,23,53,39,539,70,151,49,388,70,16221
15000US060730031082,365,64,43,32,13,14,30,30,322,61,118,52,204,64,16222
15000US060730031091,261,37,20,24,5,7,15,24,241,34,73,26,168,36,16223
15000US060730031092,269,43,7,13,0,12,7,13,262,42,52,22,210,43,16224
15000US060730031093,279,40,12,13,0,12,12,13,267,43,51,25,216,42,16225
15000US060730031111,574,110,211,86,94,65,117,79,363,112,72,50,291,110,16226
15000US060730031112,608,107,175,83,83,60,92,64,433,101,146,42,287,102,16227
15000US060730031113,546,108,43,31,27,22,16,22,503,110,144,57,359,117,16228
15000US060730031121,474,92,99,62,40,51,59,50,375,109,153,66,222,103,16229
15000US060730031122,802,107,81,50,35,35,46,48,721,110,193,93,528,124,16230
15000US060730031131,609,93,33,25,23,19,10,14,576,100,166,82,410,109,16231
15000US060730031132,649,88,0,12,0,12,0,12,649,88,302,89,347,92,16232
15000US060730031141,319,50,22,17,15,14,7,10,297,50,81,31,216,57,16233
15000US060730031142,493,55,23,24,4,7,19,23,470,54,148,45,322,66,16234
15000US060730031151,659,82,284,82,43,34,241,82,375,105,176,84,199,84,16235
15000US060730031152,334,71,46,32,23,19,23,29,288,68,56,42,232,75,16236
15000US060730031153,253,48,44,26,21,18,23,23,209,45,67,27,142,41,16237
15000US060730031154,535,85,33,27,23,22,10,15,502,88,139,51,363,90,16238
15000US060730032011,291,60,20,24,0,12,20,24,271,64,111,63,160,73,16239
15000US060730032012,478,83,73,54,18,23,55,48,405,87,71,38,334,94,16240
15000US060730032013,686,96,15,25,0,12,15,25,671,94,51,40,620,97,16241
15000US060730032021,538,99,58,41,35,33,23,24,480,107,134,71,346,97,16242
15000US060730032022,730,116,78,56,55,44,23,34,652,123,164,59,488,113,16243
15000US060730032041,495,94,5,9,5,9,0,12,490,94,115,44,375,89,16244
15000US060730032042,465,73,42,36,29,28,13,18,423,78,148,55,275,79,16245
15000US060730032071,783,151,28,37,0,12,28,37,755,147,64,36,691,151,16246
15000US060730032072,545,127,0,12,0,12,0,12,545,127,92,58,453,122,16247
15000US060730032073,781,121,49,73,0,12,49,73,732,108,103,69,629,112,16248
15000US060730032081,518,146,92,89,0,12,92,89,426,145,31,48,395,137,16249
15000US060730032082,146,68,0,12,0,12,0,12,146,68,32,48,114,52,16250
15000US060730032083,478,124,15,23,15,23,0,12,463,125,20,31,443,129,16251
15000US060730032084,238,107,0,12,0,12,0,12,238,107,45,43,193,98,16252
15000US060730032085,745,162,91,94,72,88,19,25,654,170,62,42,592,172,16253
15000US060730032091,853,119,53,35,9,14,44,32,800,121,177,74,623,120,16254
15000US060730032092,453,93,34,27,18,20,16,19,419,94,73,51,346,85,16255
15000US060730032093,383,83,9,13,9,13,0,12,374,82,108,68,266,67,16256
15000US060730032111,573,56,33,21,13,12,20,16,540,54,211,48,329,57,16257
15000US060730032112,317,53,30,26,19,24,11,11,287,49,100,44,187,51,16258
15000US060730032121,324,69,38,30,24,27,14,21,286,67,71,40,215,63,16259
15000US060730032122,672,94,62,58,9,15,53,55,610,98,93,41,517,98,16260
15000US060730032131,503,79,21,33,0,12,21,33,482,70,62,40,420,78,16261
15000US060730032132,542,76,8,15,8,15,0,12,534,76,165,64,369,80,16262
15000US060730032141,559,86,27,26,18,21,9,13,532,89,165,60,367,88,16263
15000US060730032142,557,105,66,55,59,52,7,13,491,102,144,69,347,94,16264
15000US060730032143,417,85,6,9,6,9,0,12,411,86,36,35,375,86,16265
15000US060730033011,440,70,119,55,25,26,94,51,321,65,101,48,220,62,16266
15000US060730033012,474,72,174,67,62,40,112,60,300,61,84,42,216,64,16267
15000US060730033031,479,100,210,82,36,31,174,78,269,91,87,65,182,70,16268
15000US060730033032,679,109,168,77,36,35,132,71,511,109,127,54,384,117,16269
15000US060730033041,379,54,93,42,36,28,57,35,286,59,82,35,204,44,16270
15000US060730033042,649,63,200,57,105,43,95,38,449,70,112,39,337,68,16271
15000US060730033051,169,53,24,23,10,16,14,16,145,53,48,29,97,48,16272
15000US060730033052,628,80,254,92,63,47,191,86,374,108,101,52,273,98,16273
15000US060730033053,768,76,167,76,37,39,130,67,601,93,141,67,460,97,16274
15000US060730034011,671,153,0,12,0,12,0,12,671,153,63,50,608,159,16275
15000US060730034012,456,131,0,12,0,12,0,12,456,131,106,68,350,133,16276
15000US060730034013,292,97,45,70,0,12,45,70,247,82,71,58,176,85,16277
15000US060730034014,682,119,65,61,46,49,19,32,617,119,247,116,370,114,16278
15000US060730034031,312,69,44,37,8,12,36,36,268,71,108,54,160,64,16279
15000US060730034032,443,87,94,57,24,35,70,47,349,85,77,49,272,89,16280
15000US060730034033,319,74,37,42,0,12,37,42,282,85,36,29,246,84,16281
15000US060730034041,400,112,117,75,11,17,106,73,283,78,67,49,216,76,16282
15000US060730034042,783,114,186,69,81,45,105,58,597,122,161,69,436,116,16283
15000US060730035011,493,91,111,63,9,17,102,64,382,93,87,47,295,96,16284
15000US060730035012,314,70,101,61,8,14,93,58,213,57,12,11,201,58,16285
15000US060730035013,267,79,109,56,16,23,93,62,158,74,35,40,123,62,16286
15000US060730035021,245,65,56,37,0,12,56,37,189,61,18,28,171,65,16287
15000US060730035022,559,81,145,62,45,39,100,48,414,78,43,28,371,83,16288
15000US060730035023,521,75,134,52,24,28,110,51,387,75,88,53,299,82,16289
15000US060730036011,713,52,197,64,20,19,177,62,516,68,66,35,450,68,16290
15000US060730036021,360,47,96,37,27,25,69,36,264,48,80,36,184,49,16291
15000US060730036022,397,49,58,33,0,12,58,33,339,51,102,37,237,52,16292
15000US060730036031,494,89,109,68,14,17,95,69,385,92,67,49,318,94,16293
15000US060730036032,369,90,108,68,0,12,108,68,261,84,25,24,236,81,16294
15000US060730036033,203,59,29,23,6,9,23,21,174,61,21,22,153,62,16295
15000US060730038001,0,17,0,17,0,17,0,17,0,17,0,17,0,17,16296
15000US060730039011,310,52,77,36,16,19,61,34,233,52,43,19,190,51,16297
15000US060730039012,342,59,97,43,19,17,78,45,245,58,41,27,204,56,16298
15000US060730039013,406,62,109,49,31,27,78,43,297,59,50,25,247,60,16299
15000US060730039021,214,82,22,22,7,13,15,19,192,82,9,14,183,80,16300
15000US060730039022,378,98,66,57,21,35,45,47,312,90,66,51,246,88,16301
15000US060730039023,408,100,82,58,19,31,63,53,326,86,63,34,263,92,16302
15000US060730039024,179,74,71,48,26,23,45,45,108,59,6,16,102,59,16303
15000US060730040001,418,95,54,53,0,12,54,53,364,90,52,45,312,103,16304
15000US060730040002,193,49,28,28,28,28,0,12,165,50,81,36,84,38,16305
15000US060730040003,368,83,58,43,13,19,45,43,310,85,80,53,230,75,16306
15000US060730040004,263,75,16,18,10,15,6,10,247,73,106,52,141,69,16307
15000US060730041001,430,170,0,12,0,12,0,12,430,170,23,32,407,176,16308
15000US060730041002,800,182,16,27,0,12,16,27,784,183,71,66,713,186,16309
15000US060730041003,746,157,209,103,103,105,106,92,537,138,138,91,399,148,16310
15000US060730041004,858,176,6,16,0,12,6,16,852,176,102,67,750,181,16311
15000US060730042001,804,148,78,65,22,27,56,62,726,152,67,48,659,148,16312
15000US060730042002,850,135,17,29,17,29,0,12,833,141,86,55,747,144,16313
15000US060730042003,337,69,0,12,0,12,0,12,337,69,0,12,337,69,16314
15000US060730042004,366,113,13,23,13,23,0,12,353,113,83,71,270,97,16315
15000US060730043001,230,71,14,22,14,22,0,12,216,71,16,19,200,70,16316
15000US060730043002,1014,130,27,35,7,11,20,34,987,129,70,43,917,128,16317
15000US060730043003,492,99,43,48,0,12,43,48,449,94,65,33,384,100,16318
15000US060730044001,530,90,22,25,0,12,22,25,508,91,95,47,413,95,16319
15000US060730044002,675,104,54,58,43,55,11,19,621,109,73,56,548,107,16320
15000US060730044003,316,64,16,25,16,25,0,12,300,63,26,24,274,63,16321
15000US060730044004,271,73,0,12,0,12,0,12,271,73,27,25,244,76,16322
15000US060730045011,694,101,82,57,18,19,64,55,612,106,128,71,484,100,16323
15000US060730045012,316,88,8,12,0,12,8,12,308,87,57,58,251,69,16324
15000US060730045013,252,62,16,19,0,12,16,19,236,63,58,43,178,59,16325
15000US060730046001,813,81,14,21,0,12,14,21,799,83,95,56,704,81,16326
15000US060730046002,249,65,0,12,0,12,0,12,249,65,39,37,210,70,16327
15000US060730047001,327,50,36,27,9,15,27,23,291,56,60,29,231,58,16328
15000US060730047002,374,49,75,46,8,11,67,46,299,57,101,38,198,51,16329
15000US060730048001,334,87,75,53,21,30,54,47,259,82,80,48,179,77,16330
15000US060730048002,414,91,78,47,63,50,15,22,336,96,170,84,166,71,16331
15000US060730048003,296,78,64,52,18,20,46,48,232,66,49,32,183,65,16332
15000US060730049001,428,92,54,35,29,28,25,25,374,89,73,53,301,86,16333
15000US060730049002,451,76,67,46,18,18,49,42,384,88,82,44,302,90,16334
15000US060730049003,577,91,170,67,15,18,155,67,407,93,136,52,271,81,16335
15000US060730050001,668,50,171,68,25,27,146,67,497,70,89,46,408,69,16336
15000US060730051001,688,155,137,82,33,25,104,76,551,159,159,95,392,155,16337
15000US060730051002,2500,181,232,119,74,58,158,97,2268,221,269,106,1999,211,16338
15000US060730052001,1584,241,183,111,107,93,76,76,1401,250,368,164,1033,190,16339
15000US060730052002,1989,201,201,95,63,66,138,76,1788,204,351,110,1437,205,16340
15000US060730053001,571,130,0,12,0,12,0,12,571,130,121,78,450,138,16341
15000US060730053002,742,171,72,78,18,27,54,73,670,180,87,67,583,170,16342
15000US060730053003,282,93,9,19,9,19,0,12,273,100,162,85,111,66,16343
15000US060730053004,859,148,0,12,0,12,0,12,859,148,97,54,762,158,16344
15000US060730054001,386,120,0,12,0,12,0,12,386,120,84,100,302,116,16345
15000US060730054002,1561,231,51,53,0,12,51,53,1510,233,215,111,1295,239,16346
15000US060730054003,631,160,0,12,0,12,0,12,631,160,44,51,587,163,16347
15000US060730054004,2189,332,20,33,0,12,20,33,2169,334,264,140,1905,350,16348
15000US060730055001,0,12,0,12,0,12,0,12,0,12,0,12,0,12,16349
15000US060730056001,1742,187,47,37,31,26,16,26,1695,184,496,156,1199,188,16350
15000US060730056002,1138,178,16,21,0,12,16,21,1122,181,87,80,1035,177,16351
15000US060730057001,404,60,0,12,0,12,0,12,404,60,27,18,377,62,16352
15000US060730057002,420,59,46,29,14,17,32,25,374,53,55,26,319,50,16353
15000US060730058001,1883,139,7,12,0,12,7,12,1876,138,84,54,1792,139,16354
15000US060730059001,845,128,0,12,0,12,0,12,845,128,114,53,731,131,16355
15000US060730059002,539,103,7,12,7,12,0,12,532,103,45,51,487,107,16356
15000US060730059003,557,100,0,12,0,12,0,12,557,100,110,56,447,92,16357
15000US060730060001,648,110,9,16,0,12,9,16,639,109,41,33,598,109,16358
15000US060730060002,636,124,0,12,0,12,0,12,636,124,224,101,412,125,16359
15000US060730060003,857,163,0,12,0,12,0,12,857,163,188,116,669,139,16360
15000US060730061001,802,79,26,30,2,10,24,27,776,79,120,53,656,86,16361
15000US060730061002,367,64,71,50,10,15,61,52,296,75,25,28,271,76,16362
15000US060730062001,0,12,0,12,0,12,0,12,0,12,0,12,0,12,16363
15000US060730063001,11,15,0,12,0,12,0,12,11,15,0,12,11,15,16364
15000US060730065001,706,98,72,54,28,26,44,50,634,100,292,98,342,111,16365
15000US060730065002,464,115,34,46,0,12,34,46,430,114,56,39,374,116,16366
15000US060730065003,365,82,23,39,0,12,23,39,342,83,41,33,301,83,16367
15000US060730066001,438,43,48,31,14,15,34,26,390,47,34,24,356,47,16368
15000US060730068011,1287,85,65,59,0,12,65,59,1222,98,174,74,1048,105,16369
15000US060730068021,646,125,50,60,15,23,35,49,596,144,91,60,505,147,16370
15000US060730068022,932,140,55,64,0,12,55,64,877,157,174,124,703,130,16371
15000US060730068023,691,133,0,12,0,12,0,12,691,133,134,77,557,135,16372
15000US060730069001,1161,131,38,56,0,12,38,56,1123,148,115,62,1008,166,16373
15000US060730069002,401,98,22,35,22,35,0,12,379,96,48,47,331,101,16374
15000US060730069003,534,109,0,12,0,12,0,12,534,109,95,49,439,115,16375
15000US060730070021,618,65,22,24,11,17,11,18,596,67,136,55,460,74,16376
15000US060730070022,323,51,0,12,0,12,0,12,323,51,120,48,203,50,16377
15000US060730070023,215,49,0,12,0,12,0,12,215,49,52,29,163,49,16378
15000US060730071001,715,123,0,12,0,12,0,12,715,123,96,57,619,129,16379
15000US060730071002,1072,106,13,20,0,12,13,20,1059,106,285,110,774,125,16380
15000US060730071003,260,86,20,31,0,12,20,31,240,85,71,72,169,75,16381
15000US060730072001,512,54,0,12,0,12,0,12,512,54,105,48,407,46,16382
15000US060730072002,1020,73,0,12,0,12,0,12,1020,73,129,37,891,77,16383
15000US060730073011,495,128,0,12,0,12,0,12,495,128,57,54,438,130,16384
15000US060730073012,884,170,24,29,0,12,24,29,860,170,81,84,779,189,16385
15000US060730073013,859,144,19,29,19,29,0,12,840,146,20,27,820,148,16386
15000US060730073014,372,99,0,12,0,12,0,12,372,99,24,28,348,97,16387
15000US060730073021,281,51,7,11,7,11,0,12,274,53,43,33,231,46,16388
15000US060730073022,287,42,14,21,14,21,0,12,273,42,43,22,230,46,16389
15000US060730073023,281,42,5,8,0,12,5,8,276,43,55,28,221,45,16390
15000US060730074001,487,120,24,29,24,29,0,12,463,120,53,64,410,113,16391
15000US060730074002,645,136,0,12,0,12,0,12,645,136,198,78,447,131,16392
15000US060730074003,510,95,8,14,0,12,8,14,502,95,101,70,401,97,16393
15000US060730074004,577,128,0,12,0,12,0,12,577,128,75,52,502,137,16394
15000US060730074005,441,106,27,31,0,12,27,31,414,99,12,20,402,100,16395
15000US060730074006,311,75,0,12,0,12,0,12,311,75,137,66,174,71,16396
15000US060730075011,506,122,0,12,0,12,0,12,506,122,13,20,493,124,16397
15000US060730075012,347,104,0,12,0,12,0,12,347,104,133,103,214,73,16398
15000US060730075013,424,97,0,12,0,12,0,12,424,97,20,30,404,94,16399
15000US060730075014,592,114,0,12,0,12,0,12,592,114,145,91,447,111,16400
15000US060730075015,345,97,28,23,0,12,28,23,317,93,19,32,298,96,16401
15000US060730075021,507,76,42,36,8,12,34,34,465,78,54,37,411,79,16402
15000US060730075022,507,105,9,14,0,12,9,14,498,103,62,50,436,112,16403
15000US060730075023,591,92,9,14,9,14,0,12,582,96,104,47,478,102,16404
15000US060730076001,280,104,56,72,13,20,43,69,224,90,85,75,139,62,16405
15000US060730076002,303,100,0,12,0,12,0,12,303,100,17,28,286,100,16406
15000US060730076003,472,139,14,23,0,12,14,23,458,140,44,41,414,130,16407
15000US060730076004,298,94,0,12,0,12,0,12,298,94,41,33,257,97,16408
15000US060730076005,432,148,14,22,14,22,0,12,418,145,124,88,294,129,16409
15000US060730076006,336,136,0,12,0,12,0,12,336,136,53,36,283,132,16410
15000US060730076007,309,141,0,12,0,12,0,12,309,141,0,12,309,141,16411
15000US060730077011,842,191,0,12,0,12,0,12,842,191,264,152,578,169,16412
15000US060730077012,414,123,17,28,17,28,0,12,397,131,67,70,330,121,16413
15000US060730077013,873,144,0,12,0,12,0,12,873,144,31,34,842,145,16414
15000US060730077021,360,106,0,12,0,12,0,12,360,106,77,79,283,111,16415
15000US060730077022,782,176,85,96,44,70,41,66,697,165,27,31,670,168,16416
15000US060730077023,499,129,0,12,0,12,0,12,499,129,31,36,468,135,16417
15000US060730077024,495,147,28,32,14,21,14,24,467,148,16,25,451,147,16418
15000US060730078001,899,169,13,22,0,12,13,22,886,168,86,62,800,166,16419
15000US060730078002,295,124,0,12,0,12,0,12,295,124,11,19,284,125,16420
15000US060730078003,709,151,21,34,0,12,21,34,688,153,77,59,611,146,16421
15000US060730078004,249,101,37,42,16,28,21,32,212,99,10,23,202,99,16422
15000US060730078005,310,113,0,12,0,12,0,12,310,113,80,74,230,105,16423
15000US060730079031,482,122,12,19,0,12,12,19,470,123,18,22,452,122,16424
15000US060730079032,912,130,0,12,0,12,0,12,912,130,42,33,870,131,16425
15000US060730079033,376,123,13,20,0,12,13,20,363,125,53,47,310,132,16426
15000US060730079034,465,166,39,45,28,41,11,16,426,156,0,12,426,156,16427
15000US060730079051,619,114,0,12,0,12,0,12,619,114,36,49,583,116,16428
15000US060730079052,711,133,7,12,0,12,7,12,704,133,30,25,674,136,16429
15000US060730079071,889,99,22,22,11,15,11,16,867,100,82,39,785,100,16430
15000US060730079072,756,96,27,32,27,32,0,12,729,99,125,79,604,96,16431
15000US060730079081,309,70,10,16,10,16,0,12,299,68,16,17,283,68,16432
15000US060730079082,1122,85,16,19,7,11,9,16,1106,84,84,32,1022,92,16433
15000US060730079101,784,111,7,11,7,11,0,12,777,111,68,54,709,113,16434
15000US060730079102,818,92,17,26,0,12,17,26,801,96,39,24,762,99,16435
15000US060730080021,326,76,20,29,0,12,20,29,306,73,86,50,220,62,16436
15000US060730080022,368,67,25,38,0,12,25,38,343,66,47,33,296,68,16437
15000US060730080023,379,66,0,12,0,12,0,12,379,66,0,12,379,66,16438
15000US060730080031,626,88,0,12,0,12,0,12,626,88,56,31,570,88,16439
15000US060730080032,584,87,10,15,10,15,0,12,574,92,66,50,508,95,16440
15000US060730080033,569,103,0,12,0,12,0,12,569,103,30,27,539,99,16441
15000US060730080061,291,77,0,12,0,12,0,12,291,77,56,48,235,71,16442
15000US060730080062,437,75,0,12,0,12,0,12,437,75,34,41,403,76,16443
15000US060730080063,282,77,17,19,0,12,17,19,265,77,17,19,248,79,16444
15000US060730080064,431,94,11,16,0,12,11,16,420,97,50,40,370,91,16445
15000US060730080065,391,82,10,15,0,12,10,15,381,83,51,35,330,80,16446
15000US060730081011,261,64,0,12,0,12,0,12,261,64,23,30,238,71,16447
15000US060730081012,394,116,0,12,0,12,0,12,394,116,70,58,324,119,16448
15000US060730081013,458,128,14,23,0,12,14,23,444,134,42,36,402,140,16449
15000US060730081014,360,107,0,12,0,12,0,12,360,107,0,12,360,107,16450
15000US060730081015,405,94,0,12,0,12,0,12,405,94,63,65,342,102,16451
15000US060730081021,293,65,0,12,0,12,0,12,293,65,37,23,256,66,16452
15000US060730081022,566,87,0,12,0,12,0,12,566,87,64,35,502,93,16453
15000US060730081023,558,78,8,12,0,12,8,12,550,80,98,56,452,77,16454
15000US060730082001,539,95,0,12,0,12,0,12,539,95,113,46,426,97,16455
15000US060730082002,693,131,0,12,0,12,0,12,693,131,102,55,591,122,16456
15000US060730082003,366,70,0,12,0,12,0,12,366,70,83,44,283,72,16457
15000US060730083011,511,79,0,12,0,12,0,12,511,79,63,37,448,84,16458
15000US060730083012,424,66,0,12,0,12,0,12,424,66,100,46,324,71,16459
15000US060730083013,326,68,9,14,9,14,0,12,317,70,56,39,261,71,16460
15000US060730083031,595,111,0,12,0,12,0,12,595,111,134,73,461,100,16461
15000US060730083032,666,95,0,12,0,12,0,12,666,95,169,62,497,93,16462
15000US060730083033,161,41,0,12,0,12,0,12,161,41,29,24,132,38,16463
15000US060730083051,0,12,0,12,0,12,0,12,0,12,0,12,0,12,16464
15000US060730083052,805,49,77,36,25,30,52,21,728,46,56,31,672,56,16465
15000US060730083061,251,37,26,27,0,12,26,27,225,38,65,38,160,39,16466
15000US060730083062,392,46,0,12,0,12,0,12,392,46,53,37,339,48,16467
15000US060730083063,545,57,0,12,0,12,0,12,545,57,125,46,420,68,16468
15000US060730083071,392,69,0,12,0,12,0,12,392,69,71,45,321,66,16469
15000US060730083072,662,80,0,12,0,12,0,12,662,80,209,71,453,76,16470
15000US060730083073,474,69,15,18,8,13,7,12,459,72,98,51,361,75,16471
15000US060730083101,493,94,18,28,0,12,18,28,475,92,0,12,475,92,16472
15000US060730083102,691,138,0,12,0,12,0,12,691,138,115,78,576,131,16473
15000US060730083103,1057,145,0,12,0,12,0,12,1057,145,198,89,859,155,16474
15000US060730083111,651,74,0,12,0,12,0,12,651,74,83,51,568,81,16475
15000US060730083112,436,87,11,16,11,16,0,12,425,89,133,77,292,57,16476
15000US060730083121,234,45,0,12,0,12,0,12,234,45,58,39,176,45,16477
15000US060730083122,581,105,3,6,0,12,3,6,578,106,98,59,480,104,16478
15000US060730083123,265,65,0,12,0,12,0,12,265,65,60,34,205,67,16479
15000US060730083124,531,89,0,12,0,12,0,12,531,89,134,78,397,90,16480
15000US060730083131,402,48,5,7,5,7,0,12,397,48,64,32,333,50,16481
15000US060730083132,423,52,0,12,0,12,0,12,423,52,53,27,370,55,16482
15000US060730083241,1181,137,0,12,0,12,0,12,1181,137,92,57,1089,138,16483
15000US060730083242,995,141,0,12,0,12,0,12,995,141,156,92,839,169,16484
15000US060730083243,220,56,0,12,0,12,0,12,220,56,28,32,192,61,16485
15000US060730083244,551,106,0,12,0,12,0,12,551,106,67,56,484,111,16486
15000US060730083271,1006,150,0,12,0,12,0,12,1006,150,117,85,889,158,16487
15000US060730083272,1033,133,14,22,14,22,0,12,1019,135,82,71,937,127,16488
15000US060730083273,440,119,0,12,0,12,0,12,440,119,73,55,367,126,16489
15000US060730083281,1837,109,19,18,0,17,19,18,1818,114,173,80,1645,136,16490
15000US060730083291,1525,182,80,54,13,22,67,60,1445,181,185,109,1260,208,16491
15000US060730083292,775,126,10,17,0,12,10,17,765,127,52,41,713,135,16492
15000US060730083293,848,172,0,12,0,12,0,12,848,172,46,40,802,175,16493
15000US060730083301,796,102,14,22,14,22,0,12,782,102,157,82,625,114,16494
15000US060730083302,1214,111,15,25,0,12,15,25,1199,114,39,39,1160,122,16495
15000US060730083311,878,27,3,5,3,5,0,12,875,28,115,37,760,45,16496
15000US060730083331,2656,263,0,17,0,17,0,17,2656,263,143,132,2513,293,16497
15000US060730083332,2519,253,29,46,29,46,0,17,2490,253,187,139,2303,276,16498
15000US060730083351,306,77,0,12,0,12,0,12,306,77,84,56,222,94,16499
15000US060730083352,237,87,0,12,0,12,0,12,237,87,63,76,174,62,16500
15000US060730083353,2411,129,189,118,35,38,154,122,2222,155,220,92,2002,145,16501
15000US060730083361,280,36,0,12,0,12,0,12,280,36,31,21,249,40,16502
15000US060730083362,424,45,4,8,0,12,4,8,420,45,57,26,363,50,16503
15000US060730083371,601,66,0,12,0,12,0,12,601,66,88,40,513,72,16504
15000US060730083372,265,59,0,12,0,12,0,12,265,59,75,44,190,54,16505
15000US060730083373,439,54,0,12,0,12,0,12,439,54,89,42,350,63,16506
15000US060730083391,784,60,8,12,0,12,8,12,776,61,29,18,747,59,16507
15000US060730083401,1927,274,19,32,0,12,19,32,1908,275,314,164,1594,301,16508
15000US060730083402,131,84,0,12,0,12,0,12,131,84,40,48,91,72,16509
15000US060730083403,924,201,0,12,0,12,0,12,924,201,107,100,817,195,16510
15000US060730083404,1108,241,22,37,0,12,22,37,1086,242,107,75,979,245,16511
15000US060730083411,1085,161,13,21,0,12,13,21,1072,165,206,85,866,156,16512
15000US060730083412,2398,202,0,17,0,17,0,17,2398,202,194,51,2204,200,16513
15000US060730083431,1017,117,17,19,10,15,7,12,1000,120,238,110,762,128,16514
15000US060730083432,505,98,0,12,0,12,0,12,505,98,38,31,467,96,16515
15000US060730083433,451,84,9,14,0,12,9,14,442,83,22,20,420,87,16516
15000US060730083441,657,62,18,18,8,12,10,14,639,63,43,30,596,62,16517
15000US060730083442,591,70,8,12,0,12,8,12,583,73,154,65,429,72,16518
15000US060730083451,456,52,12,17,12,17,0,12,444,55,99,45,345,62,16519
15000US060730083452,825,98,12,19,12,19,0,12,813,102,211,75,602,116,16520
15000US060730083453,489,84,10,15,0,12,10,15,479,84,76,36,403,86,16521
15000US060730083461,1123,86,0,12,0,12,0,12,1123,86,135,65,988,89,16522
15000US060730083462,532,68,0,12,0,12,0,12,532,68,94,41,438,75,16523
15000US060730083471,1036,91,30,30,22,27,8,13,1006,96,163,59,843,109,16524
15000US060730083472,438,79,40,49,0,12,40,49,398,77,101,54,297,76,16525
15000US060730083473,390,60,7,11,7,11,0,12,383,61,40,29,343,66,16526
15000US060730083474,211,51,0,12,0,12,0,12,211,51,38,27,173,55,16527
15000US060730083481,657,96,11,16,0,12,11,16,646,96,151,61,495,103,16528
15000US060730083482,324,86,8,13,0,12,8,13,316,87,59,43,257,88,16529
15000US060730083483,814,87,52,53,15,23,37,49,762,91,70,39,692,95,16530
15000US060730083491,462,59,1,5,0,12,1,5,461,59,71,36,390,62,16531
15000US060730083492,606,66,15,19,15,19,0,12,591,69,112,45,479,74,16532
15000US060730083501,755,142,0,12,0,12,0,12,755,142,78,55,677,150,16533
15000US060730083502,338,100,0,12,0,12,0,12,338,100,48,46,290,104,16534
15000US060730083503,328,73,0,12,0,12,0,12,328,73,29,34,299,74,16535
15000US060730083504,740,120,0,12,0,12,0,12,740,120,37,42,703,117,16536
15000US060730083511,375,73,6,9,0,12,6,9,369,74,94,47,275,88,16537
15000US060730083512,197,40,19,23,10,19,9,14,178,39,30,26,148,40,16538
15000US060730083513,327,74,20,32,0,12,20,32,307,75,67,30,240,76,16539
15000US060730083514,417,62,27,24,27,24,0,12,390,64,66,38,324,68,16540
15000US060730083521,259,57,20,32,20,32,0,12,239,50,69,31,170,53,16541
15000US060730083522,402,52,43,32,11,16,32,29,359,56,86,41,273,62,16542
15000US060730083523,418,81,21,23,0,12,21,23,397,85,55,37,342,86,16543
15000US060730083531,340,63,22,34,0,12,22,34,318,64,53,36,265,63,16544
15000US060730083532,925,69,56,38,31,30,25,25,869,72,187,70,682,101,16545
15000US060730083533,269,55,23,36,0,12,23,36,246,53,28,25,218,51,16546
15000US060730083541,1619,133,47,61,0,17,47,61,1572,146,246,142,1326,190,16547
15000US060730083542,865,130,0,12,0,12,0,12,865,130,98,59,767,134,16548
15000US060730083551,276,50,4,6,4,6,0,12,272,51,63,23,209,48,16549
15000US060730083552,707,50,9,11,4,7,5,7,698,53,137,49,561,69,16550
15000US060730083561,732,91,19,23,12,19,7,12,713,93,66,37,647,98,16551
15000US060730083562,632,84,57,68,14,24,43,56,575,88,73,31,502,85,16552
15000US060730083571,399,77,6,10,6,10,0,12,393,78,92,46,301,78,16553
15000US060730083572,364,83,78,66,40,47,38,54,286,65,71,36,215,66,16554
15000US060730083573,695,90,34,33,9,15,25,29,661,85,95,43,566,91,16555
15000US060730083581,668,120,0,12,0,12,0,12,668,120,99,61,569,125,16556
15000US060730083582,229,91,0,12,0,12,0,12,229,91,55,44,174,84,16557
15000US060730083583,749,131,72,58,30,38,42,47,677,139,171,102,506,127,16558
15000US060730083584,581,102,31,49,31,49,0,12,550,109,87,55,463,111,16559
15000US060730083591,1006,96,27,23,6,10,21,21,979,93,115,46,864,103,16560
15000US060730083592,800,88,78,43,0,12,78,43,722,103,140,68,582,95,16561
15000US060730083601,659,132,30,35,14,24,16,25,629,136,87,55,542,147,16562
15000US060730083602,506,119,0,12,0,12,0,12,506,119,78,64,428,119,16563
15000US060730083603,883,127,18,37,18,37,0,12,865,130,201,86,664,142,16564
15000US060730083611,879,117,0,12,0,12,0,12,879,117,80,51,799,122,16565
15000US060730083612,415,91,13,21,0,12,13,21,402,89,29,26,373,90,16566
15000US060730083621,570,86,0,12,0,12,0,12,570,86,28,27,542,88,16567
15000US060730083622,312,50,9,14,0,12,9,14,303,49,35,30,268,52,16568
15000US060730083623,642,89,18,20,0,12,18,20,624,92,9,14,615,94,16569
15000US060730083631,414,97,18,28,18,28,0,12,396,97,0,12,396,97,16570
15000US060730083632,1202,147,38,59,0,12,38,59,1164,147,92,82,1072,149,16571
15000US060730083633,585,127,0,12,0,12,0,12,585,127,25,32,560,133,16572
15000US060730083641,631,157,0,12,0,12,0,12,631,157,100,86,531,146,16573
15000US060730083642,1032,190,0,12,0,12,0,12,1032,190,51,47,981,190,16574
15000US060730083643,998,173,0,12,0,12,0,12,998,173,42,45,956,172,16575
15000US060730083651,594,41,0,12,0,12,0,12,594,41,116,59,478,56,16576
15000US060730083652,358,39,12,11,5,9,7,11,346,39,39,22,307,44,16577
15000US060730083661,2182,39,10,15,0,17,10,15,2172,43,302,97,1870,102,16578
15000US060730085011,615,108,32,42,17,29,15,25,583,114,140,79,443,113,16579
15000US060730085012,719,119,0,12,0,12,0,12,719,119,132,67,587,119,16580
15000US060730085013,428,80,0,12,0,12,0,12,428,80,104,59,324,87,16581
15000US060730085014,356,81,33,38,0,12,33,38,323,88,13,21,310,89,16582
15000US060730085021,538,92,0,12,0,12,0,12,538,92,204,94,334,103,16583
15000US060730085022,419,116,33,40,0,12,33,40,386,112,131,87,255,79,16584
15000US060730085023,321,90,12,21,0,12,12,21,309,95,11,22,298,96,16585
15000US060730085024,454,101,21,32,21,32,0,12,433,106,134,62,299,112,16586
15000US060730085025,564,97,15,23,0,12,15,23,549,99,71,53,478,95,16587
15000US060730085031,959,143,21,33,21,33,0,12,938,140,148,75,790,148,16588
15000US060730085032,435,98,33,52,0,12,33,52,402,86,72,57,330,93,16589
15000US060730085033,796,127,0,12,0,12,0,12,796,127,226,106,570,112,16590
15000US060730085034,630,120,20,31,20,31,0,12,610,126,94,73,516,131,16591
15000US060730085041,321,108,39,40,11,18,28,36,282,123,60,62,222,115,16592
15000US060730085042,427,134,0,12,0,12,0,12,427,134,142,101,285,97,16593
15000US060730085043,504,112,18,28,18,28,0,12,486,110,162,81,324,119,16594
15000US060730085044,294,83,11,19,11,19,0,12,283,82,85,68,198,75,16595
15000US060730085045,663,129,25,40,0,12,25,40,638,129,134,67,504,136,16596
15000US060730085051,479,114,0,12,0,12,0,12,479,114,53,35,426,114,16597
15000US060730085052,445,106,21,24,21,24,0,12,424,104,44,45,380,102,16598
15000US060730085053,230,56,0,12,0,12,0,12,230,56,36,28,194,55,16599
15000US060730085054,415,85,13,21,13,21,0,12,402,88,101,79,301,80,16600
15000US060730085055,545,132,12,19,0,12,12,19,533,138,77,58,456,135,16601
15000US060730085061,493,86,52,35,14,21,38,38,441,91,88,55,353,88,16602
15000US060730085062,530,75,29,28,9,16,20,22,501,80,92,60,409,77,16603
15000US060730085063,508,69,0,12,0,12,0,12,508,69,97,48,411,75,16604
15000US060730085071,435,96,3,12,3,12,0,12,432,95,84,69,348,91,16605
15000US060730085072,429,154,35,47,0,12,35,47,394,154,36,34,358,155,16606
15000US060730085073,499,121,47,39,16,25,31,37,452,120,104,62,348,113,16607
15000US060730085074,724,150,0,12,0,12,0,12,724,150,154,117,570,155,16608
15000US060730085075,445,130,9,18,0,12,9,18,436,129,143,89,293,124,16609
15000US060730085076,354,147,0,12,0,12,0,12,354,147,147,107,207,129,16610
15000US060730085091,300,82,0,12,0,12,0,12,300,82,75,53,225,89,16611
15000US060730085092,299,85,0,12,0,12,0,12,299,85,113,62,186,83,16612
15000US060730085093,289,85,0,12,0,12,0,12,289,85,38,43,251,85,16613
15000US060730085094,1498,139,105,67,87,61,18,30,1393,146,361,132,1032,171,16614
15000US060730085095,439,112,15,24,0,12,15,24,424,113,44,35,380,119,16615
15000US060730085101,665,133,15,25,15,25,0,12,650,132,98,76,552,150,16616
15000US060730085102,762,118,30,35,0,12,30,35,732,117,306,113,426,127,16617
15000US060730085103,786,144,82,81,82,81,0,12,704,140,249,104,455,141,16618
15000US060730085104,715,142,18,29,0,12,18,29,697,137,87,62,610,153,16619
15000US060730085111,1562,99,63,52,20,22,43,48,1499,114,235,112,1264,111,16620
15000US060730085121,244,48,0,12,0,12,0,12,244,48,35,23,209,48,16621
15000US060730085122,471,74,9,14,0,12,9,14,462,73,171,62,291,74,16622
15000US060730085123,842,98,12,13,12,13,0,12,830,98,187,65,643,102,16623
15000US060730085131,708,62,34,37,15,16,19,29,674,75,101,44,573,88,16624
15000US060730085132,387,55,0,12,0,12,0,12,387,55,75,39,312,71,16625
15000US060730086001,892,99,64,49,33,42,31,26,828,100,309,88,519,100,16626
15000US060730086002,377,96,8,13,0,12,8,13,369,95,83,62,286,89,16627
15000US060730086003,197,68,17,20,6,10,11,16,180,63,49,40,131,57,16628
15000US060730086004,498,114,123,80,21,34,102,75,375,119,20,19,355,120,16629
15000US060730087011,469,71,32,30,0,12,32,30,437,73,72,35,365,74,16630
15000US060730087012,748,66,32,42,0,12,32,42,716,78,59,34,657,79,16631
15000US060730087021,486,93,38,44,0,12,38,44,448,91,41,32,407,94,16632
15000US060730087022,689,83,40,25,15,14,25,23,649,86,133,50,516,100,16633
15000US060730087023,542,106,32,26,15,18,17,19,510,106,17,18,493,106,16634
15000US060730088001,516,92,64,35,16,23,48,25,452,91,72,38,380,97,16635
15000US060730088002,399,79,80,63,29,25,51,57,319,86,93,50,226,72,16636
15000US060730088003,430,90,18,18,0,12,18,18,412,91,143,67,269,78,16637
15000US060730088004,632,109,86,57,17,23,69,51,546,118,150,78,396,126,16638
15000US060730089011,295,87,12,21,0,12,12,21,283,86,58,67,225,82,16639
15000US060730089012,176,54,0,12,0,12,0,12,176,54,70,44,106,51,16640
15000US060730089013,868,138,0,12,0,12,0,12,868,138,135,82,733,147,16641
15000US060730089014,959,178,0,12,0,12,0,12,959,178,44,42,915,175,16642
15000US060730089021,627,90,0,12,0,12,0,12,627,90,77,52,550,99,16643
15000US060730089022,655,96,0,12,0,12,0,12,655,96,158,60,497,95,16644
15000US060730090001,954,89,73,55,41,33,32,43,881,104,165,68,716,106,16645
15000US060730090002,304,79,29,25,20,20,9,14,275,83,56,39,219,80,16646
15000US060730091011,407,91,0,12,0,12,0,12,407,91,165,101,242,86,16647
15000US060730091012,886,135,21,31,21,31,0,12,865,139,111,75,754,157,16648
15000US060730091013,420,99,21,35,0,12,21,35,399,103,111,97,288,80,16649
15000US060730091014,607,125,32,40,32,40,0,12,575,133,87,63,488,140,16650
15000US060730091021,885,112,60,50,34,43,26,26,825,116,209,76,616,117,16651
15000US060730091022,947,109,60,49,0,12,60,49,887,113,87,65,800,115,16652
15000US060730091031,291,57,8,12,8,12,0,12,283,57,75,33,208,67,16653
15000US060730091032,288,67,0,12,0,12,0,12,288,67,57,33,231,72,16654
15000US060730091033,500,69,12,18,12,18,0,12,488,63,96,41,392,71,16655
15000US060730091034,452,81,0,12,0,12,0,12,452,81,170,86,282,66,16656
15000US060730091041,480,80,26,23,10,16,16,17,454,82,59,38,395,86,16657
15000US060730091042,713,73,0,12,0,12,0,12,713,73,218,68,495,87,16658
15000US060730091061,479,49,4,6,0,12,4,6,475,50,47,27,428,55,16659
15000US060730091062,119,41,11,11,11,11,0,12,108,43,26,28,82,41,16660
15000US060730091063,307,44,5,8,5,8,0,12,302,44,87,42,215,45,16661
15000US060730091071,1230,141,42,51,0,12,42,51,1188,140,83,69,1105,153,16662
15000US060730091072,848,132,0,12,0,12,0,12,848,132,135,73,713,139,16663
15000US060730092011,543,113,48,39,9,16,39,35,495,111,70,40,425,105,16664
15000US060730092012,403,112,17,19,17,19,0,12,386,116,43,36,343,114,16665
15000US060730092013,480,99,50,39,11,17,39,38,430,93,66,51,364,98,16666
15000US060730092014,392,83,0,12,0,12,0,12,392,83,9,14,383,82,16667
15000US060730092021,894,143,18,20,0,12,18,20,876,148,133,51,743,139,16668
15000US060730092022,1317,119,17,20,17,20,0,12,1300,121,263,100,1037,122,16669
15000US060730093011,338,60,9,14,0,12,9,14,329,63,55,46,274,62,16670
15000US060730093012,484,70,19,21,10,15,9,14,465,69,103,45,362,79,16671
15000US060730093013,750,91,43,31,26,23,17,19,707,100,116,69,591,108,16672
15000US060730093014,388,89,28,26,0,12,28,26,360,89,24,37,336,87,16673
15000US060730093041,1050,261,107,138,0,12,107,138,943,234,40,48,903,232,16674
15000US060730093042,649,154,0,12,0,12,0,12,649,154,59,94,590,167,16675
15000US060730093043,2427,302,50,83,0,12,50,83,2377,295,479,202,1898,304,16676
15000US060730093051,1263,185,0,12,0,12,0,12,1263,185,219,104,1044,167,16677
15000US060730093052,405,113,0,12,0,12,0,12,405,113,78,54,327,116,16678
15000US060730093053,329,98,9,28,0,12,9,28,320,103,18,20,302,107,16679
15000US060730093061,1085,176,18,29,0,12,18,29,1067,179,215,115,852,201,16680
15000US060730093062,235,88,16,42,16,42,0,12,219,79,55,40,164,74,16681
15000US060730093063,411,124,15,26,15,26,0,12,396,126,144,88,252,125,16682
15000US060730093064,664,141,20,31,20,31,0,12,644,142,96,74,548,133,16683
15000US060730094001,515,29,4,6,0,17,4,6,511,30,42,25,469,41,16684
15000US060730095021,556,53,0,12,0,12,0,12,556,53,120,43,436,62,16685
15000US060730095022,977,60,33,27,11,17,22,24,944,69,150,78,794,92,16686
15000US060730095041,1715,46,18,19,10,14,8,13,1697,49,220,72,1477,85,16687
15000US060730095042,270,41,0,12,0,12,0,12,270,41,42,28,228,43,16688
15000US060730095051,543,80,18,28,0,12,18,28,525,88,85,64,440,99,16689
15000US060730095052,590,114,0,12,0,12,0,12,590,114,76,55,514,121,16690
15000US060730095053,666,111,0,12,0,12,0,12,666,111,121,73,545,113,16691
15000US060730095054,811,114,0,12,0,12,0,12,811,114,133,74,678,114,16692
15000US060730095061,954,78,15,22,0,12,15,22,939,79,157,74,782,84,16693
15000US060730095062,671,73,0,12,0,12,0,12,671,73,114,53,557,79,16694
15000US060730095071,807,81,51,31,12,18,39,28,756,87,37,28,719,85,16695
15000US060730095072,179,67,12,18,12,18,0,12,167,64,46,40,121,60,16696
15000US060730095073,362,66,0,12,0,12,0,12,362,66,71,38,291,71,16697
15000US060730095091,1314,194,17,26,0,12,17,26,1297,195,109,88,1188,187,16698
15000US060730095092,531,89,37,45,19,34,18,30,494,94,178,88,316,100,16699
15000US060730095101,314,80,0,12,0,12,0,12,314,80,47,31,267,84,16700
15000US060730095102,595,79,21,25,21,25,0,12,574,81,65,43,509,89,16701
15000US060730095103,334,77,8,11,0,12,8,11,326,76,29,34,297,76,16702
15000US060730095111,441,73,40,40,7,10,33,39,401,77,99,61,302,78,16703
15000US060730095112,569,83,0,12,0,12,0,12,569,83,74,34,495,78,16704
15000US060730096021,630,67,10,16,10,16,0,12,620,68,118,51,502,80,16705
15000US060730096022,361,75,11,16,11,16,0,12,350,74,49,32,301,70,16706
15000US060730096023,375,70,9,15,0,12,9,15,366,71,57,34,309,76,16707
15000US060730096024,271,57,14,20,0,12,14,20,257,59,93,48,164,61,16708
15000US060730096031,719,142,19,31,0,12,19,31,700,139,76,51,624,145,16709
15000US060730096032,667,100,0,12,0,12,0,12,667,100,170,89,497,101,16710
15000US060730096033,821,136,0,12,0,12,0,12,821,136,178,120,643,122,16711
15000US060730096034,517,114,13,23,0,12,13,23,504,107,75,49,429,112,16712
15000US060730096041,285,65,0,12,0,12,0,12,285,65,91,42,194,57,16713
15000US060730096042,223,60,0,12,0,12,0,12,223,60,24,22,199,61,16714
15000US060730096043,466,89,48,58,7,11,41,57,418,71,36,27,382,75,16715
15000US060730096044,457,106,0,12,0,12,0,12,457,106,68,44,389,112,16716
15000US060730097031,340,62,7,11,7,11,0,12,333,63,116,43,217,69,16717
15000US060730097032,379,51,28,22,11,16,17,19,351,58,100,39,251,61,16718
15000US060730097033,608,92,0,12,0,12,0,12,608,92,178,71,430,95,16719
15000US060730097041,513,111,0,12,0,12,0,12,513,111,85,55,428,116,16720
15000US060730097042,440,93,16,26,16,26,0,12,424,95,36,40,388,103,16721
15000US060730097043,536,80,9,17,9,17,0,12,527,83,104,61,423,91,16722
15000US060730097044,269,68,0,12,0,12,0,12,269,68,34,27,235,75,16723
15000US060730097045,593,88,33,37,20,30,13,22,560,95,0,12,560,95,16724
15000US060730097051,248,40,0,12,0,12,0,12,248,40,104,39,144,45,16725
15000US060730097052,668,75,13,19,0,12,13,19,655,75,96,45,559,86,16726
15000US060730097053,543,69,21,24,21,24,0,12,522,70,59,39,463,76,16727
15000US060730097061,482,91,0,12,0,12,0,12,482,91,148,87,334,80,16728
15000US060730097062,475,114,23,26,12,19,11,18,452,116,45,42,407,112,16729
15000US060730097063,542,87,0,12,0,12,0,12,542,87,139,76,403,93,16730
15000US060730097064,231,64,0,12,0,12,0,12,231,64,100,65,131,58,16731
15000US060730097065,383,68,12,18,12,18,0,12,371,70,85,51,286,82,16732
15000US060730097066,368,90,0,12,0,12,0,12,368,90,160,88,208,89,16733
15000US060730097067,319,89,0,12,0,12,0,12,319,89,58,37,261,107,16734
15000US060730098011,396,103,0,12,0,12,0,12,396,103,43,42,353,105,16735
15000US060730098012,552,89,0,12,0,12,0,12,552,89,141,71,411,93,16736
15000US060730098013,712,101,0,12,0,12,0,12,712,101,115,68,597,112,16737
15000US060730098014,555,90,48,52,48,52,0,12,507,92,151,77,356,101,16738
15000US060730098021,414,97,0,12,0,12,0,12,414,97,145,81,269,87,16739
15000US060730098022,651,144,39,36,0,12,39,36,612,132,113,67,499,135,16740
15000US060730098023,487,129,74,89,57,83,17,28,413,127,29,33,384,129,16741
15000US060730098024,611,140,14,24,14,24,0,12,597,140,189,98,408,124,16742
15000US060730098025,196,53,12,19,12,19,0,12,184,57,24,28,160,60,16743
15000US060730098041,594,91,25,21,19,19,6,10,569,88,203,64,366,99,16744
15000US060730098042,308,65,14,16,0,12,14,16,294,65,47,35,247,60,16745
15000US060730098043,305,63,7,11,7,11,0,12,298,63,45,40,253,61,16746
15000US060730098044,623,81,0,12,0,12,0,12,623,81,52,35,571,86,16747
15000US060730098051,533,71,27,26,11,18,16,18,506,72,49,28,457,74,16748
15000US060730098052,299,70,0,12,0,12,0,12,299,70,26,24,273,74,16749
15000US060730098053,409,67,0,12,0,12,0,12,409,67,79,39,330,70,16750
15000US060730098054,760,111,85,83,0,12,85,83,675,105,109,61,566,91,16751
15000US060730099011,4,6,0,12,0,12,0,12,4,6,0,12,4,6,16752
15000US060730099021,0,12,0,12,0,12,0,12,0,12,0,12,0,12,16753
15000US060730100011,440,86,6,9,6,9,0,12,434,87,179,89,255,81,16754
15000US060730100012,647,96,43,28,34,24,9,15,604,96,118,65,486,98,16755
15000US060730100031,440,104,95,72,9,13,86,72,345,101,89,45,256,102,16756
15000US060730100032,398,81,63,63,12,19,51,60,335,72,115,58,220,69,16757
15000US060730100033,318,84,29,41,23,39,6,11,289,87,128,72,161,65,16758
15000US060730100034,373,89,37,39,24,34,13,21,336,82,143,68,193,71,16759
15000US060730100041,464,80,27,26,12,18,15,21,437,79,289,86,148,56,16760
15000US060730100042,657,81,150,67,70,40,80,63,507,90,137,61,370,104,16761
15000US060730100051,528,105,81,71,22,36,59,56,447,99,194,80,253,74,16762
15000US060730100052,382,95,34,40,0,12,34,40,348,90,173,80,175,72,16763
15000US060730100053,733,105,347,99,163,86,184,74,386,97,146,68,240,87,16764
15000US060730100054,382,81,191,73,26,30,165,68,191,68,38,26,153,61,16765
15000US060730100091,894,92,324,111,151,82,173,90,570,117,164,83,406,120,16766
15000US060730100092,438,82,35,43,35,43,0,12,403,72,119,53,284,71,16767
15000US060730100093,123,54,37,41,0,12,37,41,86,51,9,14,77,53,16768
15000US060730100094,219,67,65,55,18,27,47,49,154,78,37,43,117,73,16769
15000US060730100101,489,75,76,44,55,44,21,20,413,82,131,52,282,84,16770
15000US060730100102,681,74,97,53,27,21,70,50,584,94,201,87,383,96,16771
15000US060730100103,539,87,58,50,6,10,52,48,481,87,208,79,273,75,16772
15000US060730100111,442,58,22,19,16,18,6,8,420,60,119,50,301,61,16773
15000US060730100112,484,61,138,47,79,41,59,38,346,59,122,40,224,57,16774
15000US060730100121,174,59,0,12,0,12,0,12,174,59,34,21,140,58,16775
15000US060730100122,715,90,89,45,43,41,46,41,626,90,144,73,482,105,16776
15000US060730100123,446,82,144,71,37,39,107,70,302,85,99,54,203,82,16777
15000US060730100131,641,87,180,80,71,52,109,67,461,101,149,68,312,96,16778
15000US060730100132,823,92,215,69,137,61,78,46,608,105,282,76,326,89,16779
15000US060730100141,0,12,0,12,0,12,0,12,0,12,0,12,0,12,16780
15000US060730100142,4157,168,94,78,71,70,23,37,4063,185,499,168,3564,253,16781
15000US060730100151,683,41,82,31,25,19,57,29,601,46,137,39,464,51,16782
15000US060730101031,539,98,180,69,67,49,113,66,359,86,100,50,259,69,16783
15000US060730101032,420,91,63,50,11,16,52,49,357,84,110,52,247,77,16784
15000US060730101033,883,108,92,71,82,69,10,16,791,110,232,92,559,115,16785
15000US060730101041,539,73,67,52,13,15,54,52,472,85,117,45,355,90,16786
15000US060730101042,484,64,53,38,0,12,53,38,431,71,120,46,311,72,16787
15000US060730101061,599,109,73,63,0,12,73,63,526,105,212,74,314,104,16788
15000US060730101062,614,100,156,73,99,69,57,41,458,93,125,61,333,106,16789
15000US060730101063,397,101,117,68,61,54,56,46,280,90,75,54,205,80,16790
15000US060730101071,674,118,63,53,8,13,55,51,611,111,151,81,460,103,16791
15000US060730101072,261,71,59,48,0,12,59,48,202,63,73,36,129,55,16792
15000US060730101073,516,108,82,57,73,55,9,13,434,107,143,80,291,106,16793
15000US060730101074,303,69,10,18,0,12,10,18,293,70,56,40,237,69,16794
15000US060730101091,569,93,31,34,0,12,31,34,538,88,139,68,399,94,16795
15000US060730101092,610,81,119,51,14,21,105,50,491,91,122,49,369,90,16796
15000US060730101101,604,151,114,85,0,12,114,85,490,142,127,69,363,147,16797
15000US060730101102,555,101,135,84,65,68,70,55,420,116,113,74,307,120,16798
15000US060730101103,338,81,13,21,13,21,0,12,325,82,78,56,247,90,16799
15000US060730101104,421,130,126,84,50,52,76,62,295,116,148,91,147,95,16800
15000US060730101105,221,73,40,48,14,23,26,41,181,58,90,47,91,48,16801
15000US060730101111,313,56,40,30,3,8,37,29,273,58,99,40,174,59,16802
15000US060730101112,494,70,162,64,56,38,106,56,332,70,145,60,187,73,16803
15000US060730101121,788,83,222,79,103,54,119,60,566,103,168,66,398,101,16804
15000US060730101122,550,85,100,51,62,40,38,31,450,89,104,54,346,83,16805
15000US060730102001,494,149,27,30,0,12,27,30,467,144,101,83,366,130,16806
15000US060730102002,207,77,0,12,0,12,0,12,207,77,119,82,88,41,16807
15000US060730102003,527,159,48,60,0,12,48,60,479,154,121,69,358,142,16808
15000US060730102004,495,119,0,12,0,12,0,12,495,119,101,59,394,128,16809
15000US060730102005,418,125,0,12,0,12,0,12,418,125,111,54,307,123,16810
15000US060730102006,364,131,12,20,12,20,0,12,352,131,50,39,302,141,16811
15000US060730103001,239,68,4,8,0,12,4,8,235,67,85,46,150,65,16812
15000US060730103002,505,98,96,54,11,16,85,53,409,95,97,42,312,92,16813
15000US060730103003,429,96,164,84,92,82,72,57,265,90,89,59,176,73,16814
15000US060730103004,256,58,40,31,30,28,10,15,216,59,105,56,111,46,16815
15000US060730104011,762,55,147,42,57,24,90,39,615,68,161,54,454,69,16816
15000US060730104021,591,88,92,55,25,23,67,51,499,97,173,52,326,90,16817
15000US060730104022,375,75,45,43,7,12,38,41,330,73,112,50,218,68,16818
15000US060730104023,922,97,148,64,109,63,39,44,774,101,73,47,701,105,16819
15000US060730105011,564,37,33,22,26,19,7,9,531,41,172,55,359,55,16820
15000US060730105021,448,97,73,55,1,7,72,55,375,100,62,53,313,92,16821
15000US060730105022,405,92,99,73,43,44,56,56,306,88,88,49,218,80,16822
15000US060730105023,520,99,103,64,22,34,81,54,417,101,82,54,335,96,16823
15000US060730105024,512,102,94,66,33,43,61,52,418,109,175,81,243,92,16824
15000US060730106011,515,74,7,12,0,12,7,12,508,74,125,52,383,77,16825
15000US060730106012,526,68,0,12,0,12,0,12,526,68,122,43,404,75,16826
15000US060730108001,622,117,9,14,0,12,9,14,613,117,65,47,548,124,16827
15000US060730108002,582,86,0,12,0,12,0,12,582,86,63,35,519,82,16828
15000US060730109001,341,58,6,9,0,12,6,9,335,59,70,43,265,53,16829
15000US060730109002,550,61,14,14,7,10,7,10,536,62,123,45,413,66,16830
15000US060730110001,1106,135,0,12,0,12,0,12,1106,135,138,58,968,151,16831
15000US060730110002,527,87,0,12,0,12,0,12,527,87,83,43,444,88,16832
15000US060730111001,1091,132,24,25,23,25,1,7,1067,133,155,62,912,149,16833
15000US060730111002,588,94,0,12,0,12,0,12,588,94,104,73,484,89,16834
15000US060730111003,288,77,9,15,0,12,9,15,279,76,55,32,224,80,16835
15000US060730113001,43,14,0,12,0,12,0,12,43,14,3,5,40,16,16836
15000US060730116011,478,92,81,50,7,11,74,50,397,94,122,50,275,94,16837
15000US060730116012,436,101,125,65,34,32,91,60,311,99,76,51,235,88,16838
15000US060730116013,732,96,155,67,61,42,94,52,577,93,91,46,486,96,16839
15000US060730116021,701,65,133,49,50,34,83,39,568,80,112,44,456,77,16840
15000US060730116022,344,60,57,33,13,12,44,32,287,59,70,33,217,60,16841
15000US060730117001,753,155,0,12,0,12,0,12,753,155,117,68,636,157,16842
15000US060730117002,527,128,110,81,49,59,61,60,417,126,67,49,350,129,16843
15000US060730117003,435,123,100,72,30,36,70,64,335,112,205,87,130,87,16844
15000US060730117004,363,131,40,46,9,17,31,43,323,135,20,24,303,134,16845
15000US060730118011,535,79,77,56,45,41,32,39,458,87,157,73,301,94,16846
15000US060730118012,267,57,35,29,16,18,19,22,232,58,50,33,182,68,16847
15000US060730118013,250,81,36,30,22,25,14,17,214,79,84,64,130,57,16848
15000US060730118021,744,139,159,87,23,27,136,82,585,138,113,84,472,127,16849
15000US060730118022,549,117,61,49,5,10,56,48,488,123,148,70,340,115,16850
15000US060730118023,584,108,91,65,0,12,91,65,493,106,121,47,372,100,16851
15000US060730119021,259,67,8,14,8,14,0,12,251,67,86,55,165,61,16852
15000US060730119022,749,104,49,40,22,22,27,26,700,107,308,92,392,100,16853
15000US060730119023,247,66,18,22,14,16,4,13,229,68,131,68,98,48,16854
15000US060730119024,329,78,65,63,6,10,59,62,264,56,94,48,170,55,16855
15000US060730120021,264,63,26,31,0,12,26,31,238,68,48,29,190,64,16856
15000US060730120022,899,71,223,66,62,34,161,61,676,90,328,72,348,81,16857
15000US060730120031,347,48,41,39,0,12,41,39,306,59,93,37,213,45,16858
15000US060730120032,568,57,65,23,48,21,17,14,503,61,100,39,403,61,16859
15000US060730121011,680,48,78,41,43,34,35,25,602,52,139,35,463,54,16860
15000US060730121021,481,70,34,19,9,10,25,17,447,73,81,39,366,81,16861
15000US060730121022,438,60,129,57,57,41,72,38,309,62,124,35,185,55,16862
15000US060730122001,235,37,23,20,10,13,13,16,212,41,92,32,120,38,16863
15000US060730122002,653,58,108,40,33,19,75,37,545,60,160,48,385,58,16864
15000US060730123021,702,61,82,43,34,29,48,33,620,68,191,63,429,74,16865
15000US060730123031,771,99,112,70,69,51,43,42,659,94,109,54,550,99,16866
15000US060730123032,559,106,27,24,17,19,10,16,532,106,225,69,307,102,16867
15000US060730123041,410,89,29,36,0,12,29,36,381,90,74,53,307,87,16868
15000US060730123042,962,98,44,52,36,51,8,13,918,105,185,60,733,106,16869
15000US060730124011,413,81,82,50,56,42,26,32,331,87,58,46,273,83,16870
15000US060730124012,903,100,165,72,59,44,106,64,738,112,148,73,590,109,16871
15000US060730124021,472,99,112,57,19,23,93,53,360,104,30,22,330,104,16872
15000US060730124022,491,96,87,57,16,19,71,54,404,90,137,71,267,84,16873
15000US060730124023,927,137,230,100,94,76,136,87,697,145,98,50,599,139,16874
15000US060730125011,788,111,262,98,140,68,122,80,526,88,213,66,313,84,16875
15000US060730125012,430,105,43,41,9,15,34,38,387,107,40,27,347,107,16876
15000US060730125021,518,97,130,67,59,48,71,52,388,95,63,45,325,94,16877
15000US060730125022,699,100,70,45,26,30,44,36,629,95,116,72,513,98,16878
15000US060730125023,376,87,89,56,34,29,55,49,287,76,43,31,244,72,16879
15000US060730126001,386,85,34,39,34,39,0,12,352,87,56,55,296,87,16880
15000US060730126002,291,83,8,12,8,12,0,12,283,86,56,35,227,82,16881
15000US060730126003,380,90,81,62,26,35,55,56,299,74,91,58,208,79,16882
15000US060730126004,356,107,85,54,49,49,36,28,271,96,45,44,226,89,16883
15000US060730127001,1078,121,244,98,62,54,182,88,834,121,296,87,538,120,16884
15000US060730127002,647,99,118,61,24,21,94,59,529,94,138,60,391,93,16885
15000US060730128001,289,66,15,19,8,13,7,11,274,65,54,39,220,79,16886
15000US060730128002,374,68,0,12,0,12,0,12,374,68,54,31,320,70,16887
15000US060730128003,748,94,149,76,88,61,61,48,599,97,178,67,421,95,16888
15000US060730129001,421,93,50,48,17,19,33,44,371,87,75,38,296,83,16889
15000US060730129002,189,56,32,46,0,12,32,46,157,48,64,34,93,39,16890
15000US060730129003,393,83,25,22,25,22,0,12,368,84,61,41,307,78,16891
15000US060730130001,480,107,57,56,24,26,33,50,423,91,178,70,245,74,16892
15000US060730130002,476,107,55,53,8,14,47,49,421,99,138,75,283,86,16893
15000US060730130003,497,107,25,28,15,23,10,15,472,110,139,62,333,116,16894
15000US060730130004,390,89,41,60,0,12,41,60,349,81,76,53,273,64,16895
15000US060730131021,458,134,99,77,15,25,84,83,359,111,111,76,248,108,16896
15000US060730131022,1023,167,88,64,41,54,47,42,935,158,198,98,737,189,16897
15000US060730131023,658,139,125,111,36,51,89,92,533,141,83,65,450,152,16898
15000US060730131031,290,54,26,24,11,12,15,22,264,55,102,41,162,59,16899
15000US060730131032,447,65,95,37,35,20,60,31,352,60,116,44,236,53,16900
15000US060730131041,673,110,108,58,10,15,98,58,565,113,112,62,453,115,16901
15000US060730131042,328,65,0,12,0,12,0,12,328,65,124,59,204,66,16902
15000US060730131043,568,105,58,51,14,14,44,49,510,108,111,57,399,109,16903
15000US060730131044,336,91,71,48,9,13,62,47,265,86,66,52,199,82,16904
15000US060730132031,308,108,0,12,0,12,0,12,308,108,152,77,156,101,16905
15000US060730132032,233,100,27,33,27,33,0,12,206,102,13,20,193,101,16906
15000US060730132033,1050,168,385,161,109,96,276,125,665,177,68,64,597,163,16907
15000US060730132034,530,125,84,70,84,70,0,12,446,133,167,86,279,128,16908
15000US060730132041,442,76,111,68,33,40,78,58,331,76,79,45,252,78,16909
15000US060730132042,252,60,61,35,0,12,61,35,191,52,48,31,143,45,16910
15000US060730132043,476,80,134,68,74,56,60,45,342,84,114,54,228,79,16911
15000US060730132051,622,45,141,48,23,18,118,45,481,66,134,60,347,72,16912
15000US060730132061,1028,159,144,93,44,53,100,75,884,164,305,123,579,151,16913
15000US060730132062,584,133,96,82,0,12,96,82,488,123,246,88,242,117,16914
15000US060730132063,808,109,52,60,15,23,37,57,756,117,270,95,486,129,16915
15000US060730133011,884,93,113,84,69,70,44,55,771,116,232,94,539,103,16916
15000US060730133012,686,99,16,24,0,12,16,24,670,100,213,91,457,100,16917
15000US060730133021,579,81,93,55,22,26,71,47,486,76,176,55,310,79,16918
15000US060730133022,783,92,80,54,36,43,44,35,703,100,189,70,514,102,16919
15000US060730133031,814,93,85,59,16,17,69,54,729,102,263,78,466,102,16920
15000US060730133032,332,80,0,12,0,12,0,12,332,80,65,41,267,77,16921
15000US060730133033,332,76,10,15,10,15,0,12,322,75,73,38,249,74,16922
15000US060730133061,561,89,75,52,30,43,45,50,486,95,151,61,335,98,16923
15000US060730133062,677,94,111,62,4,8,107,62,566,105,145,73,421,98,16924
15000US060730133071,389,93,62,35,38,25,24,25,327,93,102,50,225,87,16925
15000US060730133072,660,92,35,29,11,15,24,23,625,93,193,57,432,92,16926
15000US060730133081,649,72,131,70,27,26,104,64,518,94,147,52,371,85,16927
15000US060730133082,266,48,17,23,5,9,12,20,249,52,113,41,136,46,16928
15000US060730133091,361,84,0,12,0,12,0,12,361,84,81,52,280,80,16929
15000US060730133092,295,74,0,12,0,12,0,12,295,74,75,51,220,71,16930
15000US060730133093,262,83,9,14,9,14,0,12,253,81,42,30,211,82,16931
15000US060730133094,665,117,34,32,0,12,34,32,631,115,150,60,481,117,16932
15000US060730133095,420,80,30,38,5,9,25,37,390,80,97,46,293,81,16933
15000US060730133101,2461,431,247,166,34,55,213,158,2214,462,252,177,1962,474,16934
15000US060730133102,6081,497,544,374,64,107,480,355,5537,544,1069,432,4468,648,16935
15000US060730133111,1410,208,0,17,0,17,0,17,1410,208,151,108,1259,190,16936
15000US060730133112,747,171,0,12,0,12,0,12,747,171,145,108,602,169,16937
15000US060730133113,344,117,0,12,0,12,0,12,344,117,50,39,294,114,16938
15000US060730133114,529,101,27,33,0,12,27,33,502,105,91,48,411,102,16939
15000US060730133121,790,55,64,42,46,36,18,19,726,65,129,40,597,64,16940
15000US060730133131,3847,212,153,90,88,91,65,82,3694,228,332,149,3362,267,16941
15000US060730133141,4907,237,81,75,15,25,66,74,4826,234,754,243,4072,346,16942
15000US060730134011,705,88,21,19,7,10,14,16,684,90,156,67,528,96,16943
15000US060730134012,656,84,39,33,0,12,39,33,617,89,153,56,464,92,16944
15000US060730134091,396,56,16,19,9,15,7,11,380,56,136,61,244,57,16945
15000US060730134092,864,108,0,12,0,12,0,12,864,108,181,69,683,102,16946
15000US060730134093,520,68,18,19,10,15,8,13,502,66,75,38,427,77,16947
15000US060730134101,1513,150,64,64,47,55,17,27,1449,164,300,123,1149,166,16948
15000US060730134102,355,84,0,12,0,12,0,12,355,84,66,64,289,84,16949
15000US060730134103,358,107,0,12,0,12,0,12,358,107,52,58,306,116,16950
15000US060730134111,623,83,9,14,0,12,9,14,614,86,171,60,443,85,16951
15000US060730134112,329,55,10,15,0,12,10,15,319,54,106,53,213,63,16952
15000US060730134113,284,74,6,11,6,11,0,12,278,76,38,27,240,79,16953
15000US060730134114,416,73,0,12,0,12,0,12,416,73,64,28,352,73,16954
15000US060730134121,916,109,6,10,6,10,0,12,910,109,181,85,729,122,16955
15000US060730134122,666,108,6,12,6,12,0,12,660,109,97,49,563,101,16956
15000US060730134141,721,133,55,86,0,12,55,86,666,129,158,86,508,149,16957
15000US060730134142,642,111,12,21,12,21,0,12,630,117,131,59,499,131,16958
15000US060730134143,348,122,0,12,0,12,0,12,348,122,87,78,261,124,16959
15000US060730134144,580,106,0,12,0,12,0,12,580,106,109,65,471,105,16960
15000US060730134151,504,45,21,19,15,15,6,11,483,48,82,30,401,49,16961
15000US060730134161,519,66,7,10,7,10,0,12,512,67,141,54,371,84,16962
15000US060730134162,668,76,36,31,23,25,13,19,632,85,182,75,450,84,16963
15000US060730134171,641,21,18,19,0,12,18,19,623,28,125,39,498,44,16964
15000US060730134181,511,116,0,12,0,12,0,12,511,116,119,89,392,103,16965
15000US060730134182,762,133,16,27,16,27,0,12,746,142,231,115,515,138,16966
15000US060730134183,483,112,0,12,0,12,0,12,483,112,256,86,227,103,16967
15000US060730134184,327,97,0,12,0,12,0,12,327,97,38,47,289,108,16968
15000US060730134191,1997,129,71,55,24,28,47,46,1926,131,180,98,1746,144,16969
15000US060730134192,404,110,49,50,0,12,49,50,355,110,59,57,296,103,16970
15000US060730134201,448,88,20,22,0,12,20,22,428,92,63,52,365,91,16971
15000US060730134202,597,78,6,11,0,12,6,11,591,79,186,77,405,109,16972
15000US060730134211,325,58,0,12,0,12,0,12,325,58,108,53,217,59,16973
15000US060730134212,569,75,10,16,0,12,10,16,559,74,73,39,486,83,16974
15000US060730134213,460,86,68,45,35,34,33,29,392,89,54,32,338,98,16975
15000US060730135031,622,136,127,93,64,87,63,72,495,113,154,83,341,114,16976
15000US060730135032,787,134,150,111,89,85,61,70,637,126,158,82,479,132,16977
15000US060730135033,581,129,11,17,0,12,11,17,570,127,120,84,450,98,16978
15000US060730135041,270,51,0,12,0,12,0,12,270,51,108,52,162,52,16979
15000US060730135042,269,42,7,11,0,12,7,11,262,42,23,22,239,48,16980
15000US060730135043,674,73,23,19,8,12,15,17,651,75,177,70,474,82,16981
15000US060730135051,987,137,108,75,63,68,45,34,879,132,269,81,610,127,16982
15000US060730135052,600,122,35,29,21,28,14,21,565,118,202,87,363,97,16983
15000US060730135053,226,63,7,11,7,11,0,12,219,64,132,60,87,43,16984
15000US060730135061,1147,74,169,79,63,59,106,70,978,90,253,92,725,113,16985
15000US060730136011,272,53,0,12,0,12,0,12,272,53,57,36,215,60,16986
15000US060730136012,578,103,57,55,8,13,49,53,521,89,125,66,396,82,16987
15000US060730136013,576,106,17,20,17,20,0,12,559,106,102,45,457,112,16988
15000US060730136014,502,93,71,66,20,33,51,57,431,96,113,69,318,101,16989
15000US060730136041,343,79,0,12,0,12,0,12,343,79,23,27,320,77,16990
15000US060730136042,309,108,0,12,0,12,0,12,309,108,47,51,262,111,16991
15000US060730136043,793,115,19,22,0,12,19,22,774,119,174,90,600,133,16992
15000US060730136044,677,149,117,87,14,22,103,86,560,152,37,38,523,151,16993
15000US060730136051,1017,133,95,92,95,92,0,12,922,150,144,68,778,150,16994
15000US060730136052,575,106,47,47,16,23,31,43,528,103,57,45,471,110,16995
15000US060730136053,515,105,15,24,0,12,15,24,500,104,138,60,362,112,16996
15000US060730136061,386,108,75,75,58,69,17,30,311,114,72,52,239,123,16997
15000US060730136062,799,133,34,38,16,25,18,28,765,142,229,122,536,140,16998
15000US060730136063,746,131,187,104,56,72,131,78,559,127,119,76,440,110,16999
15000US060730136064,890,123,17,26,17,26,0,12,873,123,414,93,459,125,17000
15000US060730137011,551,48,12,12,0,12,12,12,539,48,147,39,392,54,17001
15000US060730137012,317,48,31,37,7,8,24,36,286,49,57,28,229,48,17002
15000US060730137021,873,138,106,77,72,69,34,33,767,144,93,59,674,141,17003
15000US060730137022,492,115,147,106,0,12,147,106,345,110,108,70,237,115,17004
15000US060730137023,371,68,33,28,19,17,14,23,338,71,123,57,215,64,17005
15000US060730138011,554,98,79,50,21,24,58,44,475,92,113,58,362,81,17006
15000US060730138012,440,74,12,19,12,19,0,12,428,78,151,68,277,84,17007
15000US060730138013,596,99,72,52,29,29,43,42,524,104,153,68,371,114,17008
15000US060730138021,518,62,72,45,43,36,29,31,446,68,116,38,330,60,17009
15000US060730138022,394,62,93,53,69,49,24,23,301,60,104,44,197,54,17010
15000US060730139031,450,65,24,24,7,14,17,20,426,68,134,52,292,74,17011
15000US060730139032,877,79,72,46,26,29,46,35,805,88,292,75,513,89,17012
15000US060730139051,531,71,5,8,0,12,5,8,526,71,179,70,347,86,17013
15000US060730139052,330,73,72,51,8,13,64,50,258,77,13,15,245,74,17014
15000US060730139053,286,76,43,55,0,12,43,55,243,70,60,33,183,76,17015
15000US060730139061,1302,94,254,91,95,55,159,76,1048,137,351,114,697,138,17016
15000US060730139062,353,81,50,44,25,33,25,31,303,75,124,62,179,67,17017
15000US060730139071,419,97,96,63,27,41,69,50,323,101,45,41,278,95,17018
15000US060730139072,846,116,221,80,54,39,167,80,625,126,184,73,441,125,17019
15000US060730139081,214,60,41,32,13,20,28,25,173,53,61,32,112,48,17020
15000US060730139082,872,90,161,95,66,42,95,85,711,125,220,79,491,120,17021
15000US060730139091,478,114,92,54,77,45,15,27,386,108,180,100,206,75,17022
15000US060730139092,856,116,179,82,14,21,165,94,677,103,180,76,497,105,17023
15000US060730140011,246,63,51,48,51,48,0,12,195,60,30,23,165,58,17024
15000US060730140012,290,73,0,12,0,12,0,12,290,73,89,61,201,78,17025
15000US060730140013,543,116,26,28,12,14,14,24,517,114,169,87,348,87,17026
15000US060730140014,475,125,114,70,34,42,80,64,361,110,109,65,252,102,17027
15000US060730140021,589,91,32,25,13,14,19,21,557,99,217,86,340,78,17028
15000US060730140022,649,97,198,108,39,34,159,111,451,83,120,51,331,80,17029
15000US060730141011,569,87,61,48,21,23,40,41,508,96,96,52,412,102,17030
15000US060730141012,536,79,8,11,0,12,8,11,528,82,169,71,359,80,17031
15000US060730141021,665,89,83,49,28,26,55,42,582,98,184,59,398,95,17032
15000US060730141022,447,85,50,54,0,12,50,54,397,75,146,71,251,77,17033
15000US060730142001,584,90,64,44,33,37,31,26,520,90,116,59,404,75,17034
15000US060730142002,369,84,41,36,35,35,6,10,328,84,89,67,239,72,17035
15000US060730142003,569,83,18,20,10,15,8,12,551,85,177,75,374,93,17036
15000US060730142004,339,74,11,13,4,8,7,10,328,78,108,61,220,71,17037
15000US060730143001,759,101,74,61,0,12,74,61,685,98,174,64,511,104,17038
15000US060730143002,480,94,61,53,52,52,9,14,419,95,89,55,330,95,17039
15000US060730144001,805,128,182,76,110,62,72,55,623,121,186,81,437,111,17040
15000US060730144002,689,98,105,61,66,45,39,44,584,102,211,85,373,93,17041
15000US060730145001,471,75,48,32,9,13,39,29,423,81,92,53,331,84,17042
15000US060730145002,525,96,73,51,6,10,67,50,452,94,98,47,354,93,17043
15000US060730145003,344,71,7,12,7,12,0,12,337,72,94,63,243,59,17044
15000US060730146011,936,133,145,68,81,55,64,55,791,149,264,110,527,138,17045
15000US060730146012,729,127,127,81,16,27,111,75,602,149,82,56,520,145,17046
15000US060730146013,267,113,84,85,0,12,84,85,183,72,26,43,157,71,17047
15000US060730146021,600,74,7,10,0,12,7,10,593,75,96,39,497,71,17048
15000US060730146022,529,89,0,12,0,12,0,12,529,89,112,68,417,85,17049
15000US060730146023,639,85,27,36,3,7,24,36,612,81,80,48,532,89,17050
15000US060730147001,1080,169,174,103,33,40,141,109,906,157,171,125,735,161,17051
15000US060730147002,583,134,93,94,44,69,49,65,490,115,158,90,332,108,17052
15000US060730147003,797,139,72,53,31,36,41,38,725,138,162,70,563,144,17053
15000US060730147004,548,103,0,12,0,12,0,12,548,103,184,76,364,102,17054
15000US060730148031,692,182,55,45,13,20,42,49,637,184,33,28,604,181,17055
15000US060730148032,891,189,48,57,0,12,48,57,843,190,124,80,719,182,17056
15000US060730148033,755,147,10,16,0,12,10,16,745,150,389,137,356,129,17057
15000US060730148041,320,84,0,12,0,12,0,12,320,84,118,59,202,91,17058
15000US060730148042,953,126,37,59,0,12,37,59,916,131,355,125,561,109,17059
15000US060730148043,557,120,19,30,19,30,0,12,538,119,87,64,451,125,17060
15000US060730148051,521,123,0,12,0,12,0,12,521,123,74,49,447,129,17061
15000US060730148052,842,142,129,98,66,63,63,81,713,153,71,52,642,160,17062
15000US060730148053,579,114,32,36,17,27,15,24,547,116,105,92,442,108,17063
15000US060730148061,507,102,108,66,41,36,67,55,399,90,77,55,322,95,17064
15000US060730148062,710,87,10,24,10,24,0,12,700,90,197,75,503,101,17065
15000US060730149011,393,81,25,24,16,19,9,13,368,86,55,48,313,91,17066
15000US060730149012,862,118,144,98,77,58,67,63,718,125,86,38,632,128,17067
15000US060730149013,486,82,42,45,7,10,35,43,444,77,91,39,353,80,17068
15000US060730149021,1077,81,183,97,69,61,114,88,894,92,159,60,735,107,17069
15000US060730149022,375,75,12,18,12,18,0,12,363,77,108,69,255,76,17070
15000US060730150001,623,103,47,68,0,12,47,68,576,113,95,52,481,118,17071
15000US060730150002,1368,198,23,15,23,15,0,12,1345,197,178,81,1167,217,17072
15000US060730150003,411,132,125,111,54,67,71,86,286,110,130,92,156,80,17073
15000US060730150004,284,99,23,31,8,17,15,25,261,100,49,59,212,88,17074
15000US060730151001,353,52,0,12,0,12,0,12,353,52,134,49,219,58,17075
15000US060730151002,648,78,46,49,0,12,46,49,602,83,130,47,472,93,17076
15000US060730151003,411,89,54,46,7,12,47,44,357,91,22,24,335,87,17077
15000US060730151004,488,75,0,12,0,12,0,12,488,75,109,49,379,78,17078
15000US060730152001,517,101,0,12,0,12,0,12,517,101,150,65,367,77,17079
15000US060730152002,455,97,0,12,0,12,0,12,455,97,95,54,360,95,17080
15000US060730152003,243,56,0,12,0,12,0,12,243,56,38,26,205,54,17081
15000US060730152004,298,83,0,12,0,12,0,12,298,83,82,60,216,61,17082
15000US060730153011,429,76,86,56,4,10,82,59,343,70,56,34,287,70,17083
15000US060730153012,531,69,198,67,61,37,137,63,333,85,87,47,246,82,17084
15000US060730153021,916,70,96,54,46,41,50,43,820,89,210,58,610,94,17085
15000US060730153022,430,79,15,19,0,12,15,19,415,79,82,34,333,84,17086
15000US060730154031,462,45,7,8,4,6,3,5,455,46,120,38,335,53,17087
15000US060730154032,391,49,9,10,3,5,6,9,382,48,98,26,284,47,17088
15000US060730154041,776,151,257,101,91,73,166,112,519,129,188,107,331,100,17089
15000US060730154042,389,117,111,78,41,39,70,72,278,117,76,65,202,96,17090
15000US060730154043,604,129,103,84,52,78,51,49,501,106,35,44,466,108,17091
15000US060730154044,874,150,136,102,20,24,116,101,738,143,178,100,560,162,17092
15000US060730154051,848,105,132,74,48,41,84,69,716,97,180,74,536,97,17093
15000US060730154052,500,88,15,18,0,12,15,18,485,86,126,46,359,88,17094
15000US060730154053,581,93,6,10,0,12,6,10,575,94,126,67,449,103,17095
15000US060730154061,900,41,26,32,19,29,7,12,874,52,214,59,660,62,17096
15000US060730155011,338,87,11,13,0,12,11,13,327,84,65,42,262,71,17097
15000US060730155012,951,103,75,44,18,20,57,41,876,105,255,84,621,119,17098
15000US060730155013,548,85,39,39,29,35,10,15,509,89,196,71,313,78,17099
15000US060730155021,427,58,20,15,7,9,13,11,407,59,76,47,331,54,17100
15000US060730155022,523,69,20,16,10,11,10,15,503,70,98,38,405,71,17101
15000US060730156011,919,156,134,73,100,71,34,40,785,149,241,111,544,156,17102
15000US060730156012,592,120,61,50,52,50,9,16,531,113,95,61,436,105,17103
15000US060730156013,484,135,147,86,72,83,75,52,337,129,68,45,269,122,17104
15000US060730156021,419,50,0,12,0,12,0,12,419,50,66,24,353,48,17105
15000US060730156022,318,40,8,9,8,9,0,12,310,40,91,37,219,42,17106
15000US060730157011,462,118,78,55,13,22,65,49,384,116,77,55,307,112,17107
15000US060730157012,925,173,560,174,254,145,306,131,365,135,109,74,256,116,17108
15000US060730157013,728,167,210,103,96,71,114,92,518,163,90,53,428,164,17109
15000US060730157031,454,156,127,93,55,64,72,61,327,132,99,67,228,111,17110
15000US060730157032,892,134,318,137,123,68,195,122,574,112,318,110,256,88,17111
15000US060730157033,878,159,378,133,202,120,176,102,500,169,124,98,376,134,17112
15000US060730157041,587,83,152,64,39,35,113,62,435,88,127,65,308,83,17113
15000US060730157042,671,91,108,56,18,17,90,55,563,94,130,55,433,113,17114
15000US060730158011,858,102,177,78,98,68,79,47,681,120,271,103,410,120,17115
15000US060730158012,493,93,73,51,28,30,45,45,420,99,118,60,302,96,17116
15000US060730158021,347,70,44,32,17,19,27,26,303,73,84,49,219,72,17117
15000US060730158022,765,91,219,76,132,82,87,43,546,94,247,69,299,87,17118
15000US060730158023,336,92,149,84,61,69,88,63,187,73,71,54,116,52,17119
15000US060730159011,573,69,210,68,77,46,133,60,363,73,46,30,317,76,17120
15000US060730159012,373,62,148,58,56,40,92,47,225,63,79,47,146,67,17121
15000US060730159021,261,81,0,12,0,12,0,12,261,81,150,76,111,59,17122
15000US060730159022,477,97,152,77,10,15,142,74,325,86,144,67,181,77,17123
15000US060730159023,250,74,0,12,0,12,0,12,250,74,57,37,193,72,17124
15000US060730159024,723,131,180,70,69,38,111,64,543,128,158,86,385,107,17125
15000US060730160001,243,52,83,38,48,30,35,26,160,50,32,20,128,47,17126
15000US060730160002,602,62,37,39,0,12,37,39,565,61,69,29,496,68,17127
15000US060730161001,991,168,31,35,13,22,18,28,960,167,315,133,645,180,17128
15000US060730161002,622,135,39,51,0,12,39,51,583,144,171,92,412,137,17129
15000US060730161003,550,127,18,30,0,12,18,30,532,130,107,74,425,127,17130
15000US060730162011,779,134,102,84,0,12,102,84,677,143,120,69,557,155,17131
15000US060730162012,524,81,0,12,0,12,0,12,524,81,102,50,422,90,17132
15000US060730162013,749,118,0,12,0,12,0,12,749,118,252,106,497,111,17133
15000US060730162021,423,84,37,36,6,9,31,35,386,79,35,30,351,75,17134
15000US060730162022,959,93,155,82,28,43,127,78,804,125,115,60,689,120,17135
15000US060730163011,759,92,212,87,94,64,118,59,547,110,153,62,394,103,17136
15000US060730163012,968,106,198,73,67,40,131,63,770,116,180,66,590,121,17137
15000US060730163021,280,56,54,37,43,34,11,16,226,60,92,39,134,48,17138
15000US060730163022,704,103,279,96,50,36,229,92,425,91,104,58,321,84,17139
15000US060730163023,675,105,161,74,51,38,110,62,514,98,71,44,443,98,17140
15000US060730164011,201,47,0,12,0,12,0,12,201,47,23,21,178,47,17141
15000US060730164012,583,100,72,52,60,50,12,16,511,95,151,60,360,80,17142
15000US060730164013,826,109,100,63,54,53,46,33,726,103,248,90,478,100,17143
15000US060730164021,752,144,0,12,0,12,0,12,752,144,258,133,494,132,17144
15000US060730164022,151,45,0,12,0,12,0,12,151,45,11,17,140,47,17145
15000US060730164023,559,212,232,124,47,35,185,117,327,162,65,51,262,166,17146
15000US060730164024,502,138,157,110,52,57,105,94,345,131,102,87,243,119,17147
15000US060730164025,458,144,174,100,83,75,91,86,284,124,74,82,210,108,17148
15000US060730165021,234,74,27,30,27,30,0,12,207,69,60,53,147,66,17149
15000US060730165022,747,141,180,100,84,87,96,60,567,140,268,126,299,130,17150
15000US060730165023,710,127,296,117,91,68,205,102,414,118,95,74,319,110,17151
15000US060730165024,611,125,99,80,14,22,85,78,512,112,113,56,399,113,17152
15000US060730165031,603,75,102,41,53,28,49,33,501,75,113,54,388,74,17153
15000US060730165032,465,69,30,29,24,28,6,9,435,70,172,55,263,65,17154
15000US060730165041,987,156,177,96,53,50,124,87,810,159,283,102,527,138,17155
15000US060730165042,999,162,198,111,80,65,118,90,801,166,95,81,706,156,17156
15000US060730165043,213,75,65,61,23,28,42,64,148,56,59,58,89,55,17157
15000US060730165044,219,85,17,28,0,12,17,28,202,86,53,66,149,76,17158
15000US060730166051,859,163,16,26,0,12,16,26,843,170,182,101,661,145,17159
15000US060730166052,1066,138,0,12,0,12,0,12,1066,138,209,114,857,168,17160
15000US060730166053,406,100,12,20,0,12,12,20,394,102,60,44,334,97,17161
15000US060730166054,885,168,14,23,0,12,14,23,871,171,285,133,586,160,17162
15000US060730166061,693,75,32,39,0,12,32,39,661,86,131,69,530,92,17163
15000US060730166062,580,70,11,13,11,13,0,12,569,73,125,68,444,81,17164
15000US060730166071,1119,142,61,47,0,12,61,47,1058,146,287,102,771,142,17165
15000US060730166072,478,104,32,40,20,34,12,22,446,108,142,95,304,87,17166
15000US060730166073,684,133,35,39,35,39,0,12,649,131,125,90,524,113,17167
15000US060730166081,808,28,7,9,7,9,0,12,801,28,181,49,620,61,17168
15000US060730166091,624,66,31,28,31,28,0,12,593,66,90,48,503,74,17169
15000US060730166092,341,64,10,15,0,12,10,15,331,63,84,40,247,75,17170
15000US060730166093,780,82,125,62,66,53,59,39,655,93,130,54,525,103,17171
15000US060730166101,811,95,65,51,16,25,49,43,746,102,138,66,608,110,17172
15000US060730166102,619,98,56,60,56,60,0,12,563,88,123,47,440,79,17173
15000US060730166121,848,97,9,12,0,12,9,12,839,98,191,70,648,106,17174
15000US060730166122,221,63,8,14,8,14,0,12,213,64,28,33,185,56,17175
15000US060730166123,868,94,19,18,13,15,6,10,849,96,94,47,755,104,17176
15000US060730166131,279,40,0,12,0,12,0,12,279,40,100,34,179,40,17177
15000US060730166132,422,46,13,11,4,5,9,9,409,48,83,29,326,48,17178
15000US060730166141,755,91,10,15,0,12,10,15,745,94,30,25,715,95,17179
15000US060730166142,579,88,8,13,8,13,0,12,571,89,137,56,434,91,17180
15000US060730166151,857,53,48,35,35,33,13,14,809,66,89,34,720,72,17181
15000US060730166161,620,85,116,60,59,47,57,47,504,95,187,74,317,83,17182
15000US060730166162,743,82,78,49,31,30,47,35,665,80,141,55,524,88,17183
15000US060730166171,419,84,0,12,0,12,0,12,419,84,147,53,272,80,17184
15000US060730166172,913,95,103,55,44,38,59,39,810,98,214,66,596,86,17185
15000US060730167011,2917,178,95,78,54,61,41,45,2822,196,626,172,2196,231,17186
15000US060730167012,543,131,0,12,0,12,0,12,543,131,117,97,426,122,17187
15000US060730167021,888,171,36,35,18,28,18,22,852,174,298,137,554,157,17188
15000US060730167022,995,211,108,59,55,50,53,39,887,209,300,153,587,177,17189
15000US060730167023,268,90,0,12,0,12,0,12,268,90,0,12,268,90,17190
15000US060730167024,500,116,10,17,0,12,10,17,490,121,96,62,394,133,17191
15000US060730168021,294,90,24,37,0,12,24,37,270,81,12,20,258,81,17192
15000US060730168022,753,134,46,45,23,35,23,27,707,131,194,103,513,131,17193
15000US060730168023,389,96,40,37,28,32,12,19,349,102,181,94,168,81,17194
15000US060730168024,1182,157,0,12,0,12,0,12,1182,157,516,176,666,160,17195
15000US060730168041,817,168,74,82,0,12,74,82,743,166,156,81,587,161,17196
15000US060730168042,707,162,107,74,58,44,49,63,600,165,138,94,462,151,17197
15000US060730168043,533,141,155,102,85,78,70,75,378,113,41,43,337,103,17198
15000US060730168044,543,135,74,62,21,28,53,52,469,126,152,84,317,117,17199
15000US060730168061,570,87,37,25,18,19,19,21,533,89,139,57,394,94,17200
15000US060730168062,308,102,17,23,0,12,17,23,291,104,166,98,125,65,17201
15000US060730168063,587,92,201,73,99,47,102,59,386,82,139,75,247,73,17202
15000US060730168071,270,64,0,12,0,12,0,12,270,64,23,28,247,73,17203
15000US060730168072,802,132,0,12,0,12,0,12,802,132,259,131,543,142,17204
15000US060730168073,920,155,28,33,0,12,28,33,892,159,164,71,728,168,17205
15000US060730168074,405,130,18,27,18,27,0,12,387,127,80,56,307,137,17206
15000US060730168091,374,59,27,25,6,10,21,23,347,62,107,38,240,69,17207
15000US060730168092,644,86,14,20,0,12,14,20,630,86,86,39,544,87,17208
15000US060730168093,779,100,32,26,6,9,26,24,747,103,114,50,633,106,17209
15000US060730168101,891,40,44,34,17,17,27,28,847,49,269,62,578,71,17210
15000US060730168111,918,91,34,44,0,12,34,44,884,101,154,50,730,111,17211
15000US060730168112,645,111,103,63,68,58,35,29,542,106,195,84,347,87,17212
15000US060730169011,587,128,38,46,0,12,38,46,549,124,123,65,426,111,17213
15000US060730169012,452,121,0,12,0,12,0,12,452,121,141,77,311,117,17214
15000US060730169013,411,103,0,12,0,12,0,12,411,103,167,78,244,94,17215
15000US060730169014,769,160,53,62,53,62,0,12,716,151,141,62,575,158,17216
15000US060730169021,827,63,47,25,8,10,39,28,780,68,199,46,581,71,17217
15000US060730170061,606,59,12,18,12,18,0,12,594,64,125,65,469,75,17218
15000US060730170062,443,57,0,12,0,12,0,12,443,57,75,43,368,63,17219
15000US060730170091,773,106,29,28,17,19,12,19,744,106,164,59,580,102,17220
15000US060730170092,648,96,16,14,16,14,0,12,632,95,119,64,513,104,17221
15000US060730170101,332,66,9,14,9,14,0,12,323,67,57,35,266,74,17222
15000US060730170102,630,80,21,32,0,12,21,32,609,80,122,69,487,78,17223
15000US060730170141,807,97,24,39,24,39,0,12,783,102,438,82,345,85,17224
15000US060730170142,726,76,0,12,0,12,0,12,726,76,246,58,480,87,17225
15000US060730170151,329,83,0,12,0,12,0,12,329,83,120,83,209,64,17226
15000US060730170152,339,85,15,24,0,12,15,24,324,84,30,34,294,91,17227
15000US060730170153,1916,133,146,97,44,54,102,87,1770,143,258,132,1512,159,17228
15000US060730170154,596,104,0,12,0,12,0,12,596,104,103,75,493,115,17229
15000US060730170181,984,106,50,36,36,28,14,19,934,113,196,93,738,128,17230
15000US060730170182,800,108,0,12,0,12,0,12,800,108,179,74,621,99,17231
15000US060730170191,785,112,0,12,0,12,0,12,785,112,140,66,645,122,17232
15000US060730170192,796,124,12,22,0,12,12,22,784,124,359,100,425,124,17233
15000US060730170193,1247,130,0,12,0,12,0,12,1247,130,124,67,1123,159,17234
15000US060730170201,784,72,0,12,0,12,0,12,784,72,184,65,600,103,17235
15000US060730170202,483,72,0,12,0,12,0,12,483,72,107,61,376,73,17236
15000US060730170211,480,61,9,14,0,12,9,14,471,59,95,50,376,69,17237
15000US060730170212,458,76,8,14,0,12,8,14,450,77,86,42,364,76,17238
15000US060730170221,256,77,0,12,0,12,0,12,256,77,46,41,210,78,17239
15000US060730170222,235,61,0,12,0,12,0,12,235,61,68,42,167,67,17240
15000US060730170223,282,70,0,12,0,12,0,12,282,70,62,74,220,67,17241
15000US060730170224,487,98,0,12,0,12,0,12,487,98,58,47,429,99,17242
15000US060730170225,361,106,0,12,0,12,0,12,361,106,21,26,340,105,17243
15000US060730170226,525,85,0,12,0,12,0,12,525,85,45,31,480,86,17244
15000US060730170291,2112,214,0,17,0,17,0,17,2112,214,354,140,1758,230,17245
15000US060730170292,955,165,0,12,0,12,0,12,955,165,186,85,769,172,17246
15000US060730170301,4987,297,41,50,0,19,41,50,4946,290,861,316,4085,354,17247
15000US060730170302,311,122,20,35,0,12,20,35,291,119,46,55,245,117,17248
15000US060730170303,455,126,0,12,0,12,0,12,455,126,234,106,221,115,17249
15000US060730170304,1195,251,0,12,0,12,0,12,1195,251,87,82,1108,249,17250
15000US060730170311,358,70,8,13,8,13,0,12,350,69,62,37,288,74,17251
15000US060730170312,294,58,0,12,0,12,0,12,294,58,54,34,240,63,17252
15000US060730170313,691,71,20,20,20,20,0,12,671,71,54,38,617,80,17253
15000US060730170321,3363,245,0,19,0,19,0,19,3363,245,488,202,2875,312,17254
15000US060730170322,897,220,75,86,0,12,75,86,822,218,77,85,745,215,17255
15000US060730170331,475,75,25,25,0,12,25,25,450,74,44,26,406,78,17256
15000US060730170332,270,40,0,12,0,12,0,12,270,40,60,36,210,47,17257
15000US060730170333,807,78,5,9,5,9,0,12,802,79,256,80,546,81,17258
15000US060730170341,854,94,11,18,0,12,11,18,843,94,104,51,739,97,17259
15000US060730170342,288,60,34,50,0,12,34,50,254,44,52,32,202,45,17260
15000US060730170343,498,87,26,27,26,27,0,12,472,93,48,29,424,95,17261
15000US060730170351,342,54,6,8,0,12,6,8,336,55,63,37,273,53,17262
15000US060730170352,268,96,12,18,0,12,12,18,256,97,16,24,240,96,17263
15000US060730170353,386,65,162,54,38,35,124,51,224,60,115,43,109,45,17264
15000US060730170361,453,73,41,41,8,13,33,36,412,71,80,40,332,75,17265
15000US060730170362,360,62,0,12,0,12,0,12,360,62,61,32,299,68,17266
15000US060730170363,363,53,0,12,0,12,0,12,363,53,94,45,269,56,17267
15000US060730170371,767,108,51,55,0,12,51,55,716,117,42,29,674,117,17268
15000US060730170372,337,103,14,23,0,12,14,23,323,104,30,33,293,109,17269
15000US060730170373,679,136,31,36,0,12,31,36,648,137,93,61,555,133,17270
15000US060730170374,246,80,12,19,0,12,12,19,234,80,66,49,168,93,17271
15000US060730170391,244,49,0,12,0,12,0,12,244,49,48,27,196,55,17272
15000US060730170392,1513,115,19,28,19,28,0,12,1494,122,337,124,1157,165,17273
15000US060730170393,1033,127,12,19,0,12,12,19,1021,127,86,42,935,122,17274
15000US060730170401,518,77,65,48,24,39,41,29,453,76,85,48,368,71,17275
15000US060730170402,467,66,0,12,0,12,0,12,467,66,80,56,387,71,17276
15000US060730170403,447,86,19,21,9,13,10,16,428,90,70,43,358,89,17277
15000US060730170411,617,120,71,68,0,12,71,68,546,119,85,54,461,115,17278
15000US060730170412,616,103,38,38,38,38,0,12,578,109,146,100,432,104,17279
15000US060730170413,276,89,0,12,0,12,0,12,276,89,49,52,227,85,17280
15000US060730170414,459,135,0,12,0,12,0,12,459,135,164,80,295,121,17281
15000US060730170421,1052,145,13,21,0,12,13,21,1039,148,133,103,906,171,17282
15000US060730170422,722,122,0,12,0,12,0,12,722,122,26,41,696,117,17283
15000US060730170423,797,139,0,12,0,12,0,12,797,139,133,110,664,143,17284
15000US060730170431,1430,112,9,14,0,12,9,14,1421,113,75,44,1346,113,17285
15000US060730170432,719,79,0,12,0,12,0,12,719,79,67,46,652,88,17286
15000US060730170441,857,75,0,12,0,12,0,12,857,75,97,39,760,77,17287
15000US060730170442,931,78,0,12,0,12,0,12,931,78,110,53,821,86,17288
15000US060730170451,869,18,0,12,0,12,0,12,869,18,102,34,767,41,17289
15000US060730170461,997,75,0,12,0,12,0,12,997,75,141,54,856,84,17290
15000US060730170462,371,55,0,12,0,12,0,12,371,55,32,25,339,56,17291
15000US060730170471,526,55,0,12,0,12,0,12,526,55,62,34,464,57,17292
15000US060730170472,384,51,0,12,0,12,0,12,384,51,48,32,336,51,17293
15000US060730170473,509,61,0,12,0,12,0,12,509,61,62,44,447,65,17294
15000US060730170481,726,101,118,72,51,55,67,71,608,107,78,59,530,109,17295
15000US060730170482,454,102,59,51,45,52,14,23,395,91,71,47,324,95,17296
15000US060730170483,660,127,11,18,0,12,11,18,649,128,173,100,476,113,17297
15000US060730170484,265,76,0,12,0,12,0,12,265,76,52,40,213,70,17298
15000US060730170491,347,46,6,9,6,9,0,12,341,48,80,36,261,48,17299
15000US060730170492,602,57,88,40,26,21,62,41,514,64,97,30,417,70,17300
15000US060730170501,439,63,0,12,0,12,0,12,439,63,98,49,341,68,17301
15000US060730170502,619,69,30,27,8,12,22,24,589,79,138,59,451,94,17302
15000US060730170511,635,101,0,12,0,12,0,12,635,101,73,51,562,110,17303
15000US060730170512,470,90,0,12,0,12,0,12,470,90,134,70,336,101,17304
15000US060730170513,858,106,39,48,12,20,27,42,819,105,160,105,659,128,17305
15000US060730170521,836,141,0,12,0,12,0,12,836,141,65,51,771,151,17306
15000US060730170522,824,134,37,40,37,40,0,12,787,143,112,62,675,148,17307
15000US060730170523,523,95,52,75,0,12,52,75,471,88,91,60,380,86,17308
15000US060730170531,554,57,0,12,0,12,0,12,554,57,68,35,486,71,17309
15000US060730170532,522,59,0,12,0,12,0,12,522,59,66,36,456,71,17310
15000US060730170541,496,81,0,12,0,12,0,12,496,81,115,45,381,77,17311
15000US060730170542,245,39,0,12,0,12,0,12,245,39,74,40,171,35,17312
15000US060730170543,279,50,0,12,0,12,0,12,279,50,38,31,241,51,17313
15000US060730170544,958,96,0,12,0,12,0,12,958,96,321,78,637,94,17314
15000US060730170551,555,70,0,12,0,12,0,12,555,70,89,47,466,71,17315
15000US060730170552,677,95,7,11,7,11,0,12,670,93,41,31,629,100,17316
15000US060730170553,663,78,0,12,0,12,0,12,663,78,114,50,549,81,17317
15000US060730170561,1023,118,6,10,6,10,0,12,1017,119,59,35,958,123,17318
15000US060730170562,793,107,35,30,25,26,10,16,758,109,47,33,711,108,17319
15000US060730171041,839,81,6,10,6,10,0,12,833,82,131,55,702,94,17320
15000US060730171042,605,71,10,16,0,12,10,16,595,71,43,26,552,79,17321
15000US060730171061,514,104,0,12,0,12,0,12,514,104,56,42,458,111,17322
15000US060730171062,425,86,0,12,0,12,0,12,425,86,27,32,398,87,17323
15000US060730171063,417,114,7,11,0,12,7,11,410,115,45,44,365,109,17324
15000US060730171064,279,98,27,43,27,43,0,12,252,88,46,38,206,82,17325
15000US060730171071,582,43,2,6,2,6,0,12,580,43,88,35,492,48,17326
15000US060730171072,408,36,0,12,0,12,0,12,408,36,41,20,367,43,17327
15000US060730171081,266,47,0,12,0,12,0,12,266,47,38,28,228,50,17328
15000US060730171082,564,63,0,12,0,12,0,12,564,63,47,26,517,66,17329
15000US060730171083,530,76,13,20,0,12,13,20,517,80,137,70,380,73,17330
15000US060730171084,315,50,7,11,7,11,0,12,308,49,51,25,257,49,17331
15000US060730171091,836,148,0,12,0,12,0,12,836,148,72,56,764,144,17332
15000US060730171092,474,138,28,34,0,12,28,34,446,138,58,61,388,142,17333
15000US060730171093,417,110,32,36,32,36,0,12,385,111,58,48,327,117,17334
15000US060730171094,520,81,17,27,0,12,17,27,503,82,13,21,490,85,17335
15000US060730171101,646,149,17,26,17,26,0,12,629,148,164,128,465,160,17336
15000US060730171102,2288,225,100,87,24,36,76,79,2188,236,266,116,1922,237,17337
15000US060730171103,661,106,0,12,0,12,0,12,661,106,99,58,562,111,17338
15000US060730172001,702,184,0,12,0,12,0,12,702,184,197,129,505,169,17339
15000US060730172002,586,164,0,12,0,12,0,12,586,164,62,46,524,163,17340
15000US060730172003,531,174,75,104,0,12,75,104,456,173,13,27,443,169,17341
15000US060730172004,439,154,0,12,0,12,0,12,439,154,88,76,351,143,17342
15000US060730173031,363,71,0,12,0,12,0,12,363,71,75,40,288,70,17343
15000US060730173032,549,80,0,12,0,12,0,12,549,80,76,62,473,85,17344
15000US060730173033,199,54,0,12,0,12,0,12,199,54,15,19,184,55,17345
15000US060730173041,650,149,11,17,11,17,0,12,639,153,40,36,599,154,17346
15000US060730173042,621,158,32,38,13,22,19,31,589,168,38,25,551,167,17347
15000US060730173043,595,126,0,12,0,12,0,12,595,126,31,33,564,127,17348
15000US060730173044,957,178,0,12,0,12,0,12,957,178,143,88,814,179,17349
15000US060730173051,454,72,0,12,0,12,0,12,454,72,69,35,385,77,17350
15000US060730173052,294,67,0,12,0,12,0,12,294,67,107,56,187,59,17351
15000US060730173053,491,71,0,12,0,12,0,12,491,71,44,32,447,72,17352
15000US060730173061,805,94,0,12,0,12,0,12,805,94,72,45,733,97,17353
15000US060730173062,338,85,0,12,0,12,0,12,338,85,25,22,313,88,17354
15000US060730174011,782,123,36,58,36,58,0,12,746,129,77,53,669,131,17355
15000US060730174012,655,125,0,12,0,12,0,12,655,125,111,75,544,121,17356
15000US060730174013,538,115,0,12,0,12,0,12,538,115,35,27,503,117,17357
15000US060730174014,455,116,18,23,18,23,0,12,437,115,0,12,437,115,17358
15000US060730174031,607,117,0,12,0,12,0,12,607,117,263,120,344,112,17359
15000US060730174032,466,110,0,12,0,12,0,12,466,110,84,59,382,115,17360
15000US060730174033,518,112,0,12,0,12,0,12,518,112,146,87,372,119,17361
15000US060730174034,483,94,0,12,0,12,0,12,483,94,72,56,411,107,17362
15000US060730174041,350,109,0,12,0,12,0,12,350,109,45,43,305,102,17363
15000US060730174042,393,101,0,12,0,12,0,12,393,101,73,57,320,104,17364
15000US060730174043,1086,163,17,26,17,26,0,12,1069,165,432,132,637,142,17365
15000US060730174044,522,118,8,14,0,12,8,14,514,121,49,48,465,130,17366
15000US060730174045,269,70,0,12,0,12,0,12,269,70,105,69,164,75,17367
15000US060730175011,258,48,0,12,0,12,0,12,258,48,24,20,234,53,17368
15000US060730175012,554,99,13,19,0,12,13,19,541,98,11,13,530,98,17369
15000US060730175013,460,81,9,15,9,15,0,12,451,83,39,22,412,82,17370
15000US060730175021,340,75,12,17,12,17,0,12,328,76,56,36,272,84,17371
15000US060730175022,501,89,9,16,9,16,0,12,492,88,80,59,412,96,17372
15000US060730175023,340,72,0,12,0,12,0,12,340,72,29,25,311,70,17373
15000US060730176011,530,116,13,21,0,12,13,21,517,120,84,61,433,132,17374
15000US060730176012,621,130,0,12,0,12,0,12,621,130,93,75,528,127,17375
15000US060730176013,1087,117,0,12,0,12,0,12,1087,117,427,125,660,120,17376
15000US060730176031,394,43,17,11,0,12,17,11,377,43,75,35,302,53,17377
15000US060730176032,571,50,2,5,2,5,0,12,569,49,17,15,552,49,17378
15000US060730176041,1384,193,24,30,8,14,16,26,1360,195,394,133,966,181,17379
15000US060730176042,988,159,14,23,14,23,0,12,974,163,162,84,812,172,17380
15000US060730176043,639,126,20,28,6,14,14,22,619,126,70,52,549,122,17381
15000US060730177011,333,117,0,12,0,12,0,12,333,117,21,28,312,116,17382
15000US060730177012,806,152,29,46,0,12,29,46,777,148,82,63,695,142,17383
15000US060730177013,368,108,15,25,15,25,0,12,353,107,65,59,288,112,17384
15000US060730177014,771,128,27,40,27,40,0,12,744,129,31,36,713,135,17385
15000US060730177021,480,75,9,15,9,15,0,12,471,78,137,57,334,76,17386
15000US060730177022,374,74,0,12,0,12,0,12,374,74,54,52,320,76,17387
15000US060730177023,424,74,0,12,0,12,0,12,424,74,39,23,385,74,17388
15000US060730178011,340,101,0,12,0,12,0,12,340,101,70,58,270,105,17389
15000US060730178012,297,77,35,41,21,33,14,24,262,69,24,28,238,73,17390
15000US060730178013,724,134,0,12,0,12,0,12,724,134,191,89,533,138,17391
15000US060730178014,1047,131,0,12,0,12,0,12,1047,131,169,103,878,152,17392
15000US060730178081,571,102,16,26,16,26,0,12,555,104,161,73,394,104,17393
15000US060730178082,832,127,0,12,0,12,0,12,832,127,48,45,784,131,17394
15000US060730178083,430,92,0,12,0,12,0,12,430,92,47,47,383,98,17395
15000US060730178084,614,132,0,12,0,12,0,12,614,132,149,101,465,104,17396
15000US060730178091,835,69,21,17,3,6,18,17,814,73,130,35,684,73,17397
15000US060730178101,980,177,0,12,0,12,0,12,980,177,221,117,759,179,17398
15000US060730178102,1058,151,23,38,0,12,23,38,1035,154,322,133,713,131,17399
15000US060730178111,638,110,0,12,0,12,0,12,638,110,118,67,520,104,17400
15000US060730178112,966,141,0,12,0,12,0,12,966,141,103,56,863,149,17401
15000US060730178113,908,138,0,12,0,12,0,12,908,138,94,57,814,140,17402
15000US060730178114,385,95,0,12,0,12,0,12,385,95,52,55,333,98,17403
15000US060730178131,817,93,0,12,0,12,0,12,817,93,160,64,657,104,17404
15000US060730178132,977,121,43,38,12,19,31,33,934,129,156,59,778,127,17405
15000US060730179001,1011,196,28,37,0,12,28,37,983,201,179,76,804,188,17406
15000US060730179002,500,121,20,23,10,16,10,17,480,122,61,43,419,122,17407
15000US060730179003,410,115,15,22,0,12,15,22,395,120,54,45,341,128,17408
15000US060730179004,743,177,121,97,0,12,121,97,622,185,31,38,591,182,17409
15000US060730179005,416,102,0,12,0,12,0,12,416,102,24,22,392,102,17410
15000US060730180001,448,85,8,12,8,12,0,12,440,85,208,79,232,79,17411
15000US060730180002,1050,132,47,39,0,12,47,39,1003,140,80,36,923,136,17412
15000US060730180003,304,92,6,11,0,12,6,11,298,92,24,22,274,92,17413
15000US060730181001,710,142,66,63,44,57,22,32,644,157,183,89,461,160,17414
15000US060730181002,376,96,32,38,0,12,32,38,344,103,43,39,301,111,17415
15000US060730181003,429,120,0,12,0,12,0,12,429,120,38,37,391,124,17416
15000US060730181004,329,102,13,21,13,21,0,12,316,101,110,87,206,89,17417
15000US060730181005,311,94,0,12,0,12,0,12,311,94,90,68,221,92,17418
15000US060730181006,422,130,18,28,18,28,0,12,404,132,86,43,318,139,17419
15000US060730182001,643,147,31,35,0,12,31,35,612,152,106,74,506,170,17420
15000US060730182002,431,152,103,88,34,52,69,76,328,120,43,32,285,120,17421
15000US060730182003,566,181,166,137,34,38,132,128,400,152,51,46,349,147,17422
15000US060730182004,486,177,33,46,0,12,33,46,453,176,102,94,351,169,17423
15000US060730182005,444,124,0,12,0,12,0,12,444,124,0,12,444,124,17424
15000US060730183001,362,84,0,12,0,12,0,12,362,84,41,21,321,88,17425
15000US060730183002,399,106,0,12,0,12,0,12,399,106,45,32,354,105,17426
15000US060730183003,270,87,24,37,0,12,24,37,246,80,35,21,211,79,17427
15000US060730183004,245,79,10,16,10,16,0,12,235,76,52,41,183,77,17428
15000US060730184001,568,122,16,20,9,14,7,14,552,122,99,57,453,113,17429
15000US060730184002,389,97,39,30,21,23,18,20,350,100,116,67,234,81,17430
15000US060730184003,626,112,40,36,17,20,23,29,586,115,156,72,430,119,17431
15000US060730185041,434,116,0,12,0,12,0,12,434,116,0,12,434,116,17432
15000US060730185042,628,134,63,90,63,90,0,12,565,116,130,83,435,118,17433
15000US060730185043,812,154,16,22,0,12,16,22,796,155,88,71,708,151,17434
15000US060730185044,701,170,19,31,0,12,19,31,682,166,191,92,491,153,17435
15000US060730185071,567,144,94,80,0,12,94,80,473,130,209,99,264,101,17436
15000US060730185072,818,149,99,59,51,40,48,46,719,149,102,77,617,142,17437
15000US060730185073,419,89,0,12,0,12,0,12,419,89,70,35,349,86,17438
15000US060730185074,980,137,15,24,15,24,0,12,965,141,214,97,751,127,17439
15000US060730185091,464,106,139,80,36,30,103,75,325,92,47,35,278,86,17440
15000US060730185092,601,106,56,44,0,12,56,44,545,111,129,57,416,111,17441
15000US060730185093,386,93,52,48,21,23,31,44,334,96,123,73,211,87,17442
15000US060730185094,206,62,20,20,5,8,15,18,186,64,19,21,167,61,17443
15000US060730185101,349,50,8,10,0,12,8,10,341,50,111,35,230,56,17444
15000US060730185102,547,53,70,36,12,17,58,33,477,63,153,53,324,67,17445
15000US060730185111,401,83,21,23,8,13,13,20,380,82,81,45,299,83,17446
15000US060730185112,237,47,5,11,5,11,0,12,232,49,90,37,142,50,17447
15000US060730185113,211,56,0,12,0,12,0,12,211,56,50,31,161,60,17448
15000US060730185114,946,110,99,67,0,12,99,67,847,113,204,84,643,111,17449
15000US060730185121,949,99,22,35,0,12,22,35,927,100,340,88,587,110,17450
15000US060730185122,598,89,41,33,27,24,14,21,557,90,201,81,356,81,17451
15000US060730185123,513,68,35,27,15,16,20,23,478,68,165,62,313,77,17452
15000US060730185131,765,150,16,26,0,12,16,26,749,149,103,66,646,169,17453
15000US060730185132,2075,226,0,17,0,17,0,17,2075,226,546,152,1529,237,17454
15000US060730185133,563,118,0,12,0,12,0,12,563,118,96,87,467,122,17455
15000US060730185141,1528,163,0,12,0,12,0,12,1528,163,301,137,1227,202,17456
15000US060730185142,749,127,15,24,15,24,0,12,734,127,204,103,530,112,17457
15000US060730185143,740,148,16,27,0,12,16,27,724,148,93,77,631,145,17458
15000US060730185151,296,62,21,35,0,12,21,35,275,59,46,35,229,57,17459
15000US060730185152,1694,94,32,31,10,16,22,26,1662,91,248,77,1414,110,17460
15000US060730185161,868,71,21,32,21,32,0,12,847,82,165,62,682,91,17461
15000US060730185162,402,67,60,37,8,12,52,35,342,65,87,47,255,64,17462
15000US060730185171,559,102,10,16,0,12,10,16,549,102,185,86,364,104,17463
15000US060730185172,1442,121,21,24,12,20,9,13,1421,119,289,76,1132,130,17464
15000US060730185181,390,60,6,9,0,12,6,9,384,61,96,39,288,64,17465
15000US060730185182,510,66,49,41,0,12,49,41,461,67,69,40,392,68,17466
15000US060730185191,470,77,37,38,20,32,17,25,433,71,102,48,331,71,17467
15000US060730185192,658,91,139,68,66,47,73,57,519,109,92,65,427,98,17468
15000US060730185193,382,70,18,20,18,20,0,12,364,71,60,46,304,83,17469
15000US060730186011,419,72,26,38,26,38,0,12,393,76,94,46,299,75,17470
15000US060730186012,1090,91,71,57,27,39,44,44,1019,105,158,65,861,125,17471
15000US060730186031,527,149,92,90,0,12,92,90,435,151,173,107,262,126,17472
15000US060730186032,652,145,228,110,32,32,196,120,424,110,163,66,261,104,17473
15000US060730186033,579,191,20,33,0,12,20,33,559,191,79,59,480,192,17474
15000US060730186034,247,133,69,73,16,27,53,67,178,120,90,101,88,56,17475
15000US060730186081,775,93,37,36,31,34,6,11,738,97,191,72,547,103,17476
15000US060730186082,329,66,0,12,0,12,0,12,329,66,43,37,286,77,17477
15000US060730186091,644,106,62,44,59,43,3,7,582,111,188,86,394,111,17478
15000US060730186092,480,124,9,17,9,17,0,12,471,122,111,62,360,116,17479
15000US060730186093,630,107,121,64,51,36,70,57,509,114,27,28,482,113,17480
15000US060730186101,728,91,16,20,16,20,0,12,712,95,136,60,576,95,17481
15000US060730186102,214,54,6,9,0,12,6,9,208,53,55,35,153,53,17482
15000US060730186103,383,87,50,42,50,42,0,12,333,91,48,32,285,92,17483
15000US060730186104,726,97,134,67,28,33,106,59,592,107,121,64,471,103,17484
15000US060730186111,401,100,0,12,0,12,0,12,401,100,76,60,325,103,17485
15000US060730186112,1471,169,0,17,0,17,0,17,1471,169,419,123,1052,198,17486
15000US060730186113,754,153,86,73,33,38,53,62,668,159,171,103,497,160,17487
15000US060730186121,822,92,18,22,0,12,18,22,804,89,141,56,663,99,17488
15000US060730186122,428,82,70,47,14,20,56,46,358,83,70,51,288,83,17489
15000US060730186131,1094,76,29,29,8,13,21,26,1065,80,195,67,870,102,17490
15000US060730186132,218,65,0,12,0,12,0,12,218,65,40,40,178,56,17491
15000US060730186141,589,117,50,42,12,19,38,36,539,120,195,89,344,110,17492
15000US060730186142,509,106,13,20,0,12,13,20,496,106,139,64,357,124,17493
15000US060730186143,1316,146,107,77,24,29,83,70,1209,156,370,153,839,175,17494
15000US060730187001,6948,393,328,293,0,25,328,293,6620,478,563,282,6057,527,17495
15000US060730188011,632,85,23,36,23,36,0,12,609,88,206,83,403,90,17496
15000US060730188012,714,80,16,20,11,18,5,9,698,78,78,38,620,87,17497
15000US060730188021,616,142,18,29,18,29,0,12,598,143,56,53,542,136,17498
15000US060730188022,717,127,39,54,7,16,32,52,678,122,155,75,523,136,17499
15000US060730188023,467,97,0,12,0,12,0,12,467,97,84,66,383,94,17500
15000US060730188024,732,140,26,29,0,12,26,29,706,139,230,98,476,118,17501
15000US060730188025,886,137,0,12,0,12,0,12,886,137,215,94,671,142,17502
15000US060730188031,261,79,21,33,0,12,21,33,240,81,51,41,189,85,17503
15000US060730188032,346,80,0,12,0,12,0,12,346,80,46,27,300,84,17504
15000US060730188033,1234,109,52,42,12,15,40,40,1182,117,341,97,841,126,17505
15000US060730189031,478,72,9,15,0,12,9,15,469,74,119,60,350,73,17506
15000US060730189032,305,74,7,10,7,10,0,12,298,75,118,51,180,71,17507
15000US060730189033,601,101,121,91,48,52,73,68,480,101,122,62,358,99,17508
15000US060730189034,334,76,29,25,12,17,17,19,305,78,77,55,228,79,17509
15000US060730189041,350,89,69,65,0,12,69,65,281,91,56,34,225,85,17510
15000US060730189042,282,83,71,59,16,19,55,56,211,70,87,54,124,60,17511
15000US060730189043,441,93,0,12,0,12,0,12,441,93,93,53,348,101,17512
15000US060730189044,873,111,14,21,14,21,0,12,859,112,344,93,515,108,17513
15000US060730189051,922,120,158,96,19,23,139,93,764,141,125,77,639,141,17514
15000US060730189052,266,98,66,66,8,13,58,63,200,86,62,42,138,79,17515
15000US060730189053,910,84,38,39,16,19,22,33,872,74,225,74,647,91,17516
15000US060730189061,723,113,95,57,23,36,72,58,628,113,36,30,592,114,17517
15000US060730189062,432,104,9,15,9,15,0,12,423,103,82,48,341,103,17518
15000US060730189063,786,97,46,36,24,25,22,24,740,99,182,67,558,112,17519
15000US060730190011,335,106,13,21,13,21,0,12,322,104,42,38,280,103,17520
15000US060730190012,829,106,87,54,62,52,25,32,742,114,196,69,546,135,17521
15000US060730190013,1235,167,0,12,0,12,0,12,1235,167,331,134,904,167,17522
15000US060730190021,498,45,41,23,2,4,39,22,457,43,100,28,357,49,17523
15000US060730191011,360,91,30,14,13,11,17,11,330,90,50,20,280,93,17524
15000US060730191012,176,82,15,24,0,12,15,24,161,83,10,15,151,82,17525
15000US060730191013,1244,143,24,27,2,4,22,26,1220,150,276,109,944,145,17526
15000US060730191014,374,70,55,42,35,37,20,13,319,66,84,41,235,58,17527
15000US060730191031,381,85,52,60,52,60,0,12,329,77,83,63,246,82,17528
15000US060730191032,1008,128,20,31,20,31,0,12,988,128,208,92,780,137,17529
15000US060730191033,605,133,45,70,0,12,45,70,560,126,161,94,399,133,17530
15000US060730191051,309,99,11,17,11,17,0,12,298,98,53,43,245,97,17531
15000US060730191052,1210,153,0,12,0,12,0,12,1210,153,199,94,1011,170,17532
15000US060730191053,708,144,0,12,0,12,0,12,708,144,223,94,485,141,17533
15000US060730191061,1032,137,58,45,37,39,21,14,974,154,179,62,795,160,17534
15000US060730191062,487,140,44,66,0,12,44,66,443,124,80,52,363,127,17535
15000US060730191063,804,123,20,11,20,11,0,12,784,122,228,120,556,122,17536
15000US060730191064,538,142,40,38,29,32,11,19,498,150,31,34,467,154,17537
15000US060730191071,682,54,48,29,21,17,27,22,634,60,163,47,471,57,17538
15000US060730192031,231,42,19,19,0,12,19,19,212,42,83,32,129,40,17539
15000US060730192032,729,54,13,14,0,12,13,14,716,53,138,53,578,72,17540
15000US060730192051,286,96,50,54,14,14,36,51,236,88,53,44,183,80,17541
15000US060730192052,943,156,107,84,14,15,93,82,836,154,155,79,681,148,17542
15000US060730192053,470,109,66,54,40,51,26,23,404,107,118,70,286,97,17543
15000US060730192054,326,77,49,36,8,12,41,34,277,79,92,54,185,66,17544
15000US060730192061,518,92,123,80,88,71,35,32,395,109,26,22,369,106,17545
15000US060730192062,541,104,19,21,0,12,19,21,522,103,110,63,412,105,17546
15000US060730192063,345,80,4,6,4,6,0,12,341,80,70,52,271,86,17547
15000US060730192071,1220,139,65,52,0,12,65,52,1155,141,318,105,837,164,17548
15000US060730192072,690,164,26,31,15,24,11,19,664,170,86,57,578,168,17549
15000US060730192073,621,136,172,115,14,23,158,116,449,140,32,36,417,138,17550
15000US060730192074,398,103,39,45,39,45,0,12,359,96,70,50,289,94,17551
15000US060730192081,409,84,0,12,0,12,0,12,409,84,95,52,314,74,17552
15000US060730192082,745,76,0,12,0,12,0,12,745,76,162,60,583,94,17553
15000US060730193011,382,94,7,13,0,12,7,13,375,95,45,49,330,99,17554
15000US060730193012,841,121,0,12,0,12,0,12,841,121,174,87,667,139,17555
15000US060730193013,1086,129,144,94,60,63,84,72,942,140,180,86,762,155,17556
15000US060730193021,352,97,0,12,0,12,0,12,352,97,111,79,241,87,17557
15000US060730193022,832,123,10,15,0,12,10,15,822,125,201,92,621,131,17558
15000US060730193023,1043,174,82,74,42,52,40,50,961,165,168,94,793,178,17559
15000US060730193024,825,125,25,29,0,12,25,29,800,129,282,88,518,141,17560
15000US060730193031,671,129,9,15,9,15,0,12,662,129,109,69,553,144,17561
15000US060730193032,675,134,17,26,17,26,0,12,658,133,105,84,553,144,17562
15000US060730193033,773,145,53,44,36,45,17,26,720,142,157,94,563,137,17563
15000US060730194031,971,119,15,20,15,20,0,12,956,121,154,58,802,125,17564
15000US060730194032,421,89,40,32,6,11,34,29,381,95,114,74,267,84,17565
15000US060730194033,145,51,0,12,0,12,0,12,145,51,11,18,134,49,17566
15000US060730194041,335,53,10,11,10,11,0,12,325,54,61,27,264,59,17567
15000US060730194042,470,57,30,23,14,15,16,15,440,60,77,39,363,62,17568
15000US060730194051,295,68,36,31,9,12,27,34,259,68,23,21,236,65,17569
15000US060730194052,359,68,62,51,0,12,62,51,297,77,44,28,253,78,17570
15000US060730194053,595,84,23,23,17,20,6,9,572,87,39,31,533,86,17571
15000US060730194061,349,82,8,13,2,7,6,11,341,82,70,42,271,83,17572
15000US060730194062,773,120,96,66,50,48,46,41,677,123,120,72,557,109,17573
15000US060730194063,413,75,31,27,8,14,23,22,382,73,105,58,277,75,17574
15000US060730195011,457,47,49,28,33,24,16,16,408,49,27,18,381,50,17575
15000US060730195012,446,50,29,23,0,12,29,23,417,50,80,31,337,53,17576
15000US060730195021,572,91,27,18,0,12,27,18,545,94,57,47,488,96,17577
15000US060730195022,429,79,147,66,11,17,136,64,282,87,0,12,282,87,17578
15000US060730195023,355,82,65,48,57,46,8,13,290,85,27,24,263,87,17579
15000US060730195031,553,103,65,61,12,21,53,54,488,96,18,19,470,95,17580
15000US060730195032,354,87,43,38,28,36,15,16,311,81,140,68,171,77,17581
15000US060730195033,668,105,35,31,24,23,11,20,633,108,90,47,543,101,17582
15000US060730196011,629,115,43,69,0,12,43,69,586,114,84,52,502,122,17583
15000US060730196012,481,122,0,12,0,12,0,12,481,122,155,104,326,126,17584
15000US060730196013,765,140,83,57,16,25,67,58,682,144,79,56,603,154,17585
15000US060730196014,320,78,20,32,0,12,20,32,300,80,55,38,245,78,17586
15000US060730196021,444,96,9,16,9,16,0,12,435,96,126,55,309,88,17587
15000US060730196022,768,103,20,25,20,25,0,12,748,101,148,49,600,110,17588
15000US060730196023,502,116,34,31,25,28,9,15,468,119,118,71,350,119,17589
15000US060730197011,1053,162,39,44,0,12,39,44,1014,157,312,120,702,147,17590
15000US060730197012,700,144,48,63,11,18,37,61,652,151,51,44,601,148,17591
15000US060730197013,557,125,9,18,0,12,9,18,548,129,86,53,462,136,17592
15000US060730197021,255,54,16,19,0,12,16,19,239,53,51,31,188,58,17593
15000US060730197022,366,81,6,9,6,9,0,12,360,80,81,59,279,78,17594
15000US060730197023,454,83,27,22,14,16,13,17,427,86,63,48,364,85,17595
15000US060730197024,620,98,8,13,0,12,8,13,612,98,87,34,525,92,17596
15000US060730198031,806,92,37,27,27,30,10,16,769,90,107,51,662,93,17597
15000US060730198032,627,77,0,12,0,12,0,12,627,77,58,46,569,82,17598
15000US060730198033,343,80,0,12,0,12,0,12,343,80,21,26,322,82,17599
15000US060730198041,619,79,0,12,0,12,0,12,619,79,187,62,432,93,17600
15000US060730198042,427,60,6,9,6,9,0,12,421,61,113,42,308,72,17601
15000US060730198043,664,85,0,12,0,12,0,12,664,85,82,40,582,90,17602
15000US060730198051,1068,136,102,52,71,38,31,31,966,140,309,113,657,128,17603
15000US060730198052,389,94,0,12,0,12,0,12,389,94,106,38,283,92,17604
15000US060730198053,239,59,0,12,0,12,0,12,239,59,37,27,202,61,17605
15000US060730198061,1187,243,0,12,0,12,0,12,1187,243,194,110,993,231,17606
15000US060730198062,496,117,0,12,0,12,0,12,496,117,281,135,215,112,17607
15000US060730198063,1537,254,174,182,105,161,69,86,1363,261,37,43,1326,271,17608
15000US060730198064,1201,196,0,12,0,12,0,12,1201,196,244,168,957,164,17609
15000US060730198081,456,160,0,12,0,12,0,12,456,160,134,66,322,153,17610
15000US060730198082,857,153,0,12,0,12,0,12,857,153,183,114,674,135,17611
15000US060730198083,985,104,0,12,0,12,0,12,985,104,481,119,504,118,17612
15000US060730198091,500,60,0,12,0,12,0,12,500,60,43,30,457,63,17613
15000US060730198092,544,76,0,12,0,12,0,12,544,76,123,59,421,76,17614
15000US060730198093,545,75,8,14,0,12,8,14,537,74,216,70,321,76,17615
15000US060730199021,961,84,59,47,13,20,46,40,902,93,140,51,762,99,17616
15000US060730199022,330,80,19,20,10,14,9,14,311,81,26,25,285,81,17617
15000US060730199031,718,101,0,12,0,12,0,12,718,101,199,64,519,111,17618
15000US060730199032,828,116,51,50,11,17,40,48,777,131,147,64,630,142,17619
15000US060730199041,978,168,82,54,14,26,68,52,896,172,237,87,659,167,17620
15000US060730199042,584,167,19,31,19,31,0,12,565,165,66,61,499,163,17621
15000US060730199043,1214,203,33,38,18,28,15,25,1181,207,148,57,1033,206,17622
15000US060730199051,585,75,0,12,0,12,0,12,585,75,117,48,468,83,17623
15000US060730199052,981,103,31,38,0,12,31,38,950,105,106,57,844,125,17624
15000US060730199053,171,40,0,12,0,12,0,12,171,40,43,32,128,45,17625
15000US060730200131,2572,273,0,17,0,17,0,17,2572,273,261,130,2311,288,17626
15000US060730200132,1394,240,35,55,35,55,0,12,1359,247,243,164,1116,241,17627
15000US060730200133,836,176,0,12,0,12,0,12,836,176,196,113,640,170,17628
15000US060730200141,678,126,0,12,0,12,0,12,678,126,136,100,542,123,17629
15000US060730200142,1138,135,0,12,0,12,0,12,1138,135,65,54,1073,134,17630
15000US060730200143,682,119,25,30,14,22,11,20,657,122,40,39,617,125,17631
15000US060730200144,674,118,0,12,0,12,0,12,674,118,39,37,635,126,17632
15000US060730200151,901,104,0,12,0,12,0,12,901,104,125,63,776,105,17633
15000US060730200152,1036,87,7,11,0,12,7,11,1029,89,138,60,891,117,17634
15000US060730200161,732,92,0,12,0,12,0,12,732,92,91,55,641,108,17635
15000US060730200162,595,116,0,12,0,12,0,12,595,116,102,64,493,113,17636
15000US060730200163,1062,122,0,12,0,12,0,12,1062,122,212,86,850,139,17637
15000US060730200164,495,101,0,12,0,12,0,12,495,101,89,53,406,111,17638
15000US060730200165,402,83,0,12,0,12,0,12,402,83,93,83,309,107,17639
15000US060730200171,626,80,28,26,19,21,9,15,598,81,137,54,461,90,17640
15000US060730200172,335,76,43,46,27,42,16,16,292,83,22,33,270,85,17641
15000US060730200173,233,66,27,43,0,12,27,43,206,70,11,13,195,71,17642
15000US060730200181,332,140,20,33,0,12,20,33,312,145,44,33,268,139,17643
15000US060730200182,480,119,13,20,13,20,0,12,467,118,115,81,352,131,17644
15000US060730200183,462,169,12,20,0,12,12,20,450,169,36,37,414,179,17645
15000US060730200184,851,161,53,38,32,30,21,24,798,164,205,96,593,154,17646
15000US060730200191,1142,149,16,26,0,12,16,26,1126,151,409,122,717,152,17647
15000US060730200192,891,166,67,81,23,34,44,71,824,185,446,165,378,148,17648
15000US060730200193,994,143,0,12,0,12,0,12,994,143,138,79,856,143,17649
15000US060730200201,1468,124,55,83,0,12,55,83,1413,136,193,84,1220,143,17650
15000US060730200202,742,100,0,12,0,12,0,12,742,100,185,104,557,124,17651
15000US060730200211,850,104,64,51,25,25,39,44,786,109,129,65,657,118,17652
15000US060730200212,495,99,61,50,39,42,22,23,434,96,73,57,361,100,17653
15000US060730200213,327,83,38,45,0,12,38,45,289,79,53,48,236,76,17654
15000US060730200221,883,135,35,37,0,12,35,37,848,144,169,76,679,147,17655
15000US060730200222,590,143,0,12,0,12,0,12,590,143,49,43,541,142,17656
15000US060730200223,918,165,0,12,0,12,0,12,918,165,35,39,883,168,17657
15000US060730200231,736,85,39,42,0,12,39,42,697,90,159,70,538,101,17658
15000US060730200232,541,88,27,26,11,18,16,18,514,95,190,66,324,92,17659
15000US060730200241,784,95,56,57,14,16,42,54,728,89,265,72,463,109,17660
15000US060730200242,352,84,10,16,10,16,0,12,342,84,64,45,278,82,17661
15000US060730200243,345,76,7,11,0,12,7,11,338,77,41,42,297,71,17662
15000US060730200251,589,110,42,33,15,23,27,24,547,110,70,47,477,107,17663
15000US060730200252,475,86,17,20,6,10,11,19,458,88,81,48,377,94,17664
15000US060730200253,762,126,51,46,24,33,27,33,711,129,184,79,527,117,17665
15000US060730200261,468,101,8,14,0,12,8,14,460,101,83,45,377,112,17666
15000US060730200262,614,88,18,20,18,20,0,12,596,87,71,35,525,91,17667
15000US060730200263,608,82,7,11,0,12,7,11,601,83,191,66,410,90,17668
15000US060730200271,3854,262,100,159,100,159,0,19,3754,270,355,155,3399,317,17669
15000US060730200272,295,123,0,12,0,12,0,12,295,123,60,72,235,142,17670
15000US060730200273,1336,209,26,44,0,12,26,44,1310,205,534,183,776,214,17671
15000US060730200281,420,97,101,58,8,12,93,56,319,96,19,17,300,97,17672
15000US060730200282,570,93,113,75,92,68,21,34,457,99,66,41,391,92,17673
15000US060730200291,1100,113,104,75,65,57,39,49,996,114,436,118,560,95,17674
15000US060730200292,343,90,16,13,0,12,16,13,327,91,62,40,265,92,17675
15000US060730200293,613,118,103,62,20,33,83,48,510,122,88,50,422,114,17676
15000US060730201031,1266,176,109,86,0,12,109,86,1157,169,234,122,923,171,17677
15000US060730201032,744,126,10,16,10,16,0,12,734,124,152,77,582,127,17678
15000US060730201033,1009,153,15,25,15,25,0,12,994,154,300,137,694,152,17679
15000US060730201034,362,86,0,12,0,12,0,12,362,86,44,43,318,93,17680
15000US060730201051,405,75,6,10,0,12,6,10,399,75,85,45,314,66,17681
15000US060730201052,996,109,103,71,24,39,79,60,893,115,261,86,632,107,17682
15000US060730201061,694,84,89,69,20,22,69,65,605,86,152,78,453,91,17683
15000US060730201062,427,83,38,44,38,44,0,12,389,89,60,51,329,90,17684
15000US060730201071,672,81,21,24,21,24,0,12,651,88,172,71,479,97,17685
15000US060730201072,510,80,34,39,0,12,34,39,476,80,189,75,287,78,17686
15000US060730201081,450,82,65,47,29,32,36,35,385,87,23,29,362,86,17687
15000US060730201082,462,85,75,52,75,52,0,12,387,77,148,49,239,74,17688
15000US060730201083,391,88,69,46,15,17,54,44,322,86,77,44,245,86,17689
15000US060730201084,323,78,60,53,0,12,60,53,263,83,31,23,232,85,17690
15000US060730201091,270,69,26,31,0,12,26,31,244,65,40,38,204,65,17691
15000US060730201092,379,87,39,25,19,17,20,19,340,89,117,59,223,94,17692
15000US060730201093,263,70,0,12,0,12,0,12,263,70,57,33,206,72,17693
15000US060730201094,365,80,11,10,0,12,11,10,354,82,117,53,237,80,17694
15000US060730202021,601,96,170,85,43,46,127,75,431,104,48,31,383,107,17695
15000US060730202022,700,119,138,72,77,56,61,49,562,113,154,63,408,101,17696
15000US060730202023,409,105,105,62,22,24,83,65,304,104,50,41,254,101,17697
15000US060730202061,305,56,35,34,26,30,9,15,270,57,56,33,214,57,17698
15000US060730202062,359,77,31,25,18,20,13,16,328,80,86,46,242,82,17699
15000US060730202063,584,99,129,65,29,36,100,57,455,100,18,19,437,102,17700
15000US060730202071,680,121,80,54,0,12,80,54,600,115,90,60,510,118,17701
15000US060730202072,690,121,140,64,67,50,73,51,550,130,117,58,433,128,17702
15000US060730202081,668,20,40,34,19,31,21,18,628,40,209,59,419,63,17703
15000US060730202091,752,87,47,47,24,24,23,38,705,94,227,71,478,100,17704
15000US060730202092,784,105,172,92,93,78,79,66,612,99,175,82,437,113,17705
15000US060730202093,214,63,26,30,26,30,0,12,188,62,56,48,132,57,17706
15000US060730202101,716,97,107,77,58,60,49,57,609,108,102,60,507,108,17707
15000US060730202102,901,87,88,60,41,44,47,42,813,92,218,67,595,98,17708
15000US060730202111,319,99,60,66,7,16,53,62,259,84,35,46,224,86,17709
15000US060730202112,476,127,0,12,0,12,0,12,476,127,259,109,217,86,17710
15000US060730202113,620,131,80,78,14,23,66,74,540,129,151,96,389,122,17711
15000US060730202114,638,149,21,27,0,12,21,27,617,147,178,97,439,143,17712
15000US060730202131,373,55,112,47,36,29,76,39,261,61,61,28,200,55,17713
15000US060730202132,384,58,70,43,8,13,62,40,314,55,127,48,187,52,17714
15000US060730202133,269,61,68,40,3,6,65,39,201,56,39,30,162,51,17715
15000US060730202141,574,95,30,32,8,12,22,30,544,91,211,69,333,84,17716
15000US060730202142,715,114,136,69,50,48,86,53,579,115,171,84,408,115,17717
15000US060730202143,325,83,79,58,20,32,59,48,246,80,21,22,225,80,17718
15000US060730203041,808,125,0,12,0,12,0,12,808,125,251,92,557,143,17719
15000US060730203042,279,87,12,21,0,12,12,21,267,87,12,19,255,86,17720
15000US060730203043,640,116,16,25,16,25,0,12,624,114,125,80,499,125,17721
15000US060730203044,629,132,0,12,0,12,0,12,629,132,207,107,422,119,17722
15000US060730203051,1118,124,2,13,0,12,2,13,1116,124,233,104,883,139,17723
15000US060730203052,429,108,83,66,52,51,31,43,346,107,108,71,238,99,17724
15000US060730203053,503,122,35,44,0,12,35,44,468,123,149,112,319,101,17725
15000US060730203061,2754,223,125,95,93,87,32,37,2629,226,576,159,2053,257,17726
15000US060730203062,676,114,0,12,0,12,0,12,676,114,48,44,628,119,17727
15000US060730203071,924,125,0,12,0,12,0,12,924,125,220,130,704,120,17728
15000US060730203072,346,104,69,75,69,75,0,12,277,86,93,55,184,67,17729
15000US060730203073,759,108,26,30,12,20,14,22,733,110,305,138,428,147,17730
15000US060730203074,585,106,9,14,0,12,9,14,576,109,144,81,432,109,17731
15000US060730203081,555,133,79,84,66,80,13,23,476,118,221,101,255,101,17732
15000US060730203082,452,127,47,48,13,23,34,40,405,125,74,67,331,119,17733
15000US060730203083,1478,166,205,113,50,62,155,95,1273,167,407,113,866,175,17734
15000US060730203091,635,106,30,30,15,23,15,18,605,103,131,71,474,96,17735
15000US060730203092,491,77,0,12,0,12,0,12,491,77,96,48,395,79,17736
15000US060730204011,367,47,7,9,0,12,7,9,360,47,57,29,303,45,17737
15000US060730204012,518,61,14,14,0,12,14,14,504,64,77,31,427,64,17738
15000US060730204031,589,76,35,29,7,12,28,27,554,79,140,54,414,79,17739
15000US060730204032,615,82,28,34,0,12,28,34,587,86,85,42,502,90,17740
15000US060730204041,575,91,10,15,0,12,10,15,565,91,92,64,473,101,17741
15000US060730204042,602,87,33,38,10,14,23,35,569,83,66,40,503,86,17742
15000US060730204043,650,77,10,17,0,12,10,17,640,77,92,46,548,81,17743
15000US060730204051,480,65,0,12,0,12,0,12,480,65,85,44,395,71,17744
15000US060730204052,717,78,0,12,0,12,0,12,717,78,167,55,550,83,17745
15000US060730205001,293,67,0,12,0,12,0,12,293,67,103,44,190,63,17746
15000US060730205002,470,94,81,51,39,36,42,37,389,91,58,46,331,92,17747
15000US060730205003,647,77,101,64,0,12,101,64,546,91,204,91,342,89,17748
15000US060730206011,546,116,37,35,22,26,15,24,509,121,155,73,354,113,17749
15000US060730206012,435,97,90,78,40,50,50,58,345,94,44,35,301,98,17750
15000US060730206013,557,100,109,67,51,36,58,56,448,95,127,74,321,91,17751
15000US060730206021,368,79,63,63,7,12,56,62,305,82,49,54,256,83,17752
15000US060730206022,590,99,98,61,68,47,30,37,492,95,140,62,352,107,17753
15000US060730206023,472,104,59,69,8,14,51,68,413,88,139,62,274,88,17754
15000US060730206024,524,94,39,36,0,12,39,36,485,96,93,35,392,100,17755
15000US060730207051,375,75,42,51,14,23,28,44,333,64,60,31,273,75,17756
15000US060730207052,321,85,0,12,0,12,0,12,321,85,34,27,287,85,17757
15000US060730207053,714,93,22,27,0,12,22,27,692,92,146,61,546,108,17758
15000US060730207061,891,108,0,12,0,12,0,12,891,108,329,130,562,122,17759
15000US060730207062,482,89,0,12,0,12,0,12,482,89,111,68,371,106,17760
15000US060730207063,645,95,0,12,0,12,0,12,645,95,155,79,490,96,17761
15000US060730207071,847,107,171,90,85,72,86,62,676,113,187,94,489,112,17762
15000US060730207072,651,101,58,44,17,20,41,45,593,107,102,65,491,108,17763
15000US060730207081,630,103,17,23,9,18,8,14,613,103,55,36,558,96,17764
15000US060730207082,532,96,32,30,14,22,18,21,500,106,150,70,350,95,17765
15000US060730207091,956,120,21,25,16,24,5,9,935,122,191,80,744,111,17766
15000US060730207092,492,115,23,25,6,15,17,25,469,110,67,45,402,120,17767
15000US060730207093,579,124,37,39,19,26,18,28,542,129,145,89,397,131,17768
15000US060730207094,406,99,17,23,17,23,0,12,389,105,54,38,335,107,17769
15000US060730207101,667,30,0,12,0,12,0,12,667,30,129,36,538,41,17770
15000US060730208011,393,89,0,12,0,12,0,12,393,89,90,54,303,82,17771
15000US060730208012,698,108,0,12,0,12,0,12,698,108,166,68,532,109,17772
15000US060730208013,713,104,91,58,34,33,57,58,622,100,190,83,432,98,17773
15000US060730208051,475,96,87,71,45,51,42,53,388,91,75,38,313,95,17774
15000US060730208052,663,102,77,56,25,28,52,53,586,107,133,71,453,116,17775
15000US060730208061,549,98,73,39,37,28,36,30,476,96,57,35,419,99,17776
15000US060730208062,706,111,148,69,69,56,79,59,558,117,182,88,376,91,17777
15000US060730208063,735,95,24,26,11,17,13,20,711,95,206,86,505,90,17778
15000US060730208071,891,61,12,13,7,11,5,7,879,61,208,52,671,72,17779
15000US060730208091,592,133,45,39,45,39,0,12,547,128,128,86,419,139,17780
15000US060730208092,1004,161,75,72,19,30,56,67,929,174,194,109,735,184,17781
15000US060730208093,524,140,56,66,18,22,38,62,468,120,115,68,353,126,17782
15000US060730208101,333,68,35,35,8,13,27,32,298,76,26,23,272,77,17783
15000US060730208102,239,66,0,12,0,12,0,12,239,66,97,54,142,60,17784
15000US060730208103,1171,92,0,12,0,12,0,12,1171,92,166,69,1005,102,17785
15000US060730208111,508,92,0,12,0,12,0,12,508,92,111,71,397,79,17786
15000US060730208112,727,104,0,12,0,12,0,12,727,104,181,57,546,111,17787
15000US060730208113,724,91,30,37,0,12,30,37,694,91,158,59,536,96,17788
15000US060730209021,97,50,9,14,0,12,9,14,88,46,17,21,71,42,17789
15000US060730209022,661,89,56,41,26,25,30,34,605,93,229,70,376,85,17790
15000US060730209031,125,43,22,20,10,15,12,13,103,43,12,13,91,42,17791
15000US060730209032,112,34,14,9,10,7,4,5,98,36,13,14,85,33,17792
15000US060730209033,1005,104,164,67,55,41,109,52,841,99,322,71,519,85,17793
15000US060730209041,451,111,28,28,0,12,28,28,423,110,162,74,261,86,17794
15000US060730209042,248,98,8,13,0,12,8,13,240,98,32,38,208,95,17795
15000US060730209043,233,104,33,43,8,13,25,41,200,88,14,22,186,86,17796
15000US060730210001,412,95,93,77,76,71,17,27,319,123,131,86,188,84,17797
15000US060730210002,246,120,45,74,0,12,45,74,201,99,46,43,155,87,17798
15000US060730210003,493,185,43,68,43,68,0,12,450,182,246,153,204,115,17799
15000US060730210004,389,126,44,70,0,12,44,70,345,117,107,108,238,122,17800
15000US060730211001,412,129,19,30,19,30,0,12,393,129,225,127,168,87,17801
15000US060730211002,614,206,51,36,28,29,23,21,563,201,270,173,293,148,17802
15000US060730211003,1227,199,70,56,68,56,2,4,1157,203,412,144,745,168,17803
15000US060730211004,183,135,0,12,0,12,0,12,183,135,0,12,183,135,17804
15000US060730212021,666,89,28,25,9,14,19,18,638,89,188,61,450,88,17805
15000US060730212022,423,88,0,12,0,12,0,12,423,88,80,55,343,90,17806
15000US060730212041,790,104,0,12,0,12,0,12,790,104,218,79,572,102,17807
15000US060730212042,873,109,0,12,0,12,0,12,873,109,263,101,610,113,17808
15000US060730212043,217,71,17,18,9,14,8,13,200,71,51,35,149,65,17809
15000US060730212051,1052,150,31,51,31,51,0,12,1021,152,420,159,601,147,17810
15000US060730212052,650,160,18,28,0,12,18,28,632,163,62,59,570,168,17811
15000US060730212053,1050,183,165,123,102,105,63,74,885,178,187,80,698,180,17812
15000US060730212061,1123,56,15,19,9,15,6,11,1108,58,259,78,849,89,17813
15000US060730213021,480,101,22,21,0,17,22,21,458,100,134,66,324,87,17814
15000US060730213022,869,102,61,52,31,38,30,35,808,104,189,77,619,113,17815
15000US060730213031,643,110,0,12,0,12,0,12,643,110,151,95,492,123,17816
15000US060730213032,1721,186,0,17,0,17,0,17,1721,186,409,163,1312,192,17817
15000US060730213033,281,107,17,28,17,28,0,12,264,107,44,62,220,102,17818
15000US060730213041,444,55,12,12,0,12,12,12,432,57,109,38,323,50,17819
15000US060730213042,352,60,4,7,0,12,4,7,348,60,62,29,286,63,17820
15000US060730214001,1422,165,17,27,0,12,17,27,1405,163,79,49,1326,172,17821
15000US060730214002,637,116,26,46,0,12,26,46,611,109,127,67,484,114,17822
15000US060730214003,613,130,41,66,0,12,41,66,572,121,71,71,501,108,17823
15000US060730215001,1532,150,20,32,0,12,20,32,1512,157,115,85,1397,164,17824
15000US060730215002,965,137,0,12,0,12,0,12,965,137,105,71,860,150,17825
15000US060730215003,233,68,0,12,0,12,0,12,233,68,0,12,233,68,17826
15000US060730216001,519,68,0,12,0,12,0,12,519,68,69,42,450,71,17827
15000US060730216002,645,96,0,12,0,12,0,12,645,96,197,70,448,85,17828
15000US060730218001,581,79,0,12,0,12,0,12,581,79,93,36,488,81,17829
15000US060730218002,462,65,0,12,0,12,0,12,462,65,97,36,365,62,17830
15000US060730219001,397,60,58,31,5,9,53,30,339,65,99,57,240,69,17831
15000US060730219002,217,55,21,22,3,6,18,21,196,58,54,26,142,59,17832
15000US060730220001,476,94,103,58,33,33,70,47,373,90,103,51,270,83,17833
15000US060730220002,686,105,137,90,23,29,114,85,549,93,180,63,369,80,17834
15000US060730221001,918,152,0,12,0,12,0,12,918,152,66,53,852,149,17835
15000US060730221002,1172,181,130,87,99,94,31,40,1042,169,178,106,864,160,17836
15000US060730221003,1260,170,0,12,0,12,0,12,1260,170,145,69,1115,172,17837
15000US060739901000,0,12,0,12,0,12,0,12,0,12,0,12,0,12,17838
15000US060750101001,522,106,41,40,29,37,12,20,481,108,48,43,433,109,17839
15000US060750101002,1537,152,75,63,15,24,60,57,1462,155,480,128,982,188,17840
15000US060750102001,782,178,9,15,0,12,9,15,773,179,77,76,696,167,17841
15000US060750102002,1113,158,13,20,13,20,0,12,1100,158,57,52,1043,160,17842
15000US060750102003,652,137,0,12,0,12,0,12,652,137,76,60,576,134,17843
15000US060750103001,942,143,13,20,13,20,0,12,929,149,80,54,849,152,17844
15000US060750103002,486,95,44,37,0,12,44,37,442,95,133,73,309,99,17845
15000US060750103003,606,145,0,12,0,12,0,12,606,145,162,83,444,142,17846
15000US060750104001,240,70,0,12,0,12,0,12,240,70,20,31,220,70,17847
15000US060750104002,806,152,0,12,0,12,0,12,806,152,57,53,749,148,17848
15000US060750104003,908,167,0,12,0,12,0,12,908,167,136,70,772,172,17849
15000US060750104004,547,145,43,37,22,37,21,35,504,141,17,27,487,140,17850
15000US060750105001,451,93,83,84,40,62,43,53,368,89,37,28,331,85,17851
15000US060750105002,1163,129,9,15,9,15,0,12,1154,129,171,63,983,132,17852
15000US060750106001,641,115,0,12,0,12,0,12,641,115,174,83,467,106,17853
15000US060750106002,629,130,126,90,19,21,107,87,503,129,69,47,434,124,17854
15000US060750106003,542,97,6,10,0,12,6,10,536,97,201,79,335,90,17855
15000US060750107001,353,95,0,12,0,12,0,12,353,95,11,18,342,95,17856
15000US060750107002,591,113,24,28,13,20,11,20,567,111,268,99,299,91,17857
15000US060750107003,830,145,136,89,17,27,119,82,694,134,99,73,595,133,17858
15000US060750107004,722,118,118,73,17,27,101,70,604,115,219,94,385,123,17859
15000US060750108001,607,144,20,30,20,30,0,12,587,147,140,66,447,135,17860
15000US060750108002,753,128,91,60,32,37,59,45,662,135,182,108,480,121,17861
15000US060750108003,1065,155,135,90,53,87,82,63,930,150,78,55,852,158,17862
15000US060750109001,583,113,0,12,0,12,0,12,583,113,104,66,479,112,17863
15000US060750109002,1108,158,40,45,0,12,40,45,1068,157,143,79,925,154,17864
15000US060750109003,1026,164,0,12,0,12,0,12,1026,164,102,58,924,170,17865
15000US060750110001,415,148,0,12,0,12,0,12,415,148,40,44,375,143,17866
15000US060750110002,1007,164,0,12,0,12,0,12,1007,164,95,87,912,159,17867
15000US060750110003,1202,177,177,96,0,12,177,96,1025,174,147,113,878,181,17868
15000US060750111001,1162,168,0,12,0,12,0,12,1162,168,206,94,956,148,17869
15000US060750111002,1166,155,0,12,0,12,0,12,1166,155,163,96,1003,162,17870
15000US060750111003,745,178,35,57,35,57,0,12,710,181,315,157,395,106,17871
15000US060750112001,855,103,8,13,0,12,8,13,847,104,229,74,618,97,17872
15000US060750112002,746,94,0,12,0,12,0,12,746,94,98,55,648,87,17873
15000US060750112003,315,74,11,18,0,12,11,18,304,76,56,52,248,73,17874
15000US060750113001,656,104,76,54,21,25,55,50,580,91,206,69,374,79,17875
15000US060750113002,878,115,94,60,29,30,65,51,784,121,395,112,389,78,17876
15000US060750117001,450,83,29,29,0,12,29,29,421,82,67,35,354,83,17877
15000US060750117002,611,112,145,57,65,50,80,44,466,112,106,76,360,82,17878
15000US060750118001,708,53,85,41,38,30,47,30,623,58,173,51,450,60,17879
15000US060750119011,674,100,44,47,0,12,44,47,630,101,122,74,508,94,17880
15000US060750119012,814,109,0,12,0,12,0,12,814,109,73,51,741,114,17881
15000US060750119021,1451,122,52,40,11,18,41,36,1399,129,144,64,1255,135,17882
15000US060750119022,384,106,34,35,12,18,22,31,350,109,83,53,267,100,17883
15000US060750120001,1270,200,48,64,21,42,27,45,1222,181,262,117,960,204,17884
15000US060750120002,1324,204,47,46,0,12,47,46,1277,208,199,129,1078,216,17885
15000US060750121001,1507,170,42,39,0,12,42,39,1465,174,184,87,1281,196,17886
15000US060750121002,626,119,14,22,14,22,0,12,612,121,68,65,544,115,17887
15000US060750122011,1708,237,245,154,204,146,41,46,1463,245,282,122,1181,209,17888
15000US060750122012,1229,236,96,102,72,96,24,40,1133,217,316,146,817,190,17889
15000US060750122021,1563,109,89,42,29,24,60,38,1474,108,353,119,1121,151,17890
15000US060750123011,789,130,40,47,24,38,16,25,749,130,399,104,350,118,17891
15000US060750123012,551,110,115,75,26,22,89,71,436,112,119,61,317,96,17892
15000US060750123021,1011,115,79,39,17,19,62,34,932,116,74,43,858,108,17893
15000US060750123022,895,120,43,37,35,35,8,13,852,122,124,59,728,119,17894
15000US060750124011,1125,189,97,90,36,42,61,79,1028,195,391,146,637,179,17895
15000US060750124012,1539,232,453,189,206,129,247,163,1086,204,320,138,766,192,17896
15000US060750124021,568,144,0,12,0,12,0,12,568,144,248,142,320,115,17897
15000US060750124022,596,105,0,12,0,12,0,12,596,105,80,55,516,111,17898
15000US060750124023,1162,164,144,63,16,25,128,55,1018,185,348,145,670,156,17899
15000US060750125011,1345,182,288,158,164,121,124,106,1057,201,451,163,606,148,17900
15000US060750125012,834,191,115,79,95,70,20,37,719,178,404,142,315,135,17901
15000US060750125021,1146,153,274,133,178,114,96,86,872,186,477,151,395,152,17902
15000US060750125022,1055,161,313,123,70,59,243,125,742,167,423,138,319,117,17903
15000US060750126011,1518,106,22,26,0,12,22,26,1496,102,120,51,1376,110,17904
15000US060750126021,908,109,10,16,0,12,10,16,898,111,4,6,894,112,17905
15000US060750126022,764,101,0,12,0,12,0,12,764,101,94,73,670,114,17906
15000US060750127001,907,144,0,12,0,12,0,12,907,144,50,50,857,145,17907
15000US060750127002,833,145,0,12,0,12,0,12,833,145,58,52,775,149,17908
15000US060750127003,447,111,10,18,10,18,0,12,437,109,70,54,367,121,17909
15000US060750128001,994,134,17,26,17,26,0,12,977,134,102,67,875,136,17910
15000US060750128002,336,73,0,12,0,12,0,12,336,73,38,40,298,74,17911
15000US060750128003,635,124,0,12,0,12,0,12,635,124,105,63,530,133,17912
15000US060750128004,406,110,0,12,0,12,0,12,406,110,59,42,347,109,17913
15000US060750129011,663,99,0,12,0,12,0,12,663,99,58,37,605,110,17914
15000US060750129012,849,73,0,12,0,12,0,12,849,73,49,34,800,78,17915
15000US060750129021,839,141,0,12,0,12,0,12,839,141,22,24,817,138,17916
15000US060750129022,671,127,0,12,0,12,0,12,671,127,92,55,579,127,17917
15000US060750129023,547,107,0,12,0,12,0,12,547,107,52,68,495,87,17918
15000US060750130001,722,149,0,12,0,12,0,12,722,149,32,36,690,152,17919
15000US060750130002,437,83,0,12,0,12,0,12,437,83,92,48,345,79,17920
15000US060750130003,729,157,14,24,14,24,0,12,715,165,35,39,680,165,17921
15000US060750130004,674,135,34,38,0,12,34,38,640,137,78,60,562,149,17922
15000US060750131011,1131,138,0,12,0,12,0,12,1131,138,63,52,1068,145,17923
15000US060750131012,1424,145,19,31,0,12,19,31,1405,147,111,67,1294,136,17924
15000US060750131021,847,93,0,12,0,12,0,12,847,93,106,60,741,106,17925
15000US060750131022,794,81,24,27,0,12,24,27,770,81,47,34,723,82,17926
15000US060750132001,1251,149,31,38,14,22,17,30,1220,153,108,66,1112,157,17927
15000US060750132002,288,91,0,12,0,12,0,12,288,91,28,35,260,91,17928
15000US060750132003,690,121,0,12,0,12,0,12,690,121,120,62,570,122,17929
15000US060750133001,254,53,0,12,0,12,0,12,254,53,0,12,254,53,17930
15000US060750133002,492,77,0,12,0,12,0,12,492,77,103,49,389,78,17931
15000US060750133003,589,95,0,12,0,12,0,12,589,95,162,51,427,93,17932
15000US060750133004,255,53,0,12,0,12,0,12,255,53,16,19,239,51,17933
15000US060750133005,302,64,0,12,0,12,0,12,302,64,16,18,286,67,17934
15000US060750134001,523,128,0,12,0,12,0,12,523,128,75,64,448,140,17935
15000US060750134002,948,134,0,12,0,12,0,12,948,134,101,88,847,138,17936
15000US060750134003,561,109,0,12,0,12,0,12,561,109,0,12,561,109,17937
15000US060750135001,794,102,0,12,0,12,0,12,794,102,33,30,761,104,17938
15000US060750135002,810,106,36,46,25,42,11,18,774,96,156,74,618,102,17939
15000US060750151001,959,111,49,46,17,26,32,37,910,111,207,78,703,104,17940
15000US060750151002,529,103,0,12,0,12,0,12,529,103,51,37,478,104,17941
15000US060750152001,1243,186,55,85,55,85,0,12,1188,189,260,123,928,200,17942
15000US060750152002,626,140,0,12,0,12,0,12,626,140,103,75,523,135,17943
15000US060750152003,562,142,0,12,0,12,0,12,562,142,99,77,463,139,17944
15000US060750153001,430,54,7,11,7,11,0,12,423,56,70,34,353,55,17945
15000US060750153002,520,66,4,7,0,12,4,7,516,67,51,31,465,67,17946
15000US060750154001,491,126,16,25,0,12,16,25,475,126,76,83,399,129,17947
15000US060750154002,590,126,0,12,0,12,0,12,590,126,65,43,525,124,17948
15000US060750154003,860,126,0,12,0,12,0,12,860,126,188,112,672,141,17949
15000US060750154004,434,89,0,12,0,12,0,12,434,89,22,34,412,89,17950
15000US060750154005,566,103,14,23,0,12,14,23,552,103,79,60,473,96,17951
15000US060750155001,1226,182,67,88,67,88,0,12,1159,177,441,129,718,209,17952
15000US060750155002,767,182,44,71,44,71,0,12,723,184,301,124,422,144,17953
15000US060750155003,287,99,55,89,0,12,55,89,232,95,84,50,148,84,17954
15000US060750156001,294,77,0,12,0,12,0,12,294,77,10,16,284,76,17955
15000US060750156002,597,83,7,11,0,12,7,11,590,83,43,30,547,87,17956
15000US060750156003,571,86,35,27,30,26,5,10,536,96,147,77,389,93,17957
15000US060750157001,640,117,0,12,0,12,0,12,640,117,70,58,570,117,17958
15000US060750157002,830,124,0,12,0,12,0,12,830,124,34,34,796,120,17959
15000US060750157003,770,137,15,23,15,23,0,12,755,135,163,109,592,148,17960
15000US060750157004,437,123,36,54,0,12,36,54,401,119,17,28,384,120,17961
15000US060750158011,194,64,15,15,4,7,11,16,179,62,58,44,121,51,17962
15000US060750158012,1039,106,92,85,46,52,46,63,947,106,203,76,744,103,17963
15000US060750158013,494,88,61,47,54,45,7,12,433,84,80,52,353,75,17964
15000US060750158021,824,108,26,39,26,39,0,12,798,104,41,21,757,104,17965
15000US060750158022,740,116,41,43,41,43,0,12,699,110,116,65,583,112,17966
15000US060750159001,926,153,54,50,38,43,16,24,872,158,313,120,559,149,17967
15000US060750159002,1190,163,0,12,0,12,0,12,1190,163,206,71,984,170,17968
15000US060750160001,1737,116,86,69,78,68,8,13,1651,131,439,104,1212,154,17969
15000US060750161001,453,110,38,42,0,12,38,42,415,105,169,93,246,125,17970
15000US060750161002,678,149,29,28,19,23,10,19,649,147,253,112,396,127,17971
15000US060750161003,480,154,166,124,40,41,126,114,314,104,214,98,100,75,17972
15000US060750161004,991,178,118,94,76,71,42,67,873,200,322,139,551,141,17973
15000US060750162001,548,97,8,11,8,11,0,12,540,96,46,39,494,89,17974
15000US060750162002,662,91,6,10,0,12,6,10,656,91,102,51,554,109,17975
15000US060750162003,574,101,43,44,8,14,35,41,531,98,85,58,446,88,17976
15000US060750163001,359,96,57,43,29,25,28,33,302,105,84,61,218,96,17977
15000US060750163002,534,109,54,54,12,20,42,57,480,98,33,37,447,97,17978
15000US060750163003,1144,137,76,75,17,27,59,71,1068,117,97,65,971,114,17979
15000US060750164001,1048,117,48,59,13,19,35,56,1000,112,92,62,908,111,17980
15000US060750164002,826,124,19,23,10,16,9,15,807,129,60,55,747,134,17981
15000US060750165001,800,196,0,12,0,12,0,12,800,196,228,121,572,180,17982
15000US060750165002,515,109,33,44,0,12,33,44,482,110,54,49,428,105,17983
15000US060750165003,545,145,19,31,0,12,19,31,526,142,0,12,526,142,17984
15000US060750165004,523,130,20,32,20,32,0,12,503,129,43,49,460,137,17985
15000US060750166001,947,165,72,75,27,31,45,69,875,159,103,88,772,170,17986
15000US060750166002,443,110,66,85,66,85,0,12,377,96,104,67,273,83,17987
15000US060750166003,699,160,0,12,0,12,0,12,699,160,64,50,635,166,17988
15000US060750166004,405,110,0,12,0,12,0,12,405,110,0,12,405,110,17989
15000US060750167001,920,129,14,22,0,12,14,22,906,132,78,67,828,130,17990
15000US060750167002,306,84,0,12,0,12,0,12,306,84,38,60,268,85,17991
15000US060750167003,521,106,0,12,0,12,0,12,521,106,103,89,418,98,17992
15000US060750167004,675,117,23,36,23,36,0,12,652,118,35,40,617,126,17993
15000US060750168011,528,83,0,12,0,12,0,12,528,83,38,28,490,89,17994
15000US060750168012,619,97,0,12,0,12,0,12,619,97,168,74,451,87,17995
15000US060750168013,455,81,31,29,0,12,31,29,424,83,96,68,328,78,17996
15000US060750168021,640,97,28,30,28,30,0,12,612,98,96,48,516,97,17997
15000US060750168022,598,100,30,31,0,12,30,31,568,100,146,61,422,100,17998
15000US060750168023,556,92,8,13,0,12,8,13,548,94,86,48,462,91,17999
15000US060750169001,973,96,42,31,30,24,12,19,931,93,187,68,744,105,18000
15000US060750169002,559,77,0,12,0,12,0,12,559,77,55,35,504,79,18001
15000US060750170001,513,103,0,12,0,12,0,12,513,103,25,30,488,100,18002
15000US060750170002,1283,137,0,12,0,12,0,12,1283,137,253,111,1030,123,18003
15000US060750170003,369,78,15,24,0,12,15,24,354,80,13,22,341,84,18004
15000US060750171011,628,77,0,12,0,12,0,12,628,77,26,25,602,85,18005
15000US060750171012,608,88,0,12,0,12,0,12,608,88,57,38,551,89,18006
15000US060750171013,540,89,0,12,0,12,0,12,540,89,99,81,441,81,18007
15000US060750171021,586,78,8,13,0,12,8,13,578,79,67,45,511,89,18008
15000US060750171022,254,59,0,12,0,12,0,12,254,59,26,23,228,58,18009
15000US060750171023,831,87,7,12,0,12,7,12,824,87,120,72,704,92,18010
15000US060750176011,0,12,0,12,0,12,0,12,0,12,0,12,0,12,18011
15000US060750176012,1520,230,362,178,139,114,223,154,1158,240,588,220,570,173,18012
15000US060750176013,1391,272,58,93,0,12,58,93,1333,261,319,152,1014,239,18013
15000US060750176014,763,164,156,105,132,98,24,38,607,164,212,119,395,138,18014
15000US060750176015,756,154,75,85,51,77,24,37,681,159,195,101,486,166,18015
15000US060750177001,81,34,0,12,0,12,0,12,81,34,0,12,81,34,18016
15000US060750177002,677,50,42,28,25,25,17,14,635,53,115,44,520,65,18017
15000US060750178011,861,165,29,33,16,26,13,19,832,169,597,139,235,108,18018
15000US060750178012,1381,164,12,19,12,19,0,12,1369,168,425,131,944,143,18019
15000US060750178021,1361,160,82,56,18,30,64,50,1279,174,299,134,980,164,18020
15000US060750178022,925,135,135,91,116,89,19,22,790,147,214,101,576,131,18021
15000US060750179021,602,72,157,50,51,27,106,53,445,66,104,42,341,73,18022
15000US060750180001,948,121,13,21,13,21,0,12,935,120,69,50,866,125,18023
15000US060750180002,366,85,0,12,0,12,0,12,366,85,48,34,318,88,18024
15000US060750201001,654,142,0,12,0,12,0,12,654,142,149,94,505,144,18025
15000US060750201002,805,164,93,83,0,12,93,83,712,156,175,103,537,144,18026
15000US060750201003,512,170,154,109,129,109,25,29,358,143,144,81,214,130,18027
15000US060750201004,1144,235,229,156,176,147,53,51,915,218,456,172,459,149,18028
15000US060750202001,666,145,0,12,0,12,0,12,666,145,76,54,590,154,18029
15000US060750202002,1160,171,84,67,33,47,51,51,1076,176,355,166,721,130,18030
15000US060750202003,1363,204,155,125,130,125,25,39,1208,214,286,192,922,193,18031
15000US060750203001,694,80,9,15,0,12,9,15,685,80,115,55,570,87,18032
15000US060750203002,401,88,0,12,0,12,0,12,401,88,57,54,344,81,18033
15000US060750203003,643,78,10,16,0,12,10,16,633,79,49,35,584,77,18034
15000US060750204011,560,93,12,18,0,12,12,18,548,93,85,52,463,89,18035
15000US060750204012,397,76,9,13,0,12,9,13,388,76,60,55,328,70,18036
15000US060750204013,638,93,0,12,0,12,0,12,638,93,50,32,588,98,18037
15000US060750204021,1330,163,20,32,0,12,20,32,1310,165,225,114,1085,166,18038
15000US060750204022,1171,175,0,12,0,12,0,12,1171,175,205,134,966,184,18039
15000US060750205001,501,59,0,12,0,12,0,12,501,59,78,45,423,72,18040
15000US060750205002,418,70,0,12,0,12,0,12,418,70,88,48,330,81,18041
15000US060750205003,482,62,0,12,0,12,0,12,482,62,42,30,440,67,18042
15000US060750206001,1005,132,18,29,18,29,0,12,987,139,346,141,641,113,18043
15000US060750206002,465,88,15,23,15,23,0,12,450,92,74,82,376,88,18044
15000US060750206003,503,99,0,12,0,12,0,12,503,99,110,71,393,110,18045
15000US060750206004,756,124,0,12,0,12,0,12,756,124,101,54,655,119,18046
15000US060750207001,1150,150,0,12,0,12,0,12,1150,150,69,61,1081,155,18047
15000US060750207002,995,136,11,19,0,12,11,19,984,138,65,59,919,138,18048
15000US060750207003,511,123,0,12,0,12,0,12,511,123,107,104,404,126,18049
15000US060750208001,498,116,0,12,0,12,0,12,498,116,110,72,388,105,18050
15000US060750208002,724,142,0,12,0,12,0,12,724,142,117,90,607,151,18051
15000US060750208003,742,165,47,55,0,12,47,55,695,176,117,87,578,166,18052
15000US060750208004,882,192,59,49,44,43,15,24,823,209,198,102,625,198,18053
15000US060750209001,686,86,32,29,14,18,18,21,654,92,207,82,447,87,18054
15000US060750209002,390,84,12,18,12,18,0,12,378,84,89,47,289,73,18055
15000US060750209003,363,66,39,48,29,45,10,17,324,67,6,12,318,69,18056
15000US060750209004,455,79,9,14,0,12,9,14,446,77,40,31,406,71,18057
15000US060750210001,459,169,0,12,0,12,0,12,459,169,48,48,411,165,18058
15000US060750210002,499,102,0,12,0,12,0,12,499,102,96,77,403,105,18059
15000US060750210003,674,152,9,14,0,12,9,14,665,152,123,76,542,135,18060
15000US060750210004,533,121,58,85,58,85,0,12,475,110,33,41,442,109,18061
15000US060750211001,535,74,0,12,0,12,0,12,535,74,58,44,477,82,18062
15000US060750211002,443,72,0,12,0,12,0,12,443,72,18,28,425,75,18063
15000US060750211003,500,77,0,12,0,12,0,12,500,77,109,59,391,79,18064
15000US060750211004,441,86,0,12,0,12,0,12,441,86,120,67,321,85,18065
15000US060750212001,456,64,0,12,0,12,0,12,456,64,20,22,436,60,18066
15000US060750212002,554,83,0,12,0,12,0,12,554,83,52,35,502,83,18067
15000US060750212003,411,78,11,16,0,12,11,16,400,77,30,48,370,77,18068
15000US060750213001,448,56,0,12,0,12,0,12,448,56,48,33,400,68,18069
15000US060750213002,779,76,0,12,0,12,0,12,779,76,72,47,707,82,18070
15000US060750214001,390,62,0,12,0,12,0,12,390,62,45,30,345,66,18071
15000US060750214002,690,61,0,12,0,12,0,12,690,61,85,54,605,71,18072
15000US060750214003,586,88,0,12,0,12,0,12,586,88,90,52,496,80,18073
15000US060750215001,439,94,41,47,19,30,22,34,398,84,18,28,380,86,18074
15000US060750215002,692,133,0,12,0,12,0,12,692,133,74,91,618,121,18075
15000US060750215003,446,95,17,25,0,12,17,25,429,98,44,43,385,96,18076
15000US060750215004,504,89,0,12,0,12,0,12,504,89,19,29,485,93,18077
15000US060750215005,499,100,0,12,0,12,0,12,499,100,55,50,444,99,18078
15000US060750216001,964,109,0,12,0,12,0,12,964,109,47,39,917,111,18079
15000US060750216002,1207,120,89,88,23,38,66,82,1118,132,268,86,850,143,18080
15000US060750217001,537,85,0,12,0,12,0,12,537,85,71,37,466,87,18081
15000US060750217002,483,102,0,12,0,12,0,12,483,102,67,41,416,100,18082
15000US060750217003,819,108,110,67,20,33,90,67,709,106,133,74,576,105,18083
15000US060750218001,587,75,0,12,0,12,0,12,587,75,20,23,567,78,18084
15000US060750218002,492,56,9,15,0,12,9,15,483,56,26,25,457,55,18085
15000US060750218003,357,52,0,12,0,12,0,12,357,52,45,30,312,57,18086
15000US060750218004,431,58,11,19,0,12,11,19,420,58,67,35,353,63,18087
15000US060750226001,343,44,0,12,0,12,0,12,343,44,13,15,330,45,18088
15000US060750226002,606,53,21,24,11,19,10,10,585,58,41,27,544,59,18089
15000US060750227021,485,55,6,8,0,12,6,8,479,56,31,22,448,61,18090
15000US060750227022,518,54,0,12,0,12,0,12,518,54,33,21,485,54,18091
15000US060750227041,591,69,8,13,0,12,8,13,583,72,120,44,463,70,18092
15000US060750227042,1045,88,9,15,0,12,9,15,1036,88,149,58,887,103,18093
15000US060750228011,525,86,9,15,0,12,9,15,516,84,64,49,452,85,18094
15000US060750228012,804,116,38,38,0,12,38,38,766,120,50,30,716,120,18095
15000US060750228013,618,105,69,50,39,48,30,29,549,103,64,54,485,101,18096
15000US060750228021,267,54,34,17,31,16,3,5,233,56,74,47,159,47,18097
15000US060750228022,405,63,64,42,17,17,47,38,341,69,46,25,295,70,18098
15000US060750228031,657,85,75,53,65,55,10,15,582,92,79,42,503,94,18099
15000US060750228032,548,77,7,13,0,12,7,13,541,75,47,32,494,80,18100
15000US060750228033,365,73,62,44,11,17,51,40,303,73,59,41,244,75,18101
15000US060750229011,505,88,49,33,18,16,31,27,456,88,104,60,352,95,18102
15000US060750229012,579,100,38,34,25,28,13,21,541,98,112,50,429,106,18103
15000US060750229013,456,83,103,70,64,62,39,63,353,87,66,54,287,77,18104
15000US060750229021,442,65,0,12,0,12,0,12,442,65,63,27,379,68,18105
15000US060750229022,390,70,33,32,6,8,27,31,357,81,64,27,293,80,18106
15000US060750229031,529,97,63,47,32,38,31,34,466,100,70,41,396,100,18107
15000US060750229032,288,70,19,29,19,29,0,12,269,68,38,26,231,69,18108
15000US060750229033,340,71,17,19,0,12,17,19,323,72,130,58,193,54,18109
15000US060750230011,508,80,85,52,37,39,48,39,423,82,102,50,321,76,18110
15000US060750230012,392,87,24,25,15,21,9,14,368,92,47,33,321,96,18111
15000US060750230013,433,74,43,33,0,12,43,33,390,72,139,64,251,69,18112
15000US060750230031,899,105,158,84,6,9,152,84,741,113,190,73,551,132,18113
15000US060750230032,291,104,8,13,0,12,8,13,283,105,32,24,251,107,18114
15000US060750231021,1088,99,222,99,34,29,188,95,866,101,190,66,676,107,18115
15000US060750231022,479,86,143,73,37,32,106,69,336,98,95,42,241,91,18116
15000US060750231031,174,73,50,43,20,26,30,35,124,68,52,40,72,59,18117
15000US060750231032,871,96,361,121,166,84,195,89,510,124,148,86,362,104,18118
15000US060750232001,368,100,36,29,9,14,27,25,332,96,78,44,254,99,18119
15000US060750232002,439,83,46,38,40,38,6,10,393,92,148,57,245,82,18120
15000US060750232003,446,105,69,61,22,35,47,52,377,100,74,53,303,94,18121
15000US060750233001,949,63,134,53,60,47,74,38,815,64,151,43,664,67,18122
15000US060750234001,384,65,36,26,27,26,9,13,348,73,96,47,252,67,18123
15000US060750234002,477,106,164,76,26,23,138,77,313,72,54,31,259,69,18124
15000US060750251001,666,56,43,57,0,12,43,57,623,77,67,40,556,84,18125
15000US060750251002,373,48,7,10,0,12,7,10,366,50,33,27,333,51,18126
15000US060750251003,361,59,7,12,0,12,7,12,354,62,67,39,287,61,18127
15000US060750252001,546,112,14,25,14,25,0,12,532,110,61,61,471,119,18128
15000US060750252002,674,141,18,29,0,12,18,29,656,143,157,92,499,139,18129
15000US060750252003,424,107,15,25,0,12,15,25,409,111,65,48,344,101,18130
15000US060750252004,473,96,20,31,20,31,0,12,453,93,24,32,429,94,18131
15000US060750253001,451,89,0,12,0,12,0,12,451,89,25,27,426,89,18132
15000US060750253002,302,70,0,12,0,12,0,12,302,70,13,20,289,71,18133
15000US060750253003,269,80,34,34,0,12,34,34,235,74,6,10,229,73,18134
15000US060750253004,712,100,8,12,0,12,8,12,704,101,85,45,619,112,18135
15000US060750254011,535,86,46,46,36,44,10,15,489,87,120,59,369,97,18136
15000US060750254012,398,66,0,12,0,12,0,12,398,66,36,43,362,71,18137
15000US060750254013,374,78,9,14,0,12,9,14,365,77,44,46,321,75,18138
15000US060750254021,391,72,4,10,0,12,4,10,387,74,103,48,284,70,18139
15000US060750254022,313,67,34,39,18,22,16,30,279,75,40,34,239,74,18140
15000US060750254023,413,67,0,12,0,12,0,12,413,67,44,33,369,61,18141
15000US060750254031,627,97,158,77,20,21,138,72,469,95,98,54,371,100,18142
15000US060750254032,820,101,168,90,78,37,90,82,652,96,216,61,436,91,18143
15000US060750255001,447,119,0,12,0,12,0,12,447,119,74,62,373,119,18144
15000US060750255002,386,105,37,43,18,28,19,30,349,113,43,36,306,110,18145
15000US060750255003,366,115,41,45,12,19,29,43,325,113,49,52,276,107,18146
15000US060750255004,282,107,19,29,0,12,19,29,263,108,43,38,220,112,18147
15000US060750255005,405,106,6,12,6,12,0,12,399,107,0,12,399,107,18148
15000US060750255006,855,146,11,22,0,12,11,22,844,146,136,75,708,159,18149
15000US060750256001,538,98,39,32,0,12,39,32,499,99,138,56,361,106,18150
15000US060750256002,328,84,0,12,0,12,0,12,328,84,70,41,258,86,18151
15000US060750256003,325,68,6,9,0,12,6,9,319,69,46,36,273,62,18152
15000US060750256004,407,76,11,17,0,12,11,17,396,75,112,44,284,78,18153
15000US060750257011,433,94,11,17,11,17,0,12,422,95,56,36,366,97,18154
15000US060750257012,683,103,24,25,20,25,4,9,659,109,225,105,434,78,18155
15000US060750257013,359,79,9,16,9,16,0,12,350,81,88,56,262,60,18156
15000US060750257021,393,89,101,70,45,55,56,45,292,67,67,43,225,68,18157
15000US060750257022,464,86,38,38,0,12,38,38,426,86,106,63,320,92,18158
15000US060750257023,360,95,35,29,15,24,20,23,325,94,51,35,274,83,18159
15000US060750258001,327,51,25,22,0,12,25,22,302,52,55,26,247,48,18160
15000US060750258002,292,46,17,19,4,7,13,18,275,49,55,26,220,54,18161
15000US060750259001,619,101,12,19,12,19,0,12,607,100,101,50,506,84,18162
15000US060750259002,685,96,13,21,0,12,13,21,672,98,186,81,486,104,18163
15000US060750259003,200,62,27,33,18,30,9,14,173,61,21,22,152,62,18164
15000US060750260011,706,99,110,52,43,30,67,44,596,104,193,68,403,96,18165
15000US060750260012,860,93,182,96,45,29,137,88,678,121,116,59,562,126,18166
15000US060750260021,378,47,22,12,7,8,15,12,356,48,88,39,268,54,18167
15000US060750260022,606,63,7,8,7,8,0,12,599,62,144,46,455,70,18168
15000US060750260031,737,96,37,43,27,40,10,14,700,100,201,72,499,101,18169
15000US060750260032,658,88,30,37,22,34,8,13,628,87,148,55,480,87,18170
15000US060750260041,749,95,87,68,0,12,87,68,662,109,141,63,521,117,18171
15000US060750260042,527,86,20,22,0,12,20,22,507,90,104,44,403,95,18172
15000US060750261001,487,105,48,50,14,22,34,45,439,102,114,65,325,93,18173
15000US060750261002,684,105,46,36,24,27,22,23,638,103,241,81,397,97,18174
15000US060750261003,454,96,0,12,0,12,0,12,454,96,82,44,372,108,18175
15000US060750261004,368,99,0,12,0,12,0,12,368,99,141,64,227,86,18176
15000US060750262001,464,79,15,16,15,16,0,12,449,84,73,45,376,84,18177
15000US060750262002,430,114,78,76,0,12,78,76,352,93,54,35,298,100,18178
15000US060750262003,311,85,28,24,19,23,9,16,283,88,74,50,209,85,18179
15000US060750262004,474,113,44,58,44,58,0,12,430,126,96,79,334,129,18180
15000US060750262005,324,100,24,38,0,12,24,38,300,99,78,41,222,98,18181
15000US060750263011,347,79,34,41,0,12,34,41,313,72,78,43,235,82,18182
15000US060750263012,721,74,45,44,37,43,8,13,676,77,175,62,501,94,18183
15000US060750263013,338,66,0,12,0,12,0,12,338,66,101,44,237,75,18184
15000US060750263021,314,69,8,12,0,12,8,12,306,69,82,36,224,70,18185
15000US060750263022,414,66,40,49,10,14,30,46,374,64,97,35,277,67,18186
15000US060750263023,805,96,17,20,10,18,7,11,788,96,234,96,554,112,18187
15000US060750263031,543,100,46,40,6,12,40,39,497,99,85,46,412,101,18188
15000US060750263032,673,81,116,53,61,44,55,45,557,94,144,63,413,102,18189
15000US060750264011,502,85,42,36,11,17,31,33,460,79,162,80,298,75,18190
15000US060750264012,559,81,27,33,0,12,27,33,532,87,143,61,389,89,18191
15000US060750264021,334,69,17,20,0,12,17,20,317,69,94,50,223,71,18192
15000US060750264022,442,62,47,42,18,27,29,33,395,64,115,51,280,69,18193
15000US060750264023,418,81,0,12,0,12,0,12,418,81,121,67,297,90,18194
15000US060750264031,441,82,46,37,11,18,35,34,395,92,114,61,281,92,18195
15000US060750264032,610,76,110,64,27,29,83,57,500,80,108,56,392,97,18196
15000US060750264041,386,61,24,17,5,7,19,16,362,63,75,31,287,62,18197
15000US060750264042,314,48,58,34,12,13,46,31,256,47,65,31,191,47,18198
15000US060750301011,723,134,0,12,0,12,0,12,723,134,44,32,679,135,18199
15000US060750301012,640,109,41,46,21,34,20,31,599,111,69,53,530,121,18200
15000US060750301013,433,88,17,28,0,12,17,28,416,90,73,47,343,82,18201
15000US060750301014,318,101,0,12,0,12,0,12,318,101,48,48,270,94,18202
15000US060750301021,1192,154,16,28,0,12,16,28,1176,155,168,94,1008,149,18203
15000US060750301022,676,125,0,12,0,12,0,12,676,125,92,76,584,118,18204
15000US060750301023,374,79,0,12,0,12,0,12,374,79,15,23,359,78,18205
15000US060750302011,895,86,0,12,0,12,0,12,895,86,130,54,765,93,18206
15000US060750302012,522,85,12,17,0,12,12,17,510,87,62,38,448,87,18207
15000US060750302013,490,74,0,12,0,12,0,12,490,74,69,49,421,68,18208
15000US060750302021,668,114,0,12,0,12,0,12,668,114,29,35,639,109,18209
15000US060750302022,805,108,0,12,0,12,0,12,805,108,69,46,736,112,18210
15000US060750302023,676,101,0,12,0,12,0,12,676,101,30,32,646,113,18211
15000US060750303011,438,83,0,12,0,12,0,12,438,83,129,73,309,81,18212
15000US060750303012,742,108,0,12,0,12,0,12,742,108,114,76,628,106,18213
15000US060750303013,629,118,25,38,25,38,0,12,604,119,52,35,552,129,18214
15000US060750303014,552,94,0,12,0,12,0,12,552,94,101,76,451,94,18215
15000US060750303021,466,61,0,12,0,12,0,12,466,61,84,45,382,66,18216
15000US060750303022,493,58,0,12,0,12,0,12,493,58,78,39,415,68,18217
15000US060750303023,505,60,0,12,0,12,0,12,505,60,86,51,419,70,18218
15000US060750304001,400,73,10,16,10,16,0,12,390,72,63,39,327,73,18219
15000US060750304002,421,72,0,12,0,12,0,12,421,72,35,32,386,79,18220
15000US060750304003,471,63,0,12,0,12,0,12,471,63,75,52,396,64,18221
15000US060750304004,308,60,0,12,0,12,0,12,308,60,43,31,265,64,18222
15000US060750304005,367,73,16,18,7,12,9,14,351,74,54,44,297,76,18223
15000US060750305001,375,56,0,12,0,12,0,12,375,56,91,60,284,66,18224
15000US060750305002,334,53,0,12,0,12,0,12,334,53,75,42,259,57,18225
15000US060750305003,331,59,50,40,50,40,0,12,281,50,166,53,115,40,18226
15000US060750306001,300,39,7,9,7,9,0,12,293,42,73,38,220,39,18227
15000US060750306002,273,42,0,12,0,12,0,12,273,42,36,22,237,43,18228
15000US060750306003,305,38,0,12,0,12,0,12,305,38,24,21,281,40,18229
15000US060750307001,1037,122,0,12,0,12,0,12,1037,122,244,108,793,139,18230
15000US060750307002,661,138,0,12,0,12,0,12,661,138,140,93,521,124,18231
15000US060750307003,954,139,0,12,0,12,0,12,954,139,216,100,738,157,18232
15000US060750308001,343,69,0,12,0,12,0,12,343,69,67,56,276,67,18233
15000US060750308002,259,68,0,12,0,12,0,12,259,68,82,56,177,63,18234
15000US060750308003,264,48,0,12,0,12,0,12,264,48,38,36,226,59,18235
15000US060750308004,769,99,12,19,12,19,0,12,757,102,100,71,657,110,18236
15000US060750308005,625,131,6,15,0,12,6,15,619,133,90,61,529,151,18237
15000US060750309001,289,89,0,12,0,12,0,12,289,89,17,27,272,88,18238
15000US060750309002,502,100,0,12,0,12,0,12,502,100,142,83,360,106,18239
15000US060750309003,340,96,0,12,0,12,0,12,340,96,44,35,296,96,18240
15000US060750309004,360,90,0,12,0,12,0,12,360,90,121,81,239,103,18241
15000US060750309005,238,64,0,12,0,12,0,12,238,64,21,34,217,70,18242
15000US060750309006,334,105,0,12,0,12,0,12,334,105,109,83,225,124,18243
15000US060750309007,280,99,0,12,0,12,0,12,280,99,86,76,194,89,18244
15000US060750310001,317,68,0,12,0,12,0,12,317,68,42,27,275,76,18245
15000US060750310002,474,80,7,11,7,11,0,12,467,79,129,81,338,77,18246
15000US060750310003,511,79,0,12,0,12,0,12,511,79,117,61,394,76,18247
15000US060750311001,493,92,0,12,0,12,0,12,493,92,86,43,407,93,18248
15000US060750311002,496,93,13,21,13,21,0,12,483,98,62,58,421,96,18249
15000US060750311003,284,75,19,32,0,12,19,32,265,78,25,32,240,77,18250
15000US060750311004,500,77,14,22,14,22,0,12,486,82,181,61,305,68,18251
15000US060750311005,715,116,40,44,26,37,14,22,675,126,99,63,576,121,18252
15000US060750312011,751,100,104,62,20,22,84,65,647,112,169,61,478,112,18253
15000US060750312012,536,113,35,33,25,27,10,17,501,116,51,50,450,116,18254
15000US060750312013,288,66,5,9,0,12,5,9,283,67,92,44,191,70,18255
15000US060750312014,408,76,16,20,10,17,6,11,392,80,101,54,291,70,18256
15000US060750312021,390,52,41,27,10,11,31,24,349,53,93,35,256,54,18257
15000US060750312022,472,59,39,39,0,12,39,39,433,62,105,34,328,65,18258
15000US060750313011,361,56,0,12,0,12,0,12,361,56,59,25,302,62,18259
15000US060750313012,457,59,9,15,0,12,9,15,448,60,152,56,296,69,18260
15000US060750313013,496,81,57,59,11,18,46,56,439,82,91,42,348,92,18261
15000US060750313021,529,95,84,56,67,51,17,20,445,101,104,67,341,91,18262
15000US060750313022,468,77,0,12,0,12,0,12,468,77,194,60,274,79,18263
15000US060750313023,945,101,68,58,49,52,19,30,877,104,166,66,711,105,18264
15000US060750314001,217,54,0,12,0,12,0,12,217,54,30,23,187,58,18265
15000US060750314002,487,94,61,37,7,11,54,34,426,90,102,47,324,92,18266
15000US060750314003,383,91,64,63,0,12,64,63,319,71,136,59,183,75,18267
15000US060750314004,356,74,32,27,0,12,32,27,324,77,83,51,241,78,18268
15000US060750314005,418,85,23,22,16,18,7,11,395,86,90,53,305,82,18269
15000US060750326011,607,105,12,19,12,19,0,12,595,101,106,64,489,83,18270
15000US060750326012,639,93,21,24,10,16,11,18,618,94,100,62,518,97,18271
15000US060750326013,582,108,8,12,0,12,8,12,574,108,140,77,434,103,18272
15000US060750326021,724,87,16,19,0,12,16,19,708,88,199,65,509,94,18273
15000US060750326022,510,61,15,17,0,12,15,17,495,65,53,35,442,73,18274
15000US060750326023,484,77,0,12,0,12,0,12,484,77,191,69,293,68,18275
15000US060750327001,339,81,17,29,17,29,0,12,322,91,46,41,276,96,18276
15000US060750327002,528,115,19,31,0,12,19,31,509,120,55,52,454,126,18277
15000US060750327003,434,130,0,12,0,12,0,12,434,130,88,59,346,140,18278
15000US060750327004,242,62,16,26,16,26,0,12,226,66,71,41,155,59,18279
15000US060750327005,339,72,0,12,0,12,0,12,339,72,148,71,191,71,18280
15000US060750327006,276,67,0,12,0,12,0,12,276,67,33,38,243,67,18281
15000US060750327007,303,77,0,12,0,12,0,12,303,77,59,36,244,83,18282
15000US060750328011,478,75,11,16,0,12,11,16,467,76,73,44,394,85,18283
15000US060750328012,566,97,7,12,0,12,7,12,559,96,145,73,414,93,18284
15000US060750328013,416,83,27,26,0,12,27,26,389,83,142,81,247,84,18285
15000US060750328021,481,81,0,12,0,12,0,12,481,81,70,44,411,83,18286
15000US060750328022,570,83,53,47,29,30,24,37,517,84,92,58,425,88,18287
15000US060750328023,493,69,0,12,0,12,0,12,493,69,66,41,427,79,18288
15000US060750329011,419,81,0,12,0,12,0,12,419,81,114,58,305,70,18289
15000US060750329012,450,68,30,28,22,24,8,13,420,73,75,57,345,65,18290
15000US060750329013,493,87,15,22,15,22,0,12,478,89,151,90,327,76,18291
15000US060750329014,457,72,7,11,0,12,7,11,450,73,139,63,311,94,18292
15000US060750329021,460,84,85,54,19,21,66,48,375,97,65,39,310,93,18293
15000US060750329022,502,85,9,14,0,12,9,14,493,84,186,68,307,74,18294
15000US060750329023,423,62,17,26,0,12,17,26,406,64,86,41,320,62,18295
15000US060750330001,528,82,16,26,16,26,0,12,512,80,79,59,433,81,18296
15000US060750330002,412,95,0,12,0,12,0,12,412,95,106,62,306,106,18297
15000US060750330003,418,108,26,30,13,23,13,21,392,106,57,48,335,114,18298
15000US060750330004,494,130,12,20,0,12,12,20,482,131,77,58,405,125,18299
15000US060750330005,534,118,0,12,0,12,0,12,534,118,174,62,360,126,18300
15000US060750330006,324,94,82,88,0,12,82,88,242,70,129,52,113,59,18301
15000US060750331001,279,78,0,12,0,12,0,12,279,78,65,38,214,75,18302
15000US060750331002,316,64,12,18,0,12,12,18,304,65,61,40,243,62,18303
15000US060750331003,284,54,0,12,0,12,0,12,284,54,50,40,234,56,18304
15000US060750331004,584,91,13,19,0,12,13,19,571,90,114,53,457,92,18305
15000US060750332011,640,73,40,30,16,14,24,23,600,74,66,27,534,71,18306
15000US060750332031,1011,91,22,24,11,18,11,17,989,98,167,62,822,107,18307
15000US060750332032,575,90,0,12,0,12,0,12,575,90,106,42,469,92,18308
15000US060750332041,330,71,0,12,0,12,0,12,330,71,49,49,281,69,18309
15000US060750332042,686,97,19,22,0,12,19,22,667,96,130,63,537,94,18310
15000US060750332043,575,98,22,21,0,12,22,21,553,98,99,47,454,103,18311
15000US060750351001,432,120,0,12,0,12,0,12,432,120,91,74,341,117,18312
15000US060750351002,387,98,0,12,0,12,0,12,387,98,77,70,310,90,18313
15000US060750351003,403,80,0,12,0,12,0,12,403,80,59,54,344,82,18314
15000US060750351004,267,83,0,12,0,12,0,12,267,83,18,28,249,86,18315
15000US060750351005,486,90,0,12,0,12,0,12,486,90,223,102,263,102,18316
15000US060750351006,434,94,0,12,0,12,0,12,434,94,48,45,386,104,18317
15000US060750351007,440,106,0,12,0,12,0,12,440,106,54,60,386,90,18318
15000US060750352011,398,70,10,15,10,15,0,12,388,73,82,42,306,83,18319
15000US060750352012,309,57,8,13,8,13,0,12,301,57,51,28,250,61,18320
15000US060750352013,451,84,20,22,0,12,20,22,431,88,60,50,371,87,18321
15000US060750352014,502,78,21,35,0,12,21,35,481,76,55,37,426,82,18322
15000US060750352015,300,69,0,12,0,12,0,12,300,69,82,51,218,64,18323
15000US060750352021,760,97,58,53,8,12,50,50,702,98,128,68,574,102,18324
15000US060750352022,618,98,26,22,0,12,26,22,592,103,63,38,529,106,18325
15000US060750352023,456,82,0,12,0,12,0,12,456,82,86,43,370,86,18326
15000US060750353001,270,77,0,12,0,12,0,12,270,77,69,58,201,86,18327
15000US060750353002,681,132,43,42,16,25,27,33,638,150,81,84,557,142,18328
15000US060750353003,429,75,17,27,0,12,17,27,412,79,152,90,260,78,18329
15000US060750353004,334,96,18,29,0,12,18,29,316,99,30,34,286,106,18330
15000US060750353005,468,91,22,33,22,33,0,12,446,94,160,78,286,73,18331
15000US060750353006,412,103,0,12,0,12,0,12,412,103,100,65,312,106,18332
15000US060750354001,546,114,0,12,0,12,0,12,546,114,176,117,370,103,18333
15000US060750354002,348,100,17,28,17,28,0,12,331,97,125,86,206,78,18334
15000US060750354003,515,137,11,16,0,12,11,16,504,137,43,57,461,144,18335
15000US060750354004,710,167,0,12,0,12,0,12,710,167,193,167,517,168,18336
15000US060750354005,395,119,7,14,7,14,0,12,388,120,106,80,282,109,18337
15000US060750401001,348,68,0,12,0,12,0,12,348,68,39,28,309,71,18338
15000US060750401002,549,78,9,16,9,16,0,12,540,80,77,53,463,80,18339
15000US060750401003,601,81,31,24,12,17,19,20,570,82,89,51,481,74,18340
15000US060750401004,448,75,0,12,0,12,0,12,448,75,86,53,362,82,18341
15000US060750402001,806,150,0,12,0,12,0,12,806,150,72,55,734,155,18342
15000US060750402002,378,109,0,12,0,12,0,12,378,109,144,104,234,89,18343
15000US060750402003,596,112,62,46,21,29,41,43,534,118,149,75,385,113,18344
15000US060750402004,653,100,19,30,19,30,0,12,634,99,69,54,565,92,18345
15000US060750426011,694,113,77,84,0,12,77,84,617,97,80,38,537,100,18346
15000US060750426012,1094,116,72,56,10,16,62,57,1022,100,154,59,868,100,18347
15000US060750426021,394,60,18,22,9,15,9,14,376,61,56,36,320,65,18348
15000US060750426022,497,79,0,12,0,12,0,12,497,79,99,45,398,80,18349
15000US060750426023,492,72,9,16,0,12,9,16,483,76,76,40,407,81,18350
15000US060750427001,762,147,42,41,0,12,42,41,720,142,162,97,558,114,18351
15000US060750427002,885,130,51,48,0,12,51,48,834,137,203,98,631,130,18352
15000US060750427003,691,121,0,12,0,12,0,12,691,121,284,109,407,107,18353
15000US060750428001,435,54,0,12,0,12,0,12,435,54,62,35,373,52,18354
15000US060750428002,222,42,0,12,0,12,0,12,222,42,39,21,183,40,18355
15000US060750428003,240,35,0,12,0,12,0,12,240,35,37,24,203,39,18356
15000US060750451001,944,158,0,12,0,12,0,12,944,158,138,83,806,156,18357
15000US060750451002,573,116,15,22,0,12,15,22,558,118,76,52,482,128,18358
15000US060750451003,592,126,87,93,0,12,87,93,505,109,78,57,427,117,18359
15000US060750452001,874,159,0,12,0,12,0,12,874,159,208,132,666,146,18360
15000US060750452002,784,160,104,101,16,25,88,99,680,158,83,73,597,148,18361
15000US060750452003,324,81,0,12,0,12,0,12,324,81,53,45,271,79,18362
15000US060750452004,513,113,0,12,0,12,0,12,513,113,71,49,442,122,18363
15000US060750452005,525,131,26,36,0,12,26,36,499,133,105,78,394,120,18364
15000US060750476001,737,128,21,33,0,12,21,33,716,126,69,61,647,129,18365
15000US060750476002,470,77,0,12,0,12,0,12,470,77,15,22,455,78,18366
15000US060750476003,432,90,16,26,0,12,16,26,416,83,82,60,334,84,18367
15000US060750476004,572,113,0,12,0,12,0,12,572,113,96,63,476,114,18368
15000US060750477011,728,98,8,14,0,12,8,14,720,98,139,57,581,97,18369
15000US060750477012,589,83,0,12,0,12,0,12,589,83,127,54,462,91,18370
15000US060750477013,590,83,13,19,13,19,0,12,577,83,76,39,501,85,18371
15000US060750477021,468,65,7,11,7,11,0,12,461,65,61,37,400,70,18372
15000US060750477022,472,73,24,27,7,11,17,24,448,71,82,41,366,73,18373
15000US060750477023,624,85,12,19,0,12,12,19,612,84,126,76,486,95,18374
15000US060750478011,431,70,16,23,16,23,0,12,415,71,112,43,303,68,18375
15000US060750478012,380,84,8,13,0,12,8,13,372,85,54,34,318,84,18376
15000US060750478013,779,106,30,27,19,21,11,19,749,109,200,63,549,113,18377
15000US060750478021,416,89,0,12,0,12,0,12,416,89,91,49,325,90,18378
15000US060750478022,442,78,0,12,0,12,0,12,442,78,48,35,394,78,18379
15000US060750478023,619,105,20,23,11,18,9,14,599,107,165,67,434,103,18380
15000US060750479011,418,128,0,12,0,12,0,12,418,128,64,48,354,129,18381
15000US060750479012,778,164,12,21,12,21,0,12,766,163,154,79,612,156,18382
15000US060750479013,494,116,51,52,22,36,29,37,443,109,146,91,297,106,18383
15000US060750479014,581,155,20,31,0,12,20,31,561,152,116,97,445,150,18384
15000US060750479015,408,142,0,12,0,12,0,12,408,142,17,27,391,146,18385
15000US060750479021,520,64,31,31,31,31,0,12,489,72,113,51,376,84,18386
15000US060750479022,540,89,0,12,0,12,0,12,540,89,121,43,419,88,18387
15000US060750479023,452,80,3,8,3,8,0,12,449,79,83,59,366,77,18388
15000US060750601001,1306,68,22,25,0,12,22,25,1284,73,47,45,1237,87,18389
15000US060750604001,998,86,0,12,0,12,0,12,998,86,347,85,651,88,18390
15000US060750605021,197,48,131,49,28,18,103,50,66,36,16,19,50,30,18391
15000US060750605022,253,54,143,51,70,34,73,41,110,53,57,35,53,38,18392
15000US060750605023,501,68,115,52,44,30,71,45,386,63,97,37,289,61,18393
15000US060750607001,4642,305,171,151,38,62,133,131,4471,325,525,193,3946,336,18394
15000US060750607002,91,57,0,12,0,12,0,12,91,57,0,12,91,57,18395
15000US060750607003,453,136,112,121,112,121,0,12,341,120,32,62,309,100,18396
15000US060750610001,994,91,48,35,6,10,42,33,946,102,132,57,814,103,18397
15000US060750610002,600,87,14,18,0,12,14,18,586,84,92,50,494,91,18398
15000US060750611001,384,84,86,55,22,30,64,46,298,80,114,50,184,68,18399
15000US060750611002,1214,96,165,71,45,38,120,65,1049,117,322,103,727,113,18400
15000US060750611003,506,86,45,31,10,15,35,27,461,88,163,71,298,83,18401
15000US060750612001,441,70,54,39,17,19,37,35,387,72,95,47,292,69,18402
15000US060750612002,743,96,190,78,27,34,163,73,553,93,128,65,425,90,18403
15000US060750614001,1113,159,329,139,163,153,166,110,784,150,107,64,677,152,18404
15000US060750614002,812,162,0,12,0,12,0,12,812,162,123,66,689,147,18405
15000US060750614003,558,126,0,12,0,12,0,12,558,126,39,49,519,132,18406
15000US060750615001,1210,358,0,12,0,12,0,12,1210,358,56,92,1154,353,18407
15000US060750615002,929,263,0,12,0,12,0,12,929,263,16,28,913,256,18408
15000US060750615003,1293,413,0,12,0,12,0,12,1293,413,0,12,1293,413,18409
15000US060750615004,1208,358,43,71,0,12,43,71,1165,358,58,102,1107,347,18410
15000US060750615005,589,269,97,114,97,114,0,12,492,261,165,131,327,245,18411
15000US060750615006,2123,480,0,12,0,12,0,12,2123,480,295,229,1828,498,18412
15000US060759802001,72,19,0,12,0,12,0,12,72,19,10,10,62,21,18413
15000US060759803001,76,32,0,12,0,12,0,12,76,32,4,6,72,34,18414
15000US060759804011,0,12,0,12,0,12,0,12,0,12,0,12,0,12,18415
15000US060759805011,285,60,114,48,44,35,70,42,171,48,97,41,74,34,18416
15000US060759806001,188,48,14,12,9,9,5,7,174,49,38,27,136,51,18417
15000US060759809001,142,48,0,12,0,12,0,12,142,48,13,21,129,44,18418
15000US060759901000,0,12,0,12,0,12,0,12,0,12,0,12,0,12,18419
15000US060770001001,810,120,351,104,162,79,189,85,459,87,270,84,189,88,18420
15000US060770001002,484,102,143,73,45,45,98,55,341,99,221,93,120,51,18421
15000US060770001003,190,61,126,58,17,25,109,54,64,42,8,14,56,40,18422
15000US060770001004,246,71,49,36,23,28,26,23,197,68,78,47,119,67,18423
15000US060770003001,430,75,133,53,35,28,98,47,297,72,79,33,218,65,18424
15000US060770003002,437,67,95,49,26,23,69,42,342,60,236,58,106,42,18425
15000US060770004011,285,89,37,36,27,31,10,18,248,86,30,31,218,80,18426
15000US060770004012,265,86,167,93,131,87,36,41,98,61,24,24,74,56,18427
15000US060770004013,551,116,50,46,0,12,50,46,501,122,122,61,379,112,18428
15000US060770004014,233,60,27,27,19,24,8,13,206,64,91,51,115,52,18429
15000US060770004021,382,93,179,63,33,22,146,60,203,80,96,57,107,59,18430
15000US060770004022,376,102,148,76,36,38,112,74,228,88,62,51,166,78,18431
15000US060770004023,308,113,79,54,41,41,38,45,229,103,79,55,150,89,18432
15000US060770004024,551,109,224,102,96,64,128,79,327,88,118,58,209,78,18433
15000US060770005001,458,77,98,45,37,31,61,37,360,83,99,55,261,84,18434
15000US060770005002,296,65,111,54,47,37,64,46,185,65,52,36,133,54,18435
15000US060770006001,252,51,67,38,31,26,36,27,185,51,38,26,147,49,18436
15000US060770006002,291,54,75,31,28,20,47,28,216,52,87,45,129,46,18437
15000US060770007001,291,83,140,71,48,31,92,67,151,68,30,34,121,65,18438
15000US060770007002,350,98,110,75,34,40,76,64,240,80,99,65,141,67,18439
15000US060770007003,329,94,110,68,26,30,84,61,219,83,90,54,129,64,18440
15000US060770007004,250,77,95,67,21,33,74,62,155,65,84,47,71,53,18441
15000US060770008011,391,91,88,53,23,30,65,43,303,81,100,51,203,80,18442
15000US060770008012,705,114,181,74,34,26,147,71,524,128,142,83,382,110,18443
15000US060770008013,591,109,212,86,50,43,162,75,379,103,119,54,260,99,18444
15000US060770009001,316,67,52,39,6,9,46,37,264,68,47,30,217,69,18445
15000US060770009002,465,130,137,86,101,83,36,28,328,101,60,34,268,105,18446
15000US060770009003,319,64,42,42,9,17,33,37,277,61,49,31,228,62,18447
15000US060770009004,329,90,96,52,22,32,74,47,233,66,116,53,117,54,18448
15000US060770009005,501,125,246,97,26,41,220,96,255,112,25,39,230,108,18449
15000US060770010001,420,95,99,79,38,55,61,60,321,71,150,62,171,58,18450
15000US060770010002,650,119,163,83,73,67,90,54,487,113,135,59,352,110,18451
15000US060770010003,676,126,162,97,40,60,122,96,514,99,141,58,373,89,18452
15000US060770010004,216,49,0,12,0,12,0,12,216,49,101,42,115,47,18453
15000US060770011011,791,110,90,53,55,53,35,43,701,106,261,95,440,102,18454
15000US060770011012,503,96,51,31,35,27,16,18,452,99,180,70,272,94,18455
15000US060770011013,512,94,71,50,54,46,17,19,441,93,225,70,216,68,18456
15000US060770011021,529,99,74,55,16,18,58,53,455,101,90,66,365,91,18457
15000US060770011022,384,87,61,45,31,33,30,28,323,81,73,36,250,81,18458
15000US060770011023,343,81,86,66,8,12,78,65,257,79,81,51,176,70,18459
15000US060770011024,313,82,29,45,29,45,0,12,284,71,46,34,238,71,18460
15000US060770011025,371,75,81,49,15,18,66,46,290,75,68,36,222,77,18461
15000US060770012001,198,54,0,12,0,12,0,12,198,54,13,15,185,55,18462
15000US060770012002,582,105,18,21,0,12,18,21,564,105,118,54,446,100,18463
15000US060770012003,453,88,21,22,11,16,10,15,432,90,104,50,328,94,18464
15000US060770012004,501,106,43,45,0,12,43,45,458,108,133,83,325,89,18465
15000US060770013001,426,102,100,59,34,36,66,51,326,98,134,70,192,84,18466
15000US060770013002,591,106,31,31,17,27,14,16,560,110,187,78,373,109,18467
15000US060770013003,446,107,39,45,0,12,39,45,407,104,98,37,309,108,18468
15000US060770013004,437,100,51,50,8,13,43,48,386,99,74,49,312,99,18469
15000US060770014001,472,66,40,49,40,49,0,12,432,75,125,66,307,77,18470
15000US060770014002,495,95,125,62,46,39,79,49,370,79,252,81,118,52,18471
15000US060770014003,381,86,0,12,0,12,0,12,381,86,114,50,267,81,18472
15000US060770014004,465,74,36,27,0,12,36,27,429,71,104,48,325,71,18473
15000US060770015001,767,181,305,128,222,112,83,79,462,151,190,110,272,133,18474
15000US060770015002,560,139,143,97,110,80,33,51,417,129,88,53,329,129,18475
15000US060770015003,556,152,159,102,52,49,107,81,397,142,142,105,255,119,18476
15000US060770015004,416,131,78,76,28,49,50,54,338,112,35,34,303,116,18477
15000US060770016001,278,65,57,42,36,20,21,35,221,64,93,45,128,50,18478
15000US060770016002,327,61,90,48,23,23,67,44,237,71,97,41,140,62,18479
15000US060770017001,485,102,239,89,39,28,200,89,246,88,127,64,119,65,18480
15000US060770017002,428,87,119,66,72,54,47,38,309,82,70,48,239,82,18481
15000US060770017003,180,63,66,42,30,28,36,36,114,60,51,47,63,44,18482
15000US060770018001,506,108,192,96,90,58,102,80,314,92,79,58,235,76,18483
15000US060770018002,585,102,145,67,55,42,90,52,440,90,225,77,215,67,18484
15000US060770019001,443,88,188,76,100,60,88,55,255,77,112,61,143,60,18485
15000US060770019002,412,78,158,65,20,24,138,59,254,73,73,42,181,69,18486
15000US060770019003,376,78,82,52,27,33,55,42,294,71,141,57,153,64,18487
15000US060770019004,197,54,46,36,25,25,21,24,151,51,95,44,56,31,18488
15000US060770020001,279,60,92,43,16,19,76,39,187,56,69,33,118,50,18489
15000US060770020002,428,91,251,90,80,53,171,73,177,75,57,46,120,73,18490
15000US060770020003,419,77,62,36,27,22,35,26,357,80,104,53,253,74,18491
15000US060770021001,430,80,127,74,16,19,111,71,303,80,140,59,163,67,18492
15000US060770021002,787,95,178,74,26,25,152,71,609,103,158,70,451,112,18493
15000US060770021003,330,78,94,63,67,55,27,33,236,73,75,44,161,63,18494
15000US060770022011,305,59,94,50,19,16,75,48,211,63,81,41,130,53,18495
15000US060770022012,503,88,195,67,28,27,167,64,308,71,158,67,150,50,18496
15000US060770022021,356,75,140,75,52,49,88,61,216,60,26,26,190,59,18497
15000US060770022022,495,107,223,102,47,47,176,98,272,90,72,55,200,86,18498
15000US060770022023,526,103,323,88,107,51,216,75,203,86,57,48,146,78,18499
15000US060770023001,522,88,162,72,33,33,129,72,360,91,130,48,230,75,18500
15000US060770023002,454,87,193,75,76,55,117,60,261,78,90,45,171,75,18501
15000US060770023003,381,78,133,68,37,41,96,56,248,65,93,43,155,63,18502
15000US060770024011,411,113,15,17,15,17,0,12,396,113,187,91,209,98,18503
15000US060770024012,319,91,85,52,15,18,70,50,234,81,135,76,99,56,18504
15000US060770024013,527,105,207,89,111,61,96,75,320,108,109,68,211,97,18505
15000US060770024021,306,51,69,38,22,17,47,34,237,59,124,51,113,42,18506
15000US060770024022,278,55,43,37,0,12,43,37,235,54,81,39,154,48,18507
15000US060770025031,358,56,199,55,21,16,178,56,159,44,61,37,98,39,18508
15000US060770025032,303,61,107,43,23,19,84,41,196,59,69,45,127,48,18509
15000US060770025041,592,69,151,92,10,24,141,85,441,88,107,57,334,91,18510
15000US060770025042,474,62,82,48,23,32,59,43,392,72,107,52,285,81,18511
15000US060770027011,269,74,125,69,75,43,50,53,144,58,53,51,91,43,18512
15000US060770027012,358,108,39,43,31,40,8,13,319,106,151,81,168,91,18513
15000US060770027013,546,93,115,55,23,20,92,50,431,94,203,77,228,82,18514
15000US060770027014,613,100,131,54,29,25,102,50,482,98,84,43,398,96,18515
15000US060770027021,353,101,92,53,25,19,67,49,261,95,70,52,191,92,18516
15000US060770027022,451,104,69,64,0,12,69,64,382,109,53,31,329,110,18517
15000US060770027023,343,96,65,44,21,25,44,36,278,94,69,49,209,92,18518
15000US060770028001,1174,101,242,96,54,39,188,85,932,120,271,96,661,144,18519
15000US060770028002,376,82,79,54,24,39,55,43,297,87,168,73,129,68,18520
15000US060770031061,666,82,0,12,0,12,0,12,666,82,144,54,522,96,18521
15000US060770031062,728,108,73,55,28,40,45,63,655,103,121,76,534,114,18522
15000US060770031063,299,69,44,49,44,49,0,12,255,66,52,33,203,65,18523
15000US060770031081,521,107,34,43,0,12,34,43,487,99,100,44,387,99,18524
15000US060770031082,769,134,120,76,64,53,56,55,649,127,101,68,548,123,18525
15000US060770031083,527,113,173,87,78,53,95,77,354,88,97,46,257,81,18526
15000US060770031091,407,120,119,90,85,78,34,44,288,125,154,82,134,101,18527
15000US060770031092,574,127,0,12,0,12,0,12,574,127,108,72,466,125,18528
15000US060770031093,506,169,160,130,145,125,15,26,346,129,118,81,228,98,18529
15000US060770031094,659,114,47,46,14,24,33,38,612,122,90,55,522,134,18530
15000US060770031101,409,61,15,16,9,14,6,11,394,65,140,67,254,54,18531
15000US060770031102,373,77,70,42,32,31,38,29,303,76,93,50,210,78,18532
15000US060770031103,794,94,239,79,82,55,157,65,555,108,144,76,411,106,18533
15000US060770031111,855,81,55,34,15,19,40,26,800,83,287,94,513,96,18534
15000US060770031112,883,110,81,60,28,33,53,52,802,121,277,88,525,104,18535
15000US060770031121,920,85,129,64,20,32,109,58,791,111,231,81,560,114,18536
15000US060770031122,439,77,0,12,0,12,0,12,439,77,156,57,283,72,18537
15000US060770031131,791,158,257,109,53,43,204,107,534,150,146,106,388,117,18538
15000US060770031132,412,146,159,115,19,29,140,110,253,121,150,106,103,62,18539
15000US060770031133,462,119,16,25,16,25,0,12,446,118,105,75,341,111,18540
15000US060770031134,471,128,52,48,0,12,52,48,419,131,119,72,300,127,18541
15000US060770031141,1624,193,17,22,0,17,17,22,1607,194,270,155,1337,195,18542
15000US060770031142,501,121,15,25,0,12,15,25,486,119,47,44,439,120,18543
15000US060770031143,844,152,0,12,0,12,0,12,844,152,326,163,518,122,18544
15000US060770031144,645,95,0,12,0,12,0,12,645,95,65,50,580,96,18545
15000US060770032031,660,86,105,69,51,48,54,54,555,96,134,61,421,89,18546
15000US060770032032,777,85,55,40,33,28,22,25,722,90,124,57,598,100,18547
15000US060770032051,288,63,12,20,12,20,0,12,276,66,87,48,189,62,18548
15000US060770032052,867,78,160,86,56,53,104,62,707,84,259,77,448,96,18549
15000US060770032053,209,53,10,18,10,18,0,12,199,51,67,37,132,47,18550
15000US060770032081,1322,166,33,40,0,12,33,40,1289,170,270,107,1019,177,18551
15000US060770032082,1234,155,40,47,0,12,40,47,1194,153,266,103,928,162,18552
15000US060770032083,588,179,181,133,60,71,121,110,407,164,179,111,228,128,18553
15000US060770032084,743,190,0,12,0,12,0,12,743,190,182,132,561,191,18554
15000US060770032091,463,84,20,24,9,17,11,17,443,77,102,62,341,73,18555
15000US060770032092,277,65,4,10,4,10,0,12,273,64,114,52,159,62,18556
15000US060770032093,498,69,90,60,27,25,63,56,408,82,104,50,304,75,18557
15000US060770032101,741,75,63,60,17,19,46,58,678,73,210,72,468,96,18558
15000US060770032102,299,68,65,55,0,12,65,55,234,58,51,33,183,55,18559
15000US060770032131,411,120,148,91,84,74,64,58,263,88,54,44,209,84,18560
15000US060770032132,366,92,89,75,12,20,77,73,277,75,123,77,154,49,18561
15000US060770032133,278,67,106,74,87,71,19,22,172,54,63,48,109,49,18562
15000US060770032134,339,81,21,16,0,12,21,16,318,82,119,63,199,69,18563
15000US060770032141,443,58,46,44,0,12,46,44,397,54,84,34,313,59,18564
15000US060770032142,561,67,35,28,12,14,23,22,526,63,115,43,411,67,18565
15000US060770032151,306,57,22,22,0,12,22,22,284,56,128,52,156,55,18566
15000US060770032152,597,95,45,48,28,43,17,22,552,96,56,44,496,91,18567
15000US060770032153,833,105,142,79,71,62,71,56,691,106,19,24,672,106,18568
15000US060770032161,596,56,148,53,98,50,50,31,448,67,120,58,328,75,18569
15000US060770032162,351,53,80,40,63,34,17,22,271,55,102,38,169,47,18570
15000US060770032171,485,70,131,47,52,35,79,39,354,64,109,45,245,61,18571
15000US060770032172,468,62,90,41,27,20,63,34,378,60,110,36,268,59,18572
15000US060770033051,410,89,85,59,53,49,32,30,325,83,118,71,207,85,18573
15000US060770033052,510,114,158,78,34,29,124,72,352,105,162,75,190,90,18574
15000US060770033053,477,85,24,35,24,35,0,12,453,89,143,51,310,82,18575
15000US060770033061,964,104,187,81,88,60,99,51,777,128,257,96,520,130,18576
15000US060770033062,488,91,91,57,75,55,16,18,397,92,109,56,288,83,18577
15000US060770033071,597,106,118,67,25,24,93,65,479,113,206,84,273,99,18578
15000US060770033072,557,104,170,77,45,50,125,67,387,105,108,45,279,103,18579
15000US060770033073,627,121,212,88,89,56,123,80,415,109,41,31,374,107,18580
15000US060770033081,647,51,138,45,43,24,95,42,509,58,209,51,300,57,18581
15000US060770033101,471,90,135,69,46,43,89,50,336,87,142,66,194,66,18582
15000US060770033102,1017,99,219,101,70,47,149,87,798,123,301,90,497,106,18583
15000US060770033111,567,55,113,54,33,23,80,51,454,71,124,45,330,68,18584
15000US060770033112,455,81,128,58,94,52,34,31,327,74,116,49,211,63,18585
15000US060770033121,217,39,82,34,32,20,50,33,135,32,25,18,110,31,18586
15000US060770033122,379,70,119,54,34,26,85,48,260,71,93,54,167,63,18587
15000US060770033123,317,46,127,47,16,17,111,44,190,46,63,34,127,47,18588
15000US060770033131,450,57,79,32,41,21,38,25,371,57,197,49,174,45,18589
15000US060770033132,565,73,137,55,29,22,108,50,428,75,67,29,361,74,18590
15000US060770034031,304,67,56,53,56,53,0,12,248,59,56,37,192,62,18591
15000US060770034032,485,79,112,65,99,65,13,17,373,92,114,55,259,87,18592
15000US060770034033,391,77,163,76,65,49,98,65,228,68,67,41,161,63,18593
15000US060770034041,256,73,163,73,87,68,76,52,93,65,46,44,47,48,18594
15000US060770034042,404,98,128,75,35,34,93,74,276,88,90,60,186,73,18595
15000US060770034043,639,112,222,91,77,59,145,85,417,113,184,76,233,101,18596
15000US060770034044,434,73,58,39,45,34,13,17,376,77,213,72,163,53,18597
15000US060770034051,365,76,99,61,68,45,31,38,266,67,115,50,151,64,18598
15000US060770034052,230,67,25,23,14,15,11,17,205,66,83,49,122,64,18599
15000US060770034053,428,89,140,71,51,49,89,54,288,74,76,46,212,72,18600
15000US060770034061,589,91,262,89,137,80,125,68,327,79,101,59,226,74,18601
15000US060770034062,608,92,153,69,87,66,66,48,455,94,201,80,254,91,18602
15000US060770034071,497,67,140,48,56,28,84,40,357,68,166,47,191,60,18603
15000US060770034072,461,67,140,54,68,44,72,37,321,61,100,41,221,56,18604
15000US060770034091,330,77,24,29,0,12,24,29,306,75,74,42,232,69,18605
15000US060770034092,504,76,40,28,7,10,33,26,464,81,149,69,315,79,18606
15000US060770034093,508,86,84,58,10,15,74,59,424,86,124,73,300,77,18607
15000US060770034101,544,109,107,57,56,44,51,48,437,102,162,76,275,84,18608
15000US060770034102,798,101,175,80,44,54,131,66,623,105,110,56,513,106,18609
15000US060770034103,366,98,160,81,77,67,83,64,206,79,91,58,115,58,18610
15000US060770035001,451,148,0,12,0,12,0,12,451,148,166,83,285,145,18611
15000US060770035002,510,155,46,73,46,73,0,12,464,155,109,84,355,158,18612
15000US060770035003,4448,323,608,240,324,166,284,171,3840,352,931,274,2909,372,18613
15000US060770035004,274,109,25,39,25,39,0,12,249,113,20,33,229,110,18614
15000US060770035005,264,80,0,12,0,12,0,12,264,80,102,67,162,85,18615
15000US060770036011,224,71,10,17,0,12,10,17,214,73,48,42,166,66,18616
15000US060770036012,398,62,9,14,0,12,9,14,389,60,162,62,227,67,18617
15000US060770036013,274,81,32,38,6,10,26,42,242,75,106,56,136,64,18618
15000US060770036014,275,76,45,54,8,11,37,53,230,58,69,39,161,53,18619
15000US060770036021,224,58,20,23,20,23,0,12,204,58,69,48,135,46,18620
15000US060770036022,517,93,126,89,44,51,82,77,391,91,42,38,349,92,18621
15000US060770036023,305,78,24,23,10,16,14,15,281,80,122,53,159,59,18622
15000US060770037001,391,88,87,83,8,13,79,80,304,75,121,62,183,76,18623
15000US060770037002,441,102,98,58,0,12,98,58,343,99,144,83,199,82,18624
15000US060770037003,187,55,32,26,26,23,6,9,155,62,47,48,108,55,18625
15000US060770038011,1848,153,300,157,22,36,278,149,1548,163,400,149,1148,196,18626
15000US060770038012,587,163,124,106,72,81,52,65,463,146,198,123,265,110,18627
15000US060770038013,684,172,153,119,0,12,153,119,531,143,57,41,474,145,18628
15000US060770038021,504,104,97,45,60,31,37,33,407,109,96,56,311,98,18629
15000US060770038022,331,71,86,60,31,31,55,52,245,73,78,52,167,74,18630
15000US060770038023,965,117,134,74,49,36,85,64,831,119,120,52,711,134,18631
15000US060770038031,348,75,27,30,14,22,13,21,321,75,52,41,269,74,18632
15000US060770038032,375,63,24,30,20,29,4,7,351,60,176,64,175,55,18633
15000US060770038033,331,67,26,28,26,28,0,12,305,67,82,41,223,61,18634
15000US060770039001,186,58,4,8,0,12,4,8,182,58,62,32,120,53,18635
15000US060770039002,227,54,29,24,4,6,25,24,198,55,61,32,137,51,18636
15000US060770040011,349,49,14,21,0,12,14,21,335,49,120,37,215,49,18637
15000US060770040012,354,50,74,32,28,24,46,28,280,48,133,42,147,43,18638
15000US060770040021,3472,175,190,106,44,48,146,96,3282,193,798,200,2484,270,18639
15000US060770041021,436,106,0,12,0,12,0,12,436,106,133,93,303,113,18640
15000US060770041022,379,118,82,83,39,57,43,67,297,92,59,48,238,94,18641
15000US060770041023,1527,160,84,70,46,42,38,62,1443,157,296,100,1147,147,18642
15000US060770041041,1272,49,0,12,0,12,0,12,1272,49,308,76,964,94,18643
15000US060770041051,512,97,27,41,0,12,27,41,485,94,92,38,393,97,18644
15000US060770041052,841,102,76,62,37,46,39,36,765,102,163,54,602,101,18645
15000US060770041053,472,74,24,24,0,12,24,24,448,76,66,33,382,75,18646
15000US060770041061,237,55,5,8,0,12,5,8,232,55,28,25,204,50,18647
15000US060770041062,336,55,0,12,0,12,0,12,336,55,106,35,230,50,18648
15000US060770042011,465,131,14,22,0,12,14,22,451,130,133,81,318,142,18649
15000US060770042012,588,123,26,43,0,12,26,43,562,122,72,52,490,117,18650
15000US060770042013,673,135,18,29,0,12,18,29,655,133,180,94,475,125,18651
15000US060770042014,425,115,0,12,0,12,0,12,425,115,61,48,364,115,18652
15000US060770042015,406,90,0,12,0,12,0,12,406,90,88,62,318,104,18653
15000US060770042021,653,60,9,10,3,5,6,8,644,61,220,47,424,59,18654
15000US060770042031,880,100,185,87,17,25,168,83,695,116,256,85,439,104,18655
15000US060770042032,539,89,106,70,58,55,48,47,433,81,131,51,302,81,18656
15000US060770042041,493,90,36,34,17,20,19,28,457,87,97,57,360,88,18657
15000US060770042042,474,77,37,45,28,44,9,15,437,81,112,60,325,78,18658
15000US060770042043,352,72,33,50,30,49,3,11,319,66,79,35,240,74,18659
15000US060770043021,501,130,53,51,31,36,22,35,448,140,131,77,317,129,18660
15000US060770043022,634,108,43,42,31,37,12,19,591,117,206,101,385,107,18661
15000US060770043023,775,131,97,83,46,56,51,54,678,138,146,88,532,145,18662
15000US060770043024,287,78,40,40,0,12,40,40,247,77,84,48,163,78,18663
15000US060770043031,516,78,11,16,11,16,0,12,505,79,109,59,396,81,18664
15000US060770043032,478,79,30,27,20,23,10,16,448,86,96,55,352,84,18665
15000US060770043033,188,59,4,8,0,12,4,8,184,59,34,28,150,61,18666
15000US060770043034,793,96,9,13,9,13,0,12,784,95,165,72,619,109,18667
15000US060770043051,869,166,60,84,0,12,60,84,809,152,249,114,560,153,18668
15000US060770043052,1271,171,72,75,52,73,20,26,1199,163,264,122,935,163,18669
15000US060770043071,549,79,13,19,13,19,0,12,536,82,137,68,399,74,18670
15000US060770043072,657,76,76,53,34,38,42,40,581,82,133,57,448,83,18671
15000US060770043073,308,85,22,35,0,12,22,35,286,76,68,56,218,84,18672
15000US060770043081,350,81,27,33,0,12,27,33,323,81,140,59,183,85,18673
15000US060770043082,872,90,204,89,108,74,96,55,668,110,165,77,503,103,18674
15000US060770044021,1048,97,95,57,8,13,87,55,953,93,251,66,702,99,18675
15000US060770044022,601,89,52,36,26,25,26,25,549,94,145,69,404,94,18676
15000US060770044031,610,105,191,87,21,20,170,85,419,98,70,46,349,95,18677
15000US060770044032,460,93,134,68,47,42,87,52,326,82,106,60,220,81,18678
15000US060770044041,293,62,77,38,22,18,55,33,216,61,44,21,172,62,18679
15000US060770044042,318,61,116,55,54,41,62,34,202,61,50,29,152,56,18680
15000US060770044043,386,69,107,56,28,30,79,48,279,64,99,42,180,54,18681
15000US060770045011,451,66,15,13,15,13,0,12,436,67,159,46,277,56,18682
15000US060770045012,454,61,49,39,23,34,26,16,405,69,94,37,311,70,18683
15000US060770045021,647,99,203,91,55,43,148,88,444,98,172,77,272,88,18684
15000US060770045022,516,91,121,63,22,26,99,58,395,94,90,44,305,89,18685
15000US060770046001,573,131,93,91,21,24,72,87,480,117,133,82,347,101,18686
15000US060770046002,718,152,53,49,53,49,0,12,665,150,206,94,459,150,18687
15000US060770046003,470,145,0,12,0,12,0,12,470,145,112,106,358,143,18688
15000US060770046004,305,98,82,76,36,44,46,63,223,75,42,38,181,76,18689
15000US060770047011,358,66,62,40,13,21,49,34,296,69,62,37,234,66,18690
15000US060770047012,685,63,50,32,22,18,28,26,635,71,178,55,457,73,18691
15000US060770047031,890,82,30,30,20,24,10,15,860,86,280,73,580,93,18692
15000US060770047032,385,67,0,12,0,12,0,12,385,67,126,72,259,76,18693
15000US060770047041,424,97,12,17,12,17,0,12,412,95,110,63,302,97,18694
15000US060770047042,356,82,0,12,0,12,0,12,356,82,124,55,232,77,18695
15000US060770047043,563,93,73,58,37,38,36,45,490,104,142,69,348,88,18696
15000US060770047044,351,70,18,21,10,15,8,13,333,68,75,39,258,69,18697
15000US060770048001,375,88,24,41,0,12,24,41,351,87,65,53,286,89,18698
15000US060770048002,603,88,23,37,23,37,0,12,580,90,87,47,493,87,18699
15000US060770048003,330,79,7,11,7,11,0,12,323,79,93,56,230,68,18700
15000US060770048004,556,88,13,21,13,21,0,12,543,89,128,63,415,82,18701
15000US060770049011,954,189,59,80,59,80,0,12,895,190,202,105,693,184,18702
15000US060770049012,1032,201,80,89,13,22,67,87,952,205,183,93,769,191,18703
15000US060770049013,734,186,56,65,0,12,56,65,678,174,153,100,525,171,18704
15000US060770049021,696,166,25,32,9,20,16,27,671,172,216,125,455,141,18705
15000US060770049022,433,134,15,23,0,12,15,23,418,136,121,111,297,113,18706
15000US060770049023,343,91,10,19,10,19,0,12,333,90,160,73,173,76,18707
15000US060770049024,353,104,42,43,0,12,42,43,311,103,25,31,286,99,18708
15000US060770050011,948,119,68,62,21,35,47,50,880,135,154,81,726,143,18709
15000US060770050012,457,115,80,77,15,24,65,74,377,129,38,37,339,133,18710
15000US060770050013,757,123,17,28,0,12,17,28,740,121,215,83,525,135,18711
15000US060770050031,360,80,9,14,0,12,9,14,351,80,51,33,300,82,18712
15000US060770050032,1485,124,43,37,10,16,33,34,1442,127,358,102,1084,130,18713
15000US060770050041,793,95,20,23,0,12,20,23,773,101,237,66,536,107,18714
15000US060770050042,634,109,68,51,40,46,28,22,566,109,147,59,419,106,18715
15000US060770050043,510,69,25,38,0,12,25,38,485,70,128,48,357,70,18716
15000US060770051061,405,81,91,73,80,70,11,19,314,53,109,57,205,53,18717
15000US060770051062,1343,118,63,44,16,21,47,39,1280,130,270,73,1010,123,18718
15000US060770051081,540,93,77,48,15,16,62,46,463,97,139,53,324,92,18719
15000US060770051082,163,53,40,31,27,35,13,16,123,47,34,29,89,42,18720
15000US060770051083,630,91,54,42,7,12,47,41,576,89,162,72,414,95,18721
15000US060770051091,425,111,103,65,35,30,68,57,322,88,107,47,215,87,18722
15000US060770051092,631,123,239,117,39,37,200,108,392,107,98,58,294,97,18723
15000US060770051093,201,86,52,51,8,13,44,49,149,71,32,32,117,71,18724
15000US060770051101,188,84,0,12,0,12,0,12,188,84,43,40,145,80,18725
15000US060770051102,519,108,56,50,0,12,56,50,463,108,141,78,322,109,18726
15000US060770051103,275,128,62,75,0,12,62,75,213,111,81,79,132,101,18727
15000US060770051104,189,85,0,12,0,12,0,12,189,85,81,54,108,77,18728
15000US060770051105,1020,177,8,24,0,12,8,24,1012,181,348,156,664,181,18729
15000US060770051131,1227,169,69,86,14,22,55,84,1158,167,397,169,761,163,18730
15000US060770051132,1113,185,122,88,22,27,100,85,991,187,319,138,672,188,18731
15000US060770051141,774,142,90,82,0,12,90,82,684,143,183,88,501,130,18732
15000US060770051142,1906,189,101,95,0,17,101,95,1805,210,359,137,1446,205,18733
15000US060770051191,1786,114,86,55,31,31,55,60,1700,134,452,97,1248,141,18734
15000US060770051192,121,58,45,45,21,34,24,29,76,41,0,12,76,41,18735
15000US060770051221,1800,87,268,101,127,72,141,88,1532,119,363,98,1169,119,18736
15000US060770051231,1037,92,129,64,55,38,74,53,908,124,217,79,691,138,18737
15000US060770051232,523,89,80,59,6,11,74,63,443,94,75,42,368,93,18738
15000US060770051241,753,76,63,56,44,51,19,24,690,87,217,60,473,88,18739
15000US060770051242,472,88,12,14,9,14,3,7,460,86,180,67,280,85,18740
15000US060770051251,363,51,37,33,23,25,14,23,326,57,118,45,208,56,18741
15000US060770051252,299,46,32,31,17,24,15,18,267,45,87,33,180,43,18742
15000US060770051261,356,73,53,30,45,27,8,14,303,80,175,80,128,64,18743
15000US060770051262,1092,93,288,110,71,45,217,103,804,119,217,69,587,121,18744
15000US060770051271,998,94,142,75,74,57,68,50,856,104,178,63,678,118,18745
15000US060770051272,487,74,41,33,29,27,12,17,446,76,158,67,288,77,18746
15000US060770051291,367,84,92,56,61,49,31,28,275,85,130,66,145,80,18747
15000US060770051292,669,86,132,75,60,40,72,59,537,96,111,58,426,91,18748
15000US060770051301,255,49,19,16,4,7,15,15,236,49,53,32,183,47,18749
15000US060770051302,682,71,134,72,78,50,56,49,548,80,146,53,402,80,18750
15000US060770051311,243,82,41,37,18,22,23,30,202,85,55,29,147,79,18751
15000US060770051312,450,90,36,47,36,47,0,12,414,91,200,81,214,92,18752
15000US060770051313,545,114,63,52,37,44,26,28,482,107,121,48,361,106,18753
15000US060770051321,341,78,12,17,12,17,0,12,329,80,136,79,193,80,18754
15000US060770051322,311,92,40,32,0,12,40,32,271,95,133,77,138,83,18755
15000US060770051323,384,83,43,35,23,21,20,28,341,87,100,67,241,103,18756
15000US060770051331,352,89,19,21,19,21,0,12,333,87,108,59,225,93,18757
15000US060770051332,499,101,18,19,0,12,18,19,481,99,173,71,308,98,18758
15000US060770051333,305,93,23,35,23,35,0,12,282,85,95,56,187,91,18759
15000US060770051334,163,53,31,27,31,27,0,12,132,52,33,25,99,48,18760
15000US060770051341,526,87,48,36,8,12,40,33,478,90,133,51,345,95,18761
15000US060770051342,670,103,110,62,60,47,50,44,560,109,232,71,328,102,18762
15000US060770051343,361,66,32,34,9,13,23,32,329,71,83,47,246,75,18763
15000US060770051351,1377,114,96,61,45,43,51,55,1281,112,416,87,865,124,18764
15000US060770051352,1038,106,66,53,0,12,66,53,972,114,179,71,793,119,18765
15000US060770052021,540,87,123,60,53,41,70,55,417,83,138,49,279,70,18766
15000US060770052022,1548,125,0,17,0,17,0,17,1548,125,319,124,1229,163,18767
15000US060770052061,291,166,21,37,0,12,21,37,270,164,89,93,181,157,18768
15000US060770052062,353,176,0,12,0,12,0,12,353,176,101,129,252,137,18769
15000US060770052063,3901,390,49,54,24,37,25,41,3852,395,390,217,3462,413,18770
15000US060770052064,822,271,0,12,0,12,0,12,822,271,75,64,747,286,18771
15000US060770052065,538,162,63,74,23,38,40,65,475,166,252,174,223,159,18772
15000US060770052071,713,120,0,12,0,12,0,12,713,120,146,77,567,120,18773
15000US060770052072,3103,168,147,105,32,37,115,98,2956,174,489,168,2467,217,18774
15000US060770052081,920,113,32,26,15,17,17,20,888,116,177,72,711,113,18775
15000US060770052082,537,91,10,16,0,12,10,16,527,90,55,29,472,94,18776
15000US060770052083,495,109,32,41,0,12,32,41,463,107,89,51,374,100,18777
15000US060770052091,665,136,28,25,7,13,21,24,637,135,213,110,424,126,18778
15000US060770052092,531,82,31,38,0,12,31,38,500,82,155,69,345,87,18779
15000US060770052093,796,102,52,44,31,27,21,34,744,113,119,52,625,120,18780
15000US060770052101,2196,173,102,98,13,20,89,95,2094,197,325,120,1769,206,18781
15000US060770052102,780,142,0,12,0,12,0,12,780,142,84,67,696,144,18782
15000US060770052103,292,98,25,37,25,37,0,12,267,97,28,34,239,94,18783
15000US060770053021,557,158,0,12,0,12,0,12,557,158,91,62,466,159,18784
15000US060770053022,312,86,29,43,26,41,3,15,283,86,94,73,189,88,18785
15000US060770053023,454,132,91,79,62,68,29,46,363,148,72,54,291,160,18786
15000US060770053024,421,96,83,64,68,63,15,18,338,92,65,39,273,88,18787
15000US060770053025,426,110,33,40,0,12,33,40,393,106,134,91,259,89,18788
15000US060770053031,313,81,57,47,0,12,57,47,256,73,50,48,206,72,18789
15000US060770053032,395,86,98,66,43,42,55,56,297,78,92,65,205,57,18790
15000US060770053033,193,67,16,17,16,17,0,12,177,68,43,28,134,62,18791
15000US060770053034,421,81,68,55,23,20,45,50,353,88,114,63,239,84,18792
15000US060770053035,208,61,8,13,0,12,8,13,200,59,81,46,119,47,18793
15000US060770053051,501,82,93,57,23,18,70,55,408,91,134,57,274,88,18794
15000US060770053052,369,84,54,66,7,11,47,65,315,76,68,39,247,71,18795
15000US060770053053,656,119,115,91,3,8,112,90,541,119,134,63,407,106,18796
15000US060770053054,387,90,36,41,26,38,10,16,351,87,138,63,213,74,18797
15000US060770053071,396,52,71,36,38,23,33,26,325,57,80,37,245,61,18798
15000US060770053072,589,62,86,46,31,33,55,34,503,65,109,48,394,63,18799
15000US060770053081,323,66,49,42,22,25,27,34,274,61,44,29,230,64,18800
15000US060770053082,240,52,55,37,12,20,43,35,185,52,62,36,123,57,18801
15000US060770053083,757,67,45,30,8,12,37,26,712,72,190,69,522,73,18802
15000US060770054031,348,91,16,18,16,18,0,12,332,89,56,44,276,90,18803
15000US060770054032,410,65,10,15,0,12,10,15,400,65,115,54,285,68,18804
15000US060770054033,531,96,0,12,0,12,0,12,531,96,110,56,421,80,18805
15000US060770054034,490,95,25,26,5,10,20,25,465,93,110,71,355,86,18806
15000US060770054051,695,78,61,49,4,12,57,49,634,83,155,62,479,92,18807
15000US060770054052,349,63,26,17,0,12,26,17,323,65,95,36,228,64,18808
15000US060770054061,642,61,82,43,44,33,38,30,560,70,134,52,426,74,18809
15000US060770054062,373,61,50,30,14,16,36,25,323,63,120,49,203,58,18810
15000US060770055011,391,51,32,21,29,20,3,4,359,55,109,32,250,44,18811
15000US060770055012,263,38,17,18,8,13,9,13,246,42,86,30,160,36,18812
15000US060770055021,275,46,36,24,5,10,31,23,239,46,36,22,203,48,18813
15000US060770055022,306,44,16,19,0,12,16,19,290,46,92,39,198,47,18814
15000US060790100021,335,85,0,12,0,12,0,12,335,85,32,27,303,83,18815
15000US060790100022,783,98,41,30,18,19,23,23,742,98,106,55,636,95,18816
15000US060790100023,253,71,4,9,0,12,4,9,249,71,49,30,200,75,18817
15000US060790100161,1051,129,24,26,15,22,9,15,1027,131,286,105,741,153,18818
15000US060790100162,676,124,156,89,42,53,114,88,520,116,74,58,446,112,18819
15000US060790101011,772,49,60,30,12,13,48,28,712,59,118,40,594,69,18820
15000US060790101021,597,152,191,118,57,42,134,109,406,130,64,39,342,130,18821
15000US060790101022,494,176,9,15,9,15,0,12,485,176,59,71,426,176,18822
15000US060790101023,682,211,164,140,11,21,153,138,518,192,65,56,453,195,18823
15000US060790101024,499,201,15,23,0,12,15,23,484,199,78,43,406,201,18824
15000US060790101025,488,144,27,34,0,12,27,34,461,139,56,46,405,137,18825
15000US060790102011,1489,151,66,60,36,41,30,43,1423,165,260,94,1163,183,18826
15000US060790102012,1155,157,27,30,14,22,13,21,1128,157,194,83,934,164,18827
15000US060790102021,786,105,44,36,24,27,20,22,742,113,171,65,571,107,18828
15000US060790102022,1225,133,33,40,0,12,33,40,1192,135,227,68,965,138,18829
15000US060790102041,947,163,62,66,62,66,0,12,885,169,215,92,670,175,18830
15000US060790102042,1301,170,206,121,17,30,189,122,1095,170,204,86,891,164,18831
15000US060790102051,455,93,0,12,0,12,0,12,455,93,143,65,312,91,18832
15000US060790102052,291,85,46,64,1,9,45,63,245,78,31,31,214,75,18833
15000US060790102053,726,96,48,41,27,34,21,24,678,104,98,52,580,107,18834
15000US060790103001,1082,159,50,45,50,45,0,12,1032,156,288,117,744,154,18835
15000US060790103002,863,162,12,14,8,13,4,6,851,160,184,79,667,162,18836
15000US060790103003,399,97,35,44,14,21,21,37,364,87,75,41,289,86,18837
15000US060790103004,1288,165,21,24,6,7,15,23,1267,166,142,74,1125,174,18838
15000US060790104031,648,87,41,55,7,12,34,54,607,80,174,56,433,74,18839
15000US060790104032,586,98,9,14,0,12,9,14,577,97,151,54,426,97,18840
15000US060790104033,661,110,28,25,6,10,22,28,633,113,132,63,501,113,18841
15000US060790104041,568,68,25,30,0,12,25,30,543,65,157,44,386,63,18842
15000US060790104042,332,62,23,17,5,8,18,14,309,63,83,42,226,61,18843
15000US060790105031,708,146,73,55,12,20,61,51,635,139,198,88,437,129,18844
15000US060790105032,1047,173,19,31,19,31,0,12,1028,174,223,104,805,173,18845
15000US060790105033,419,107,55,66,55,66,0,12,364,110,53,43,311,103,18846
15000US060790105034,335,123,33,37,33,37,0,12,302,131,155,123,147,70,18847
15000US060790105041,380,117,8,14,0,12,8,14,372,118,120,59,252,112,18848
15000US060790105042,516,97,0,12,0,12,0,12,516,97,135,51,381,94,18849
15000US060790105043,554,111,10,16,0,12,10,16,544,112,140,47,404,113,18850
15000US060790106021,512,87,20,22,0,12,20,22,492,88,114,51,378,88,18851
15000US060790106022,777,106,50,44,11,17,39,37,727,110,116,53,611,125,18852
15000US060790106023,605,93,20,32,0,12,20,32,585,93,120,63,465,89,18853
15000US060790106031,361,72,31,24,12,14,19,17,330,70,33,22,297,65,18854
15000US060790106032,259,46,11,9,11,9,0,12,248,45,49,32,199,43,18855
15000US060790107011,693,95,24,28,0,12,24,28,669,101,164,76,505,95,18856
15000US060790107012,836,95,70,48,22,25,48,43,766,102,195,86,571,92,18857
15000US060790107013,526,71,52,38,20,23,32,28,474,75,131,54,343,77,18858
15000US060790107031,771,101,55,42,22,27,33,33,716,105,192,72,524,103,18859
15000US060790107032,614,96,99,51,41,44,58,35,515,96,101,50,414,98,18860
15000US060790107071,386,67,18,28,18,28,0,12,368,68,119,64,249,84,18861
15000US060790107072,786,143,13,20,13,20,0,12,773,148,165,94,608,130,18862
15000US060790107073,473,80,0,12,0,12,0,12,473,80,117,70,356,88,18863
15000US060790107074,451,80,0,12,0,12,0,12,451,80,109,56,342,87,18864
15000US060790107075,654,122,4,11,4,11,0,12,650,122,266,110,384,119,18865
15000US060790109011,193,47,7,12,0,12,7,12,186,46,6,9,180,45,18866
15000US060790109012,708,84,13,20,0,17,13,20,695,87,29,17,666,88,18867
15000US060790109021,230,64,0,12,0,12,0,12,230,64,31,23,199,68,18868
15000US060790109022,395,95,0,12,0,12,0,12,395,95,26,23,369,96,18869
15000US060790109023,789,114,9,16,0,12,9,16,780,116,52,46,728,119,18870
15000US060790110011,828,122,28,33,28,33,0,12,800,124,245,116,555,128,18871
15000US060790110012,386,67,15,25,0,12,15,25,371,68,73,51,298,73,18872
15000US060790110013,914,118,66,67,17,26,49,61,848,112,237,115,611,114,18873
15000US060790110021,814,77,0,12,0,12,0,12,814,77,121,51,693,80,18874
15000US060790110022,477,85,0,12,0,12,0,12,477,85,5,9,472,86,18875
15000US060790111011,605,88,65,52,27,42,38,32,540,87,46,45,494,81,18876
15000US060790111012,733,134,102,91,15,17,87,88,631,106,87,32,544,108,18877
15000US060790111013,494,86,16,14,6,11,10,10,478,85,42,33,436,90,18878
15000US060790111021,596,114,36,57,36,57,0,12,560,111,126,70,434,97,18879
15000US060790111022,465,88,46,54,0,12,46,54,419,84,20,23,399,84,18880
15000US060790111023,509,90,11,17,11,17,0,12,498,89,135,68,363,86,18881
15000US060790111024,824,128,65,66,16,26,49,58,759,131,79,66,680,145,18882
15000US060790111031,567,111,56,52,0,12,56,52,511,99,71,54,440,98,18883
15000US060790111032,673,120,66,56,29,38,37,40,607,120,164,66,443,118,18884
15000US060790112001,918,202,18,26,0,12,18,26,900,200,134,70,766,208,18885
15000US060790112002,408,100,0,12,0,12,0,12,408,100,120,74,288,93,18886
15000US060790112003,266,112,14,23,0,12,14,23,252,112,43,33,209,112,18887
15000US060790112004,701,163,12,20,12,20,0,12,689,163,136,63,553,168,18888
15000US060790112005,538,142,0,12,0,12,0,12,538,142,34,36,504,145,18889
15000US060790113001,1353,151,181,106,110,91,71,75,1172,181,304,129,868,181,18890
15000US060790113002,783,132,82,67,29,43,53,53,701,124,180,100,521,113,18891
15000US060790113003,445,73,0,12,0,12,0,12,445,73,16,26,429,71,18892
15000US060790113004,234,94,0,12,0,12,0,12,234,94,58,45,176,93,18893
15000US060790114001,0,12,0,12,0,12,0,12,0,12,0,12,0,12,18894
15000US060790115011,724,43,69,36,49,30,20,18,655,55,159,48,496,61,18895
15000US060790115031,508,75,7,11,7,11,0,12,501,75,34,26,467,78,18896
15000US060790115032,807,69,16,17,9,14,7,11,791,72,174,62,617,83,18897
15000US060790115041,237,49,0,12,0,12,0,12,237,49,59,38,178,42,18898
15000US060790115042,55,38,0,12,0,12,0,12,55,38,3,4,52,39,18899
15000US060790116001,678,89,0,12,0,12,0,12,678,89,276,83,402,92,18900
15000US060790116002,602,131,33,54,0,12,33,54,569,135,131,95,438,132,18901
15000US060790116003,487,97,11,19,0,12,11,19,476,100,126,72,350,96,18902
15000US060790117011,226,78,14,23,14,23,0,12,212,75,77,61,135,71,18903
15000US060790117012,896,159,65,95,65,95,0,12,831,162,149,106,682,141,18904
15000US060790117013,526,122,0,12,0,12,0,12,526,122,106,58,420,125,18905
15000US060790117014,568,126,0,12,0,12,0,12,568,126,223,98,345,122,18906
15000US060790117041,368,64,13,15,0,12,13,15,355,65,82,44,273,64,18907
15000US060790117042,485,118,20,25,0,12,20,25,465,114,97,37,368,115,18908
15000US060790117043,689,116,9,15,0,12,9,15,680,114,80,59,600,121,18909
15000US060790117044,283,69,8,13,0,12,8,13,275,70,52,31,223,73,18910
15000US060790118001,556,114,0,12,0,12,0,12,556,114,88,60,468,111,18911
15000US060790118002,711,93,0,12,0,12,0,12,711,93,174,89,537,91,18912
15000US060790118003,390,84,0,12,0,12,0,12,390,84,92,54,298,97,18913
15000US060790118004,297,77,17,28,0,12,17,28,280,81,0,12,280,81,18914
15000US060790118005,974,143,0,12,0,12,0,12,974,143,312,122,662,146,18915
15000US060790119011,572,78,37,41,0,12,37,41,535,73,180,56,355,82,18916
15000US060790119012,710,108,94,69,25,26,69,62,616,117,145,64,471,122,18917
15000US060790119021,901,175,55,60,55,60,0,12,846,170,167,91,679,163,18918
15000US060790119022,643,156,0,12,0,12,0,12,643,156,137,101,506,150,18919
15000US060790119023,414,128,0,12,0,12,0,12,414,128,79,54,335,125,18920
15000US060790119024,773,191,24,38,0,12,24,38,749,196,72,56,677,191,18921
15000US060790119025,692,165,56,68,17,26,39,62,636,155,130,88,506,146,18922
15000US060790120001,778,185,72,62,38,46,34,39,706,175,243,118,463,153,18923
15000US060790120002,472,178,0,12,0,12,0,12,472,178,84,75,388,158,18924
15000US060790120003,907,220,105,77,40,51,65,66,802,226,193,115,609,214,18925
15000US060790120004,945,184,41,44,29,38,12,23,904,187,195,73,709,181,18926
15000US060790121021,680,171,58,82,0,12,58,82,622,158,137,67,485,165,18927
15000US060790121022,616,134,14,21,0,12,14,21,602,136,121,71,481,137,18928
15000US060790121023,730,152,68,70,53,66,15,23,662,151,226,100,436,145,18929
15000US060790121024,415,125,58,74,58,74,0,12,357,115,16,24,341,114,18930
15000US060790122001,751,222,224,158,85,97,139,119,527,168,204,109,323,155,18931
15000US060790122002,351,128,0,12,0,12,0,12,351,128,56,69,295,120,18932
15000US060790122003,697,144,74,68,0,12,74,68,623,131,221,93,402,102,18933
15000US060790122004,724,172,124,111,72,99,52,47,600,180,144,92,456,166,18934
15000US060790123021,1179,151,14,22,0,12,14,22,1165,149,278,105,887,158,18935
15000US060790123022,247,86,0,12,0,12,0,12,247,86,107,76,140,55,18936
15000US060790123023,478,108,16,20,16,20,0,12,462,108,94,53,368,112,18937
15000US060790123041,994,190,65,74,0,12,65,74,929,180,184,99,745,175,18938
15000US060790123042,1186,154,80,56,62,48,18,27,1106,153,293,141,813,145,18939
15000US060790123043,425,91,0,12,0,12,0,12,425,91,107,66,318,105,18940
15000US060790123044,600,138,50,65,0,12,50,65,550,139,70,51,480,143,18941
15000US060790123045,694,147,24,32,24,32,0,12,670,148,250,116,420,127,18942
15000US060790124011,448,122,44,51,14,22,30,46,404,122,56,38,348,126,18943
15000US060790124012,570,118,61,45,30,35,31,30,509,118,147,65,362,110,18944
15000US060790124013,1115,141,40,34,21,27,19,22,1075,144,379,119,696,143,18945
15000US060790124021,1025,152,35,54,0,12,35,54,990,153,210,115,780,154,18946
15000US060790124022,1090,152,84,62,37,40,47,44,1006,152,243,86,763,152,18947
15000US060790124023,1191,167,225,133,33,37,192,133,966,153,166,88,800,167,18948
15000US060790125021,559,93,17,20,5,9,12,18,542,97,60,40,482,97,18949
15000US060790125022,410,76,5,10,0,12,5,10,405,76,93,53,312,76,18950
15000US060790125023,1041,110,80,51,21,20,59,50,961,126,186,80,775,137,18951
15000US060790125031,566,137,20,32,0,12,20,32,546,142,218,146,328,97,18952
15000US060790125032,1246,165,30,35,15,25,15,28,1216,169,118,86,1098,171,18953
15000US060790125033,644,136,169,105,108,85,61,77,475,116,161,92,314,101,18954
15000US060790125051,628,99,13,21,0,12,13,21,615,98,154,63,461,104,18955
15000US060790125052,404,70,20,21,20,21,0,12,384,70,97,63,287,70,18956
15000US060790125053,793,114,91,71,7,11,84,70,702,115,123,53,579,115,18957
15000US060790126001,616,149,0,12,0,12,0,12,616,149,186,97,430,145,18958
15000US060790126002,523,132,35,39,19,31,16,27,488,140,178,108,310,118,18959
15000US060790126003,487,128,24,34,3,12,21,32,463,125,147,94,316,115,18960
15000US060790126004,640,125,0,12,0,12,0,12,640,125,209,117,431,112,18961
15000US060790126005,820,186,6,12,0,12,6,12,814,187,199,116,615,190,18962
15000US060790127021,371,145,0,12,0,12,0,12,371,145,8,14,363,145,18963
15000US060790127022,367,140,34,47,0,12,34,47,333,135,97,65,236,137,18964
15000US060790127023,723,159,47,76,0,12,47,76,676,162,182,118,494,158,18965
15000US060790127024,257,76,0,12,0,12,0,12,257,76,24,31,233,74,18966
15000US060790127025,896,165,10,16,0,12,10,16,886,165,270,120,616,170,18967
15000US060790127041,1001,122,0,12,0,12,0,12,1001,122,311,116,690,133,18968
15000US060790127042,810,118,13,21,13,21,0,12,797,116,260,99,537,138,18969
15000US060790127043,1142,124,89,66,66,53,23,39,1053,124,329,106,724,116,18970
15000US060790127044,385,69,0,12,0,12,0,12,385,69,49,42,336,72,18971
15000US060790128001,79,31,8,9,0,12,8,9,71,34,21,21,50,35,18972
15000US060790129001,889,116,54,41,29,30,25,33,835,115,111,60,724,109,18973
15000US060790129002,995,123,32,32,0,12,32,32,963,115,170,72,793,133,18974
15000US060790130001,473,106,15,23,15,23,0,12,458,104,97,58,361,95,18975
15000US060790130002,618,119,0,12,0,12,0,12,618,119,106,63,512,119,18976
15000US060799900000,0,12,0,12,0,12,0,12,0,12,0,12,0,12,18977
15000US060816001001,840,142,0,12,0,12,0,12,840,142,139,71,701,145,18978
15000US060816001002,811,126,30,38,30,38,0,12,781,121,86,70,695,132,18979
15000US060816001003,441,133,0,12,0,12,0,12,441,133,60,52,381,132,18980
15000US060816002001,564,76,154,60,37,35,117,58,410,73,134,57,276,72,18981
15000US060816002002,591,78,9,17,0,12,9,17,582,78,76,38,506,82,18982
15000US060816003001,511,86,25,20,8,13,17,18,486,85,115,49,371,85,18983
15000US060816003002,708,83,0,12,0,12,0,12,708,83,71,39,637,85,18984
15000US060816004011,705,88,74,67,51,57,23,36,631,105,125,52,506,100,18985
15000US060816004012,370,81,15,24,0,12,15,24,355,79,116,52,239,80,18986
15000US060816004021,304,77,0,12,0,12,0,12,304,77,16,17,288,77,18987
15000US060816004022,568,87,33,24,22,19,11,15,535,89,112,56,423,91,18988
15000US060816004023,388,88,10,15,0,12,10,15,378,89,31,28,347,94,18989
15000US060816005001,550,98,0,12,0,12,0,12,550,98,73,59,477,115,18990
15000US060816005002,230,90,0,12,0,12,0,12,230,90,84,54,146,101,18991
15000US060816005003,513,119,0,12,0,12,0,12,513,119,68,62,445,124,18992
15000US060816005004,415,115,0,12,0,12,0,12,415,115,36,30,379,121,18993
15000US060816005005,332,103,0,12,0,12,0,12,332,103,22,30,310,105,18994
15000US060816006001,698,110,57,60,0,12,57,60,641,109,130,58,511,111,18995
15000US060816006002,837,106,40,31,0,12,40,31,797,114,163,77,634,120,18996
15000US060816007001,715,173,34,38,34,38,0,12,681,181,129,54,552,182,18997
15000US060816007002,635,146,0,12,0,12,0,12,635,146,164,67,471,144,18998
15000US060816007003,417,119,35,36,0,12,35,36,382,127,50,45,332,120,18999
15000US060816007004,378,120,18,29,18,29,0,12,360,116,119,104,241,99,19000
15000US060816008001,616,115,52,62,0,12,52,62,564,137,124,103,440,135,19001
15000US060816008002,847,143,53,38,31,32,22,27,794,143,146,76,648,147,19002
15000US060816008003,898,131,119,92,0,12,119,92,779,147,86,75,693,153,19003
15000US060816008004,359,110,15,23,15,23,0,12,344,113,44,45,300,114,19004
15000US060816009001,761,72,19,28,0,12,19,28,742,74,107,43,635,85,19005
15000US060816009002,626,80,26,25,26,25,0,12,600,80,86,57,514,80,19006
15000US060816010001,607,101,29,29,8,12,21,26,578,96,140,48,438,97,19007
15000US060816010002,522,85,6,11,6,11,0,12,516,85,63,41,453,88,19008
15000US060816010003,656,93,7,12,0,12,7,12,649,93,104,45,545,93,19009
15000US060816010004,199,51,0,12,0,12,0,12,199,51,40,30,159,52,19010
15000US060816011001,270,51,0,12,0,12,0,12,270,51,48,30,222,62,19011
15000US060816011002,297,65,0,12,0,12,0,12,297,65,15,19,282,65,19012
15000US060816011003,308,71,9,13,0,12,9,13,299,70,72,41,227,65,19013
15000US060816011004,496,76,16,25,0,12,16,25,480,78,146,67,334,80,19014
15000US060816011005,531,57,0,12,0,12,0,12,531,57,138,40,393,61,19015
15000US060816012001,754,155,20,31,0,12,20,31,734,154,54,56,680,162,19016
15000US060816012002,327,69,34,46,0,12,34,46,293,70,49,49,244,64,19017
15000US060816012003,484,136,25,31,14,23,11,19,459,140,32,32,427,140,19018
15000US060816012004,575,118,0,12,0,12,0,12,575,118,68,55,507,120,19019
15000US060816013001,425,110,44,63,0,12,44,63,381,102,145,80,236,100,19020
15000US060816013002,760,175,98,82,18,29,80,77,662,175,94,82,568,160,19021
15000US060816013003,603,168,186,126,34,41,152,127,417,126,164,87,253,111,19022
15000US060816013004,764,154,50,58,36,54,14,23,714,148,77,75,637,147,19023
15000US060816014001,486,139,35,45,0,12,35,45,451,135,145,97,306,102,19024
15000US060816014002,1092,141,121,95,68,77,53,52,971,162,155,98,816,167,19025
15000US060816014003,564,108,0,12,0,12,0,12,564,108,157,60,407,110,19026
15000US060816015011,563,91,18,28,0,12,18,28,545,92,62,41,483,105,19027
15000US060816015012,393,75,7,13,0,12,7,13,386,76,134,62,252,75,19028
15000US060816015013,398,67,0,12,0,12,0,12,398,67,142,63,256,67,19029
15000US060816015021,1155,102,38,37,0,12,38,37,1117,110,135,55,982,111,19030
15000US060816015022,603,77,75,46,18,20,57,42,528,80,76,40,452,80,19031
15000US060816016011,417,57,34,23,4,6,30,22,383,55,65,27,318,55,19032
15000US060816016012,457,53,34,24,28,22,6,9,423,54,167,60,256,50,19033
15000US060816016031,762,105,21,33,0,12,21,33,741,108,146,56,595,110,19034
15000US060816016032,500,85,0,12,0,12,0,12,500,85,145,58,355,80,19035
15000US060816016033,628,114,17,19,17,19,0,12,611,114,123,46,488,111,19036
15000US060816016041,1106,63,0,12,0,12,0,12,1106,63,177,66,929,94,19037
15000US060816016051,334,81,44,36,12,18,32,31,290,72,103,71,187,57,19038
15000US060816016052,316,68,0,12,0,12,0,12,316,68,79,43,237,83,19039
15000US060816016053,625,72,29,39,0,12,29,39,596,74,86,41,510,80,19040
15000US060816016054,483,80,11,17,11,17,0,12,472,83,71,40,401,87,19041
15000US060816017001,384,84,0,12,0,12,0,12,384,84,24,21,360,87,19042
15000US060816017002,513,72,19,21,19,21,0,12,494,72,125,53,369,69,19043
15000US060816017003,426,76,11,17,11,17,0,12,415,78,92,39,323,88,19044
15000US060816018001,1197,136,66,65,40,61,26,33,1131,143,377,151,754,153,19045
15000US060816018002,897,126,53,53,26,36,27,41,844,136,233,90,611,141,19046
15000US060816019011,348,76,30,27,30,27,0,12,318,72,120,61,198,74,19047
15000US060816019012,768,100,37,31,10,15,27,28,731,100,180,64,551,106,19048
15000US060816019013,276,61,0,12,0,12,0,12,276,61,36,29,240,64,19049
15000US060816019021,796,164,0,12,0,12,0,12,796,164,88,61,708,162,19050
15000US060816019022,257,67,0,12,0,12,0,12,257,67,45,43,212,73,19051
15000US060816019023,1119,135,37,43,8,16,29,41,1082,134,140,76,942,157,19052
15000US060816020001,859,129,0,12,0,12,0,12,859,129,192,100,667,133,19053
15000US060816020002,369,123,0,12,0,12,0,12,369,123,127,48,242,122,19054
15000US060816020003,269,104,0,12,0,12,0,12,269,104,30,27,239,103,19055
15000US060816020004,595,110,0,12,0,12,0,12,595,110,196,103,399,108,19056
15000US060816020005,350,95,0,12,0,12,0,12,350,95,104,75,246,95,19057
15000US060816021001,274,59,7,10,7,10,0,12,267,57,89,37,178,56,19058
15000US060816021002,328,63,26,33,6,9,20,31,302,68,27,17,275,69,19059
15000US060816021003,354,69,77,38,12,13,65,36,277,70,50,30,227,63,19060
15000US060816022001,443,137,40,47,40,47,0,12,403,132,124,113,279,103,19061
15000US060816022002,394,124,11,20,0,12,11,20,383,119,31,37,352,128,19062
15000US060816022003,822,152,92,85,36,57,56,64,730,170,47,48,683,171,19063
15000US060816022004,761,157,11,19,0,12,11,19,750,158,218,93,532,170,19064
15000US060816023001,1118,68,100,60,48,31,52,54,1018,92,242,92,776,113,19065
15000US060816024001,374,122,0,12,0,12,0,12,374,122,36,42,338,126,19066
15000US060816024002,700,116,14,23,14,23,0,12,686,113,134,85,552,124,19067
15000US060816024003,696,127,0,12,0,12,0,12,696,127,224,99,472,158,19068
15000US060816024004,906,152,12,21,12,21,0,12,894,153,300,120,594,149,19069
15000US060816025001,564,85,0,12,0,12,0,12,564,85,111,58,453,95,19070
15000US060816025002,414,85,6,9,6,9,0,12,408,85,142,55,266,81,19071
15000US060816025003,537,70,30,46,0,12,30,46,507,79,95,40,412,82,19072
15000US060816026001,361,75,14,23,0,12,14,23,347,77,47,43,300,79,19073
15000US060816026002,854,107,61,53,30,34,31,39,793,113,123,72,670,111,19074
15000US060816026003,753,124,0,12,0,12,0,12,753,124,146,79,607,131,19075
15000US060816026004,734,123,0,12,0,12,0,12,734,123,133,81,601,132,19076
15000US060816027001,325,82,0,12,0,12,0,12,325,82,28,24,297,80,19077
15000US060816027002,549,104,18,20,8,12,10,16,531,108,124,56,407,100,19078
15000US060816027003,468,85,0,12,0,12,0,12,468,85,83,56,385,89,19079
15000US060816027004,602,89,52,39,43,37,9,15,550,92,40,27,510,94,19080
15000US060816028001,276,60,12,15,0,12,12,15,264,61,18,19,246,61,19081
15000US060816028002,938,89,32,26,14,18,18,20,906,90,230,69,676,102,19082
15000US060816028003,285,58,9,15,0,12,9,15,276,57,34,28,242,61,19083
15000US060816029001,955,114,7,11,0,12,7,11,948,114,97,63,851,113,19084
15000US060816029002,619,91,14,21,14,21,0,12,605,92,115,53,490,104,19085
15000US060816030001,607,79,0,12,0,12,0,12,607,79,128,60,479,92,19086
15000US060816030002,358,78,0,12,0,12,0,12,358,78,45,35,313,76,19087
15000US060816030003,238,52,17,19,8,13,9,15,221,54,9,14,212,55,19088
15000US060816030004,625,93,21,20,17,19,4,6,604,94,57,40,547,93,19089
15000US060816031001,734,62,7,10,0,12,7,10,727,64,48,31,679,75,19090
15000US060816031002,493,58,0,12,0,12,0,12,493,58,126,50,367,65,19091
15000US060816032001,489,74,8,13,8,13,0,12,481,73,90,45,391,80,19092
15000US060816032002,221,61,0,12,0,12,0,12,221,61,52,37,169,55,19093
15000US060816032003,392,74,18,23,7,15,11,20,374,72,76,40,298,80,19094
15000US060816032004,255,57,0,12,0,12,0,12,255,57,16,20,239,55,19095
15000US060816033001,837,120,17,25,17,25,0,12,820,122,170,83,650,137,19096
15000US060816033002,772,114,11,19,11,19,0,12,761,116,126,62,635,124,19097
15000US060816033003,749,95,0,12,0,12,0,12,749,95,122,63,627,103,19098
15000US060816034001,539,125,0,12,0,12,0,12,539,125,60,40,479,126,19099
15000US060816034002,462,90,0,12,0,12,0,12,462,90,116,80,346,100,19100
15000US060816034003,583,107,76,76,18,29,58,86,507,90,185,74,322,108,19101
15000US060816034004,527,102,23,38,22,35,1,28,504,107,122,80,382,115,19102
15000US060816037001,847,110,0,12,0,12,0,12,847,110,138,59,709,110,19103
15000US060816037002,882,81,24,23,8,13,16,18,858,82,174,65,684,87,19104
15000US060816038011,1179,99,35,33,0,12,35,33,1144,102,146,77,998,131,19105
15000US060816038021,1166,97,13,19,0,12,13,19,1153,96,335,88,818,111,19106
15000US060816038022,706,87,0,12,0,12,0,12,706,87,108,61,598,91,19107
15000US060816039001,279,81,0,12,0,12,0,12,279,81,50,41,229,91,19108
15000US060816039002,517,120,10,16,10,16,0,12,507,123,118,98,389,116,19109
15000US060816039003,256,64,17,27,0,12,17,27,239,58,83,42,156,54,19110
15000US060816039004,261,61,19,31,0,12,19,31,242,66,79,47,163,61,19111
15000US060816039005,285,79,0,12,0,12,0,12,285,79,102,85,183,64,19112
15000US060816039006,491,98,0,12,0,12,0,12,491,98,41,47,450,102,19113
15000US060816040001,263,49,0,12,0,12,0,12,263,49,27,19,236,49,19114
15000US060816040002,391,66,0,12,0,12,0,12,391,66,108,56,283,63,19115
15000US060816040003,456,50,0,12,0,12,0,12,456,50,105,43,351,66,19116
15000US060816041011,543,136,92,84,0,12,92,84,451,136,64,77,387,120,19117
15000US060816041012,883,162,42,43,13,22,29,35,841,170,45,40,796,171,19118
15000US060816041013,1081,188,175,115,13,21,162,114,906,163,216,139,690,171,19119
15000US060816041021,1579,87,55,29,15,17,40,25,1524,86,203,64,1321,102,19120
15000US060816042001,291,82,0,12,0,12,0,12,291,82,78,45,213,78,19121
15000US060816042002,232,75,12,18,0,12,12,18,220,76,58,49,162,73,19122
15000US060816042003,587,94,66,49,23,27,43,44,521,95,89,46,432,103,19123
15000US060816044001,693,106,41,47,26,41,15,20,652,114,50,34,602,122,19124
15000US060816044002,430,73,0,12,0,12,0,12,430,73,83,43,347,66,19125
15000US060816044003,627,103,0,12,0,12,0,12,627,103,103,56,524,96,19126
15000US060816045001,236,63,6,10,0,12,6,10,230,64,58,43,172,59,19127
15000US060816045002,282,49,11,17,0,12,11,17,271,52,0,12,271,52,19128
15000US060816045003,781,81,7,11,0,12,7,11,774,81,213,64,561,82,19129
15000US060816046001,533,47,0,12,0,12,0,12,533,47,108,36,425,55,19130
15000US060816046002,421,46,0,12,0,12,0,12,421,46,61,25,360,49,19131
15000US060816047001,593,59,4,7,0,12,4,7,589,59,96,33,493,69,19132
15000US060816047002,361,53,0,12,0,12,0,12,361,53,30,20,331,54,19133
15000US060816048001,712,93,35,34,0,12,35,34,677,106,107,76,570,102,19134
15000US060816048002,506,91,17,26,0,12,17,26,489,99,144,67,345,92,19135
15000US060816048003,666,102,0,12,0,12,0,12,666,102,240,72,426,94,19136
15000US060816049001,687,63,0,12,0,12,0,12,687,63,106,48,581,72,19137
15000US060816049002,530,57,11,16,11,16,0,12,519,60,132,50,387,68,19138
15000US060816050001,909,138,0,12,0,12,0,12,909,138,163,84,746,147,19139
15000US060816050002,358,77,0,12,0,12,0,12,358,77,0,12,358,77,19140
15000US060816050003,959,104,0,12,0,12,0,12,959,104,170,77,789,129,19141
15000US060816050004,359,92,0,12,0,12,0,12,359,92,30,35,329,93,19142
15000US060816050005,310,78,0,12,0,12,0,12,310,78,26,31,284,77,19143
15000US060816051001,315,62,13,20,13,20,0,12,302,63,31,23,271,66,19144
15000US060816051002,1105,73,22,25,0,12,22,25,1083,75,180,76,903,96,19145
15000US060816052001,372,54,11,18,0,12,11,18,361,55,61,41,300,59,19146
15000US060816052002,365,50,0,12,0,12,0,12,365,50,29,27,336,54,19147
15000US060816052003,250,48,0,12,0,12,0,12,250,48,13,21,237,54,19148
15000US060816052004,275,45,0,12,0,12,0,12,275,45,22,23,253,50,19149
15000US060816053001,602,82,0,12,0,12,0,12,602,82,44,33,558,88,19150
15000US060816053002,614,82,27,27,20,23,7,13,587,82,106,46,481,84,19151
15000US060816053003,388,85,0,12,0,12,0,12,388,85,68,36,320,87,19152
15000US060816053004,241,57,0,12,0,12,0,12,241,57,23,23,218,62,19153
15000US060816054001,297,63,0,12,0,12,0,12,297,63,61,42,236,78,19154
15000US060816054002,387,91,13,22,0,12,13,22,374,94,93,84,281,71,19155
15000US060816054003,653,144,15,25,15,25,0,12,638,143,83,54,555,153,19156
15000US060816054004,427,92,16,25,0,12,16,25,411,93,43,39,368,96,19157
15000US060816054005,677,144,14,23,14,23,0,12,663,141,35,29,628,148,19158
15000US060816055001,1674,149,38,42,19,31,19,32,1636,151,146,70,1490,162,19159
15000US060816055002,309,95,17,26,17,26,0,12,292,95,28,31,264,93,19160
15000US060816055003,768,157,0,12,0,12,0,12,768,157,115,81,653,151,19161
15000US060816056001,314,53,0,12,0,12,0,12,314,53,32,29,282,55,19162
15000US060816056002,332,61,0,12,0,12,0,12,332,61,92,49,240,64,19163
15000US060816056003,377,74,0,12,0,12,0,12,377,74,50,28,327,75,19164
15000US060816056004,911,86,0,12,0,12,0,12,911,86,194,65,717,96,19165
15000US060816057001,332,67,0,12,0,12,0,12,332,67,48,34,284,71,19166
15000US060816057002,447,70,0,12,0,12,0,12,447,70,67,40,380,74,19167
15000US060816057003,531,66,10,17,10,17,0,12,521,66,96,46,425,70,19168
15000US060816057004,461,67,0,12,0,12,0,12,461,67,34,30,427,72,19169
15000US060816058001,248,55,0,12,0,12,0,12,248,55,54,30,194,54,19170
15000US060816058002,426,63,0,12,0,12,0,12,426,63,81,46,345,67,19171
15000US060816058003,298,57,0,12,0,12,0,12,298,57,58,36,240,54,19172
15000US060816059001,968,133,28,33,28,33,0,12,940,135,237,93,703,126,19173
15000US060816059002,697,126,87,91,0,12,87,91,610,120,111,64,499,122,19174
15000US060816059003,920,143,23,32,19,30,4,9,897,144,167,92,730,142,19175
15000US060816060001,1196,172,43,67,0,12,43,67,1153,184,198,104,955,187,19176
15000US060816060002,928,174,281,131,34,53,247,110,647,156,70,50,577,162,19177
15000US060816061001,549,92,0,12,0,12,0,12,549,92,39,29,510,96,19178
15000US060816061002,401,79,11,19,11,19,0,12,390,77,85,64,305,70,19179
15000US060816061003,360,78,47,47,18,29,29,35,313,91,50,40,263,90,19180
15000US060816062001,608,171,84,97,25,31,59,89,524,159,10,18,514,157,19181
15000US060816062002,664,157,195,110,95,76,100,87,469,139,147,73,322,141,19182
15000US060816062003,441,125,55,70,55,70,0,12,386,122,109,85,277,114,19183
15000US060816062004,543,109,38,59,0,12,38,59,505,107,57,51,448,104,19184
15000US060816063001,649,78,46,35,15,17,31,30,603,86,118,55,485,83,19185
15000US060816063002,470,89,8,13,0,12,8,13,462,87,119,44,343,97,19186
15000US060816063003,712,89,63,58,0,12,63,58,649,91,148,50,501,94,19187
15000US060816064001,620,133,8,15,0,12,8,15,612,133,30,34,582,140,19188
15000US060816064002,281,67,0,12,0,12,0,12,281,67,50,36,231,72,19189
15000US060816064003,651,148,0,12,0,12,0,12,651,148,197,106,454,113,19190
15000US060816064004,978,156,21,36,0,12,21,36,957,163,135,85,822,166,19191
15000US060816065001,206,38,0,12,0,12,0,12,206,38,17,19,189,43,19192
15000US060816065002,369,51,11,16,11,16,0,12,358,53,36,30,322,58,19193
15000US060816065003,301,49,0,12,0,12,0,12,301,49,31,23,270,56,19194
15000US060816065004,375,61,0,12,0,12,0,12,375,61,65,34,310,58,19195
15000US060816066001,504,68,26,29,0,12,26,29,478,68,120,46,358,68,19196
15000US060816066002,452,68,11,19,11,19,0,12,441,66,42,25,399,70,19197
15000US060816066003,496,64,0,12,0,12,0,12,496,64,107,49,389,67,19198
15000US060816067001,309,35,0,12,0,12,0,12,309,35,58,27,251,39,19199
15000US060816067002,646,49,0,12,0,12,0,12,646,49,108,31,538,54,19200
15000US060816068001,458,52,0,12,0,12,0,12,458,52,78,37,380,64,19201
15000US060816068002,811,72,0,12,0,12,0,12,811,72,80,44,731,81,19202
15000US060816069001,303,40,5,7,0,12,5,7,298,41,35,22,263,40,19203
15000US060816069002,614,43,0,12,0,12,0,12,614,43,106,39,508,54,19204
15000US060816070001,275,57,0,12,0,12,0,12,275,57,25,40,250,50,19205
15000US060816070002,1109,67,24,27,16,24,8,13,1085,76,131,51,954,85,19206
15000US060816071001,300,55,0,12,0,12,0,12,300,55,72,42,228,67,19207
15000US060816071002,386,52,0,12,0,12,0,12,386,52,89,40,297,54,19208
15000US060816071003,393,53,0,12,0,12,0,12,393,53,95,51,298,55,19209
15000US060816072001,976,86,16,24,0,12,16,24,960,91,145,71,815,112,19210
15000US060816072002,742,80,0,12,0,12,0,12,742,80,183,76,559,92,19211
15000US060816073001,434,44,0,12,0,12,0,12,434,44,33,22,401,49,19212
15000US060816073002,696,74,0,12,0,12,0,12,696,74,140,62,556,75,19213
15000US060816073003,197,37,0,12,0,12,0,12,197,37,40,26,157,39,19214
15000US060816074001,875,101,11,17,0,12,11,17,864,99,84,45,780,93,19215
15000US060816074002,302,85,54,75,0,12,54,75,248,64,66,40,182,56,19216
15000US060816074003,709,94,21,23,11,16,10,14,688,96,272,87,416,104,19217
15000US060816075001,1606,77,97,48,12,17,85,45,1509,92,200,64,1309,108,19218
15000US060816076001,358,51,0,12,0,12,0,12,358,51,36,34,322,53,19219
15000US060816076002,289,64,22,34,22,34,0,12,267,61,24,23,243,64,19220
15000US060816076003,325,61,8,12,8,12,0,12,317,65,13,14,304,64,19221
15000US060816076004,287,67,0,12,0,12,0,12,287,67,53,30,234,66,19222
15000US060816077011,551,81,42,55,33,53,9,15,509,94,106,63,403,85,19223
15000US060816077012,191,54,0,12,0,12,0,12,191,54,50,28,141,51,19224
15000US060816077013,443,66,47,49,0,12,47,49,396,77,81,54,315,72,19225
15000US060816077021,429,42,6,9,6,9,0,12,423,42,119,43,304,48,19226
15000US060816077022,369,45,29,25,11,14,18,18,340,48,111,36,229,51,19227
15000US060816078001,502,52,8,10,0,12,8,10,494,51,80,27,414,54,19228
15000US060816078002,488,47,35,32,7,11,28,31,453,52,82,30,371,59,19229
15000US060816079001,513,58,0,12,0,12,0,12,513,58,95,42,418,67,19230
15000US060816079002,450,76,11,17,0,12,11,17,439,74,50,30,389,76,19231
15000US060816079003,695,85,9,16,0,12,9,16,686,87,65,36,621,92,19232
15000US060816080011,855,82,8,13,8,13,0,12,847,83,63,37,784,92,19233
15000US060816080012,751,91,0,12,0,12,0,12,751,91,94,63,657,108,19234
15000US060816080021,778,88,0,12,0,12,0,12,778,88,125,59,653,100,19235
15000US060816080022,308,56,0,12,0,12,0,12,308,56,50,27,258,59,19236
15000US060816080023,278,55,9,12,0,12,9,12,269,56,17,20,252,54,19237
15000US060816080041,700,157,44,50,0,12,44,50,656,165,36,43,620,168,19238
15000US060816080042,585,92,0,12,0,12,0,12,585,92,89,60,496,94,19239
15000US060816080043,912,153,0,12,0,12,0,12,912,153,14,23,898,156,19240
15000US060816080044,944,131,0,12,0,12,0,12,944,131,70,55,874,136,19241
15000US060816080131,846,76,12,18,0,12,12,18,834,75,105,51,729,86,19242
15000US060816080132,416,78,0,12,0,12,0,12,416,78,22,24,394,81,19243
15000US060816080133,423,69,0,12,0,12,0,12,423,69,9,15,414,68,19244
15000US060816080231,300,44,0,12,0,12,0,12,300,44,35,18,265,45,19245
15000US060816080232,608,36,13,17,13,17,0,12,595,37,54,27,541,40,19246
15000US060816081001,1437,42,39,57,39,57,0,12,1398,73,265,78,1133,90,19247
15000US060816082001,1349,64,21,24,15,22,6,11,1328,71,198,63,1130,83,19248
15000US060816083001,731,68,0,12,0,12,0,12,731,68,83,51,648,85,19249
15000US060816083002,685,78,0,12,0,12,0,12,685,78,82,42,603,84,19250
15000US060816084001,971,135,60,69,23,36,37,59,911,145,120,66,791,156,19251
15000US060816084002,750,135,70,81,27,45,43,69,680,131,75,77,605,122,19252
15000US060816084003,454,144,69,70,13,20,56,67,385,132,107,66,278,141,19253
15000US060816085011,373,62,0,12,0,12,0,12,373,62,87,40,286,67,19254
15000US060816085012,576,86,0,12,0,12,0,12,576,86,115,54,461,86,19255
15000US060816085013,385,63,22,23,22,23,0,12,363,62,11,17,352,64,19256
15000US060816085014,324,61,9,15,9,15,0,12,315,60,73,40,242,67,19257
15000US060816085021,1180,54,33,28,28,25,5,11,1147,60,96,46,1051,75,19258
15000US060816086001,310,51,22,19,15,15,7,11,288,55,69,33,219,62,19259
15000US060816086002,366,44,11,18,0,12,11,18,355,45,61,34,294,46,19260
15000US060816086003,1029,89,20,22,0,12,20,22,1009,90,134,59,875,96,19261
15000US060816087001,632,87,27,32,0,12,27,32,605,93,38,37,567,93,19262
15000US060816087002,597,101,0,12,0,12,0,12,597,101,40,41,557,101,19263
15000US060816087003,390,93,14,22,0,12,14,22,376,91,102,64,274,74,19264
15000US060816087004,351,71,0,12,0,12,0,12,351,71,110,70,241,70,19265
15000US060816087005,637,99,0,12,0,12,0,12,637,99,119,82,518,108,19266
15000US060816088001,495,90,12,20,12,20,0,12,483,91,85,49,398,111,19267
15000US060816088002,432,89,0,12,0,12,0,12,432,89,100,80,332,87,19268
15000US060816088003,223,62,0,12,0,12,0,12,223,62,49,44,174,55,19269
15000US060816088004,336,66,0,12,0,12,0,12,336,66,48,38,288,66,19270
15000US060816088005,614,89,33,47,33,47,0,12,581,94,147,66,434,91,19271
15000US060816089001,433,82,0,12,0,12,0,12,433,82,45,43,388,88,19272
15000US060816089002,905,156,0,12,0,12,0,12,905,156,179,110,726,141,19273
15000US060816089003,1347,155,18,29,18,29,0,12,1329,159,173,80,1156,176,19274
15000US060816089004,259,60,0,12,0,12,0,12,259,60,87,52,172,70,19275
15000US060816090001,423,75,8,14,8,14,0,12,415,73,88,54,327,70,19276
15000US060816090002,530,73,0,12,0,12,0,12,530,73,121,67,409,67,19277
15000US060816091001,293,51,26,24,0,12,26,24,267,43,53,25,214,42,19278
15000US060816091002,275,33,16,22,0,12,16,22,259,35,39,20,220,39,19279
15000US060816092011,453,58,9,13,9,13,0,12,444,59,76,41,368,64,19280
15000US060816092012,570,80,0,12,0,12,0,12,570,80,135,59,435,85,19281
15000US060816092013,565,58,52,34,24,26,28,35,513,63,102,54,411,68,19282
15000US060816092021,658,102,0,12,0,12,0,12,658,102,59,32,599,101,19283
15000US060816092022,1287,101,38,31,22,25,16,18,1249,101,143,71,1106,109,19284
15000US060816093001,557,63,8,12,8,12,0,12,549,63,71,38,478,71,19285
15000US060816093002,691,58,0,12,0,12,0,12,691,58,105,48,586,73,19286
15000US060816094001,1113,53,0,12,0,12,0,12,1113,53,202,83,911,81,19287
15000US060816095001,664,76,0,12,0,12,0,12,664,76,56,34,608,83,19288
15000US060816095002,1078,70,0,12,0,12,0,12,1078,70,148,44,930,81,19289
15000US060816096011,1168,58,32,37,0,12,32,37,1136,69,115,49,1021,77,19290
15000US060816096021,678,23,0,12,0,12,0,12,678,23,113,36,565,42,19291
15000US060816096031,708,97,0,12,0,12,0,12,708,97,52,47,656,100,19292
15000US060816096032,525,83,0,12,0,12,0,12,525,83,222,68,303,77,19293
15000US060816096033,498,88,0,12,0,12,0,12,498,88,105,63,393,105,19294
15000US060816096034,250,82,0,12,0,12,0,12,250,82,18,28,232,78,19295
15000US060816097001,753,74,0,12,0,12,0,12,753,74,107,47,646,76,19296
15000US060816097002,925,69,0,12,0,12,0,12,925,69,159,57,766,74,19297
15000US060816098001,343,60,8,13,8,13,0,12,335,60,9,15,326,58,19298
15000US060816098002,616,76,8,13,0,12,8,13,608,77,69,39,539,81,19299
15000US060816098003,266,50,0,12,0,12,0,12,266,50,59,38,207,54,19300
15000US060816098004,469,68,0,12,0,12,0,12,469,68,57,35,412,69,19301
15000US060816099001,408,51,0,12,0,12,0,12,408,51,72,41,336,52,19302
15000US060816099002,674,72,0,12,0,12,0,12,674,72,78,41,596,73,19303
15000US060816100001,1019,92,0,12,0,12,0,12,1019,92,136,54,883,97,19304
15000US060816100002,416,68,0,12,0,12,0,12,416,68,109,48,307,73,19305
15000US060816100003,638,89,0,12,0,12,0,12,638,89,85,71,553,102,19306
15000US060816101001,925,44,28,26,0,12,28,26,897,51,126,46,771,66,19307
15000US060816102011,393,92,150,70,49,50,101,67,243,73,39,46,204,61,19308
15000US060816102012,402,83,63,61,0,12,63,61,339,73,124,70,215,57,19309
15000US060816102013,286,77,32,38,0,12,32,38,254,77,17,20,237,74,19310
15000US060816102014,689,105,43,36,0,12,43,36,646,102,126,55,520,114,19311
15000US060816102021,828,74,86,49,18,29,68,38,742,86,145,50,597,89,19312
15000US060816102031,383,61,73,43,9,15,64,41,310,62,51,26,259,57,19313
15000US060816102032,657,64,128,49,45,31,83,44,529,60,81,34,448,59,19314
15000US060816103021,923,56,25,18,20,15,5,9,898,58,162,55,736,76,19315
15000US060816103031,656,115,0,12,0,12,0,12,656,115,56,57,600,124,19316
15000US060816103032,520,84,0,12,0,12,0,12,520,84,81,50,439,96,19317
15000US060816103033,1183,123,0,12,0,12,0,12,1183,123,16,27,1167,124,19318
15000US060816103034,894,129,0,12,0,12,0,12,894,129,80,62,814,127,19319
15000US060816103041,777,96,0,12,0,12,0,12,777,96,84,37,693,99,19320
15000US060816103042,784,84,21,24,12,19,9,15,763,83,88,46,675,85,19321
15000US060816103043,337,68,0,12,0,12,0,12,337,68,68,47,269,53,19322
15000US060816104001,927,125,49,40,40,36,9,14,878,129,228,105,650,139,19323
15000US060816104002,771,116,128,74,21,23,107,71,643,99,151,57,492,94,19324
15000US060816105001,334,92,63,48,9,14,54,45,271,85,33,31,238,87,19325
15000US060816105002,357,87,68,51,18,24,50,43,289,75,38,28,251,76,19326
15000US060816105003,152,62,21,25,9,14,12,21,131,65,15,17,116,68,19327
15000US060816105004,535,98,6,14,0,12,6,14,529,100,55,33,474,107,19328
15000US060816106011,554,112,146,75,17,20,129,72,408,104,72,46,336,108,19329
15000US060816106012,603,124,10,15,0,12,10,15,593,123,129,59,464,130,19330
15000US060816106013,520,116,50,43,18,22,32,39,470,117,48,35,422,120,19331
15000US060816106021,324,60,0,12,0,12,0,12,324,60,33,28,291,62,19332
15000US060816106022,330,52,0,12,0,12,0,12,330,52,67,35,263,55,19333
15000US060816106023,561,77,35,55,0,12,35,55,526,86,105,40,421,92,19334
15000US060816107001,1035,156,43,48,0,12,43,48,992,164,308,114,684,165,19335
15000US060816107002,1128,160,60,58,18,28,42,63,1068,165,144,101,924,172,19336
15000US060816108001,807,123,2,16,0,12,2,16,805,124,34,28,771,126,19337
15000US060816108002,881,118,33,34,12,19,21,26,848,122,213,81,635,131,19338
15000US060816109001,725,112,78,74,21,20,57,69,647,133,206,84,441,137,19339
15000US060816109002,1005,149,71,56,31,35,40,45,934,157,110,105,824,159,19340
15000US060816109003,409,126,15,26,0,12,15,26,394,128,11,18,383,127,19341
15000US060816109004,404,76,26,42,26,42,0,12,378,88,103,72,275,88,19342
15000US060816110001,521,110,0,12,0,12,0,12,521,110,63,52,458,122,19343
15000US060816110002,470,78,0,12,0,12,0,12,470,78,74,43,396,78,19344
15000US060816110003,359,74,0,12,0,12,0,12,359,74,57,46,302,74,19345
15000US060816110004,970,116,0,12,0,12,0,12,970,116,159,83,811,136,19346
15000US060816111001,947,115,17,25,17,25,0,12,930,114,261,87,669,118,19347
15000US060816111002,781,124,0,12,0,12,0,12,781,124,200,124,581,121,19348
15000US060816111003,597,112,0,12,0,12,0,12,597,112,95,71,502,115,19349
15000US060816112001,1061,59,16,23,6,11,10,19,1045,61,225,63,820,91,19350
15000US060816113001,571,76,0,12,0,12,0,12,571,76,28,24,543,81,19351
15000US060816113002,730,81,44,39,9,13,35,33,686,80,172,66,514,74,19352
15000US060816113003,237,45,0,12,0,12,0,12,237,45,53,32,184,51,19353
15000US060816113004,481,86,4,8,0,12,4,8,477,83,50,33,427,86,19354
15000US060816114001,225,42,0,12,0,12,0,12,225,42,40,33,185,49,19355
15000US060816114002,261,72,0,12,0,12,0,12,261,72,21,24,240,73,19356
15000US060816114003,459,78,0,12,0,12,0,12,459,78,109,56,350,78,19357
15000US060816114004,466,73,15,19,0,12,15,19,451,72,64,42,387,78,19358
15000US060816115001,215,36,0,12,0,12,0,12,215,36,29,18,186,39,19359
15000US060816115002,343,58,0,12,0,12,0,12,343,58,57,27,286,55,19360
15000US060816115003,362,39,4,7,0,12,4,7,358,41,105,40,253,44,19361
15000US060816116001,419,51,0,12,0,12,0,12,419,51,62,39,357,56,19362
15000US060816116002,374,42,0,12,0,12,0,12,374,42,74,36,300,41,19363
15000US060816117001,518,87,130,67,8,13,122,66,388,78,141,46,247,75,19364
15000US060816117002,478,88,59,37,33,28,26,26,419,97,45,24,374,96,19365
15000US060816117003,375,77,82,52,12,20,70,50,293,81,66,29,227,80,19366
15000US060816117004,0,12,0,12,0,12,0,12,0,12,0,12,0,12,19367
15000US060816118001,387,55,68,37,23,19,45,31,319,59,129,47,190,49,19368
15000US060816118002,445,61,102,33,36,21,66,32,343,56,88,39,255,59,19369
15000US060816119001,438,149,86,79,0,12,86,79,352,148,0,12,352,148,19370
15000US060816119002,364,113,85,76,39,52,46,58,279,93,58,42,221,88,19371
15000US060816119003,281,93,0,12,0,12,0,12,281,93,45,47,236,91,19372
15000US060816119004,298,122,0,12,0,12,0,12,298,122,53,42,245,118,19373
15000US060816119005,726,158,72,71,58,66,14,22,654,147,70,55,584,139,19374
15000US060816119006,530,120,25,40,0,12,25,40,505,120,117,85,388,131,19375
15000US060816120001,358,90,58,49,9,15,49,46,300,91,42,38,258,93,19376
15000US060816120002,561,110,122,87,50,59,72,66,439,120,93,57,346,116,19377
15000US060816120003,265,81,25,26,11,20,14,16,240,82,53,40,187,81,19378
15000US060816120004,358,91,58,61,0,12,58,61,300,84,106,59,194,76,19379
15000US060816121001,406,90,0,12,0,12,0,12,406,90,54,45,352,102,19380
15000US060816121002,718,134,79,62,0,12,79,62,639,128,112,81,527,123,19381
15000US060816121003,498,133,37,59,0,12,37,59,461,133,108,65,353,124,19382
15000US060816121004,253,113,124,102,75,84,49,58,129,73,32,47,97,69,19383
15000US060816121005,869,193,150,108,0,12,150,108,719,191,132,106,587,192,19384
15000US060816125001,514,109,0,12,0,12,0,12,514,109,39,38,475,104,19385
15000US060816125002,430,110,0,12,0,12,0,12,430,110,77,66,353,105,19386
15000US060816125003,926,132,0,12,0,12,0,12,926,132,90,73,836,145,19387
15000US060816126001,401,90,0,12,0,12,0,12,401,90,95,62,306,81,19388
15000US060816126002,708,117,0,12,0,12,0,12,708,117,34,33,674,118,19389
15000US060816126003,432,96,30,26,14,24,16,27,402,97,96,78,306,74,19390
15000US060816126004,477,102,0,12,0,12,0,12,477,102,0,12,477,102,19391
15000US060816127001,324,33,13,20,13,20,0,12,311,33,24,17,287,35,19392
15000US060816127002,409,40,0,12,0,12,0,12,409,40,77,22,332,42,19393
15000US060816128001,542,51,0,12,0,12,0,12,542,51,109,45,433,56,19394
15000US060816128002,443,56,11,17,0,12,11,17,432,58,59,34,373,61,19395
15000US060816129001,620,63,0,12,0,12,0,12,620,63,105,48,515,68,19396
15000US060816129002,251,40,0,12,0,12,0,12,251,40,35,31,216,40,19397
15000US060816129003,299,48,0,12,0,12,0,12,299,48,56,32,243,56,19398
15000US060816129004,547,86,0,12,0,12,0,12,547,86,120,52,427,83,19399
15000US060816130001,712,87,0,12,0,12,0,12,712,87,77,37,635,86,19400
15000US060816130002,707,86,32,40,0,12,32,40,675,84,134,49,541,87,19401
15000US060816132001,564,90,0,12,0,12,0,12,564,90,52,47,512,102,19402
15000US060816132002,576,89,0,12,0,12,0,12,576,89,121,79,455,88,19403
15000US060816132003,460,78,0,12,0,12,0,12,460,78,115,52,345,81,19404
15000US060816132004,772,113,0,12,0,12,0,12,772,113,215,76,557,131,19405
15000US060816132005,250,61,0,12,0,12,0,12,250,61,59,36,191,61,19406
15000US060816133001,567,60,0,12,0,12,0,12,567,60,119,45,448,66,19407
15000US060816133002,379,62,0,12,0,12,0,12,379,62,68,28,311,60,19408
15000US060816134001,414,63,0,12,0,12,0,12,414,63,49,33,365,69,19409
15000US060816134002,244,47,0,12,0,12,0,12,244,47,42,24,202,46,19410
15000US060816134003,501,66,0,12,0,12,0,12,501,66,75,41,426,66,19411
15000US060816135011,826,104,41,65,0,12,41,65,785,113,167,65,618,116,19412
15000US060816135012,812,101,19,31,0,12,19,31,793,102,239,94,554,120,19413
15000US060816135021,709,147,0,12,0,12,0,12,709,147,97,74,612,150,19414
15000US060816135022,431,96,0,12,0,12,0,12,431,96,49,36,382,96,19415
15000US060816135023,587,156,31,37,0,12,31,37,556,156,58,76,498,137,19416
15000US060816135024,608,173,16,25,0,12,16,25,592,172,44,43,548,174,19417
15000US060816136001,1067,158,0,12,0,12,0,12,1067,158,238,117,829,172,19418
15000US060816136002,619,115,0,12,0,12,0,12,619,115,58,84,561,124,19419
15000US060816136003,350,90,0,12,0,12,0,12,350,90,82,62,268,91,19420
15000US060816136004,261,93,75,73,19,31,56,64,186,70,64,53,122,67,19421
15000US060816137001,1135,174,108,109,28,47,80,100,1027,151,244,102,783,174,19422
15000US060816137002,295,105,0,12,0,12,0,12,295,105,55,45,240,110,19423
15000US060816137003,379,127,18,30,0,12,18,30,361,129,116,107,245,101,19424
15000US060816137004,795,137,0,12,0,12,0,12,795,137,179,112,616,111,19425
15000US060816137005,1102,154,37,40,18,29,19,29,1065,158,180,89,885,169,19426
15000US060816138001,267,79,0,12,0,12,0,12,267,79,8,13,259,80,19427
15000US060816138002,262,81,8,15,0,12,8,15,254,79,20,24,234,77,19428
15000US060816138003,356,103,0,12,0,12,0,12,356,103,130,73,226,82,19429
15000US060816138004,496,120,42,43,0,12,42,43,454,112,118,72,336,105,19430
15000US060816139001,235,67,0,12,0,12,0,12,235,67,0,12,235,67,19431
15000US060816139002,324,92,0,12,0,12,0,12,324,92,41,41,283,85,19432
15000US060816139003,508,104,0,12,0,12,0,12,508,104,57,43,451,112,19433
15000US060816139004,217,54,0,12,0,12,0,12,217,54,76,51,141,54,19434
15000US060816139005,785,130,32,43,22,41,10,16,753,138,112,64,641,135,19435
15000US060816140001,930,85,19,21,0,12,19,21,911,86,112,39,799,92,19436
15000US060816140002,427,64,40,38,28,36,12,18,387,66,32,23,355,67,19437
15000US060816140003,308,59,0,12,0,12,0,12,308,59,114,63,194,51,19438
15000US060819843001,0,12,0,12,0,12,0,12,0,12,0,12,0,12,19439
15000US060819901000,0,12,0,12,0,12,0,12,0,12,0,12,0,12,19440
15000US060830001011,1189,168,89,93,0,12,89,93,1100,159,302,107,798,168,19441
15000US060830001012,420,95,14,21,14,21,0,12,406,99,99,60,307,91,19442
15000US060830001013,437,126,0,12,0,12,0,12,437,126,103,76,334,133,19443
15000US060830001014,315,124,0,12,0,12,0,12,315,124,89,92,226,111,19444
15000US060830001021,628,92,16,26,16,26,0,12,612,90,103,62,509,97,19445
15000US060830001022,192,66,26,31,12,21,14,22,166,60,0,12,166,60,19446
15000US060830001023,556,122,0,12,0,12,0,12,556,122,75,65,481,110,19447
15000US060830001024,744,133,0,12,0,12,0,12,744,133,214,120,530,135,19448
15000US060830001031,295,50,0,12,0,12,0,12,295,50,67,39,228,48,19449
15000US060830001032,588,95,8,13,0,12,8,13,580,98,63,34,517,95,19450
15000US060830001033,293,54,0,12,0,12,0,12,293,54,86,35,207,56,19451
15000US060830002001,498,145,0,12,0,12,0,12,498,145,137,91,361,127,19452
15000US060830002002,509,111,0,12,0,12,0,12,509,111,154,76,355,106,19453
15000US060830002003,1029,153,0,12,0,12,0,12,1029,153,195,98,834,152,19454
15000US060830003011,373,74,17,26,0,12,17,26,356,69,29,27,327,79,19455
15000US060830003012,461,87,0,12,0,12,0,12,461,87,109,55,352,84,19456
15000US060830003013,439,92,52,45,7,10,45,45,387,83,39,27,348,86,19457
15000US060830003021,249,67,0,12,0,12,0,12,249,67,7,12,242,68,19458
15000US060830003022,347,90,35,49,6,10,29,48,312,85,26,24,286,88,19459
15000US060830003023,535,105,9,14,0,12,9,14,526,105,84,36,442,109,19460
15000US060830003024,348,82,10,15,0,12,10,15,338,85,38,43,300,84,19461
15000US060830003025,331,97,0,12,0,12,0,12,331,97,116,63,215,92,19462
15000US060830004001,452,96,0,12,0,12,0,12,452,96,147,74,305,96,19463
15000US060830004002,345,97,0,12,0,12,0,12,345,97,77,54,268,102,19464
15000US060830004003,542,122,0,12,0,12,0,12,542,122,61,52,481,111,19465
15000US060830004004,388,79,0,12,0,12,0,12,388,79,26,31,362,85,19466
15000US060830004005,734,136,0,12,0,12,0,12,734,136,42,40,692,136,19467
15000US060830005011,390,48,0,12,0,12,0,12,390,48,56,33,334,54,19468
15000US060830005012,546,90,0,12,0,12,0,12,546,90,79,67,467,76,19469
15000US060830005013,428,60,0,12,0,12,0,12,428,60,43,29,385,63,19470
15000US060830005021,306,72,0,12,0,12,0,12,306,72,57,41,249,79,19471
15000US060830005022,385,80,21,35,0,12,21,35,364,78,32,38,332,76,19472
15000US060830005023,220,68,0,12,0,12,0,12,220,68,15,24,205,72,19473
15000US060830005024,406,91,0,12,0,12,0,12,406,91,49,44,357,102,19474
15000US060830005025,288,76,21,34,0,12,21,34,267,77,24,27,243,74,19475
15000US060830005026,859,112,36,58,0,12,36,58,823,111,122,70,701,117,19476
15000US060830006001,222,65,0,12,0,12,0,12,222,65,26,28,196,67,19477
15000US060830006002,510,128,0,12,0,12,0,12,510,128,67,46,443,138,19478
15000US060830006003,286,101,0,12,0,12,0,12,286,101,44,41,242,103,19479
15000US060830006004,400,105,0,12,0,12,0,12,400,105,36,40,364,106,19480
15000US060830006005,532,103,25,28,0,12,25,28,507,108,129,85,378,129,19481
15000US060830006006,248,71,0,12,0,12,0,12,248,71,15,24,233,70,19482
15000US060830007001,455,84,0,12,0,12,0,12,455,84,72,70,383,89,19483
15000US060830007002,422,70,6,10,6,10,0,12,416,69,58,34,358,68,19484
15000US060830007003,379,61,0,12,0,12,0,12,379,61,111,47,268,59,19485
15000US060830007004,807,100,18,27,0,12,18,27,789,97,157,85,632,98,19486
15000US060830008011,245,66,26,37,26,37,0,12,219,67,25,33,194,71,19487
15000US060830008012,473,85,26,31,0,12,26,31,447,82,132,54,315,88,19488
15000US060830008013,427,70,6,10,0,12,6,10,421,71,50,28,371,71,19489
15000US060830008041,379,113,0,12,0,12,0,12,379,113,45,40,334,106,19490
15000US060830008042,357,93,39,49,0,12,39,49,318,94,82,69,236,103,19491
15000US060830008043,426,127,27,37,0,12,27,37,399,123,45,41,354,124,19492
15000US060830008044,406,95,21,32,21,32,0,12,385,92,127,68,258,92,19493
15000US060830008045,378,92,88,66,7,13,81,64,290,96,67,45,223,89,19494
15000US060830009001,966,157,69,60,50,53,19,25,897,148,259,98,638,130,19495
15000US060830009002,715,135,0,12,0,12,0,12,715,135,160,83,555,136,19496
15000US060830010001,483,162,0,12,0,12,0,12,483,162,134,90,349,144,19497
15000US060830010002,378,114,0,12,0,12,0,12,378,114,49,47,329,115,19498
15000US060830010003,584,173,18,28,0,12,18,28,566,173,68,78,498,191,19499
15000US060830010004,740,158,0,12,0,12,0,12,740,158,218,112,522,145,19500
15000US060830010005,636,155,0,12,0,12,0,12,636,155,129,101,507,149,19501
15000US060830011011,652,118,117,86,43,54,74,66,535,127,127,77,408,124,19502
15000US060830011012,444,91,74,70,13,21,61,67,370,92,34,37,336,96,19503
15000US060830011013,251,85,89,73,24,36,65,65,162,63,0,12,162,63,19504
15000US060830011014,247,79,0,12,0,12,0,12,247,79,25,18,222,78,19505
15000US060830011021,479,84,68,63,0,12,68,63,411,81,87,49,324,70,19506
15000US060830011022,589,109,74,63,49,51,25,38,515,105,130,63,385,95,19507
15000US060830011023,249,73,55,49,55,49,0,12,194,57,104,54,90,53,19508
15000US060830012031,314,75,24,34,0,12,24,34,290,76,38,41,252,69,19509
15000US060830012032,917,79,47,48,20,21,27,43,870,90,180,67,690,89,19510
15000US060830012061,557,112,8,14,8,14,0,12,549,110,26,23,523,109,19511
15000US060830012062,528,101,21,36,0,12,21,36,507,96,66,47,441,99,19512
15000US060830012063,529,112,0,12,0,12,0,12,529,112,97,69,432,121,19513
15000US060830012081,444,104,0,12,0,12,0,12,444,104,110,68,334,98,19514
15000US060830012082,345,78,10,12,10,12,0,12,335,79,51,31,284,88,19515
15000US060830012083,279,57,0,12,0,12,0,12,279,57,91,53,188,52,19516
15000US060830012084,239,64,0,12,0,12,0,12,239,64,12,13,227,66,19517
15000US060830012085,338,70,15,20,0,12,15,20,323,70,50,40,273,69,19518
15000US060830013041,315,136,0,12,0,12,0,12,315,136,102,106,213,106,19519
15000US060830013042,293,87,0,12,0,12,0,12,293,87,99,71,194,74,19520
15000US060830013043,397,95,0,12,0,12,0,12,397,95,63,48,334,100,19521
15000US060830013044,404,139,0,12,0,12,0,12,404,139,13,20,391,139,19522
15000US060830013045,176,99,17,28,17,28,0,12,159,100,105,78,54,58,19523
15000US060830013046,289,84,42,58,0,12,42,58,247,81,61,44,186,95,19524
15000US060830013047,279,89,0,12,0,12,0,12,279,89,43,49,236,82,19525
15000US060830013048,337,94,46,70,0,12,46,70,291,98,36,43,255,99,19526
15000US060830013049,357,128,0,12,0,12,0,12,357,128,27,30,330,126,19527
15000US060830013061,557,66,12,18,0,12,12,18,545,68,84,44,461,65,19528
15000US060830013062,383,63,0,12,0,12,0,12,383,63,65,39,318,75,19529
15000US060830013063,560,68,42,45,8,12,34,44,518,76,200,67,318,65,19530
15000US060830014021,430,110,0,12,0,12,0,12,430,110,100,59,330,112,19531
15000US060830014022,390,79,9,13,9,13,0,12,381,79,96,38,285,79,19532
15000US060830014023,308,78,0,12,0,12,0,12,308,78,47,31,261,73,19533
15000US060830014024,242,80,32,50,0,12,32,50,210,71,59,31,151,67,19534
15000US060830015001,458,97,0,12,0,12,0,12,458,97,72,40,386,103,19535
15000US060830015002,348,63,0,12,0,12,0,12,348,63,47,26,301,65,19536
15000US060830015003,445,76,9,16,9,16,0,12,436,75,29,25,407,75,19537
15000US060830016011,346,72,8,14,0,12,8,14,338,74,124,66,214,66,19538
15000US060830016012,822,107,16,19,10,15,6,12,806,106,163,65,643,114,19539
15000US060830016013,678,98,22,30,22,30,0,12,656,103,142,58,514,105,19540
15000US060830016041,454,159,0,12,0,12,0,12,454,159,79,65,375,141,19541
15000US060830016042,341,106,34,38,18,27,16,26,307,103,70,82,237,98,19542
15000US060830016043,419,146,0,12,0,12,0,12,419,146,128,127,291,138,19543
15000US060830016044,862,139,80,81,58,74,22,38,782,144,152,97,630,135,19544
15000US060830017041,617,67,12,14,6,10,6,10,605,64,138,54,467,66,19545
15000US060830017042,474,65,23,19,12,13,11,14,451,68,72,39,379,64,19546
15000US060830017061,567,112,0,12,0,12,0,12,567,112,93,45,474,114,19547
15000US060830017062,459,85,0,12,0,12,0,12,459,85,145,54,314,76,19548
15000US060830017063,249,68,0,12,0,12,0,12,249,68,14,17,235,66,19549
15000US060830017064,247,88,0,12,0,12,0,12,247,88,13,17,234,88,19550
15000US060830017065,417,122,0,12,0,12,0,12,417,122,34,43,383,124,19551
15000US060830018001,380,46,15,17,5,7,10,15,365,46,96,32,269,47,19552
15000US060830019011,488,122,48,72,0,12,48,72,440,129,124,75,316,118,19553
15000US060830019012,229,87,0,12,0,12,0,12,229,87,95,64,134,70,19554
15000US060830019013,910,169,31,54,0,12,31,54,879,157,46,58,833,156,19555
15000US060830019014,801,130,35,55,35,55,0,12,766,128,237,120,529,128,19556
15000US060830019015,200,83,0,12,0,12,0,12,200,83,68,68,132,60,19557
15000US060830019031,345,78,3,5,0,12,3,5,342,77,85,37,257,74,19558
15000US060830019032,476,114,0,12,0,12,0,12,476,114,106,64,370,131,19559
15000US060830019033,412,112,0,12,0,12,0,12,412,112,55,46,357,115,19560
15000US060830019034,920,177,12,19,12,19,0,12,908,177,291,131,617,157,19561
15000US060830019035,499,120,11,19,11,19,0,12,488,124,77,51,411,124,19562
15000US060830019051,445,81,4,7,0,12,4,7,441,81,108,51,333,73,19563
15000US060830019052,255,66,3,4,0,12,3,4,252,66,45,29,207,61,19564
15000US060830019053,324,57,7,10,0,12,7,10,317,56,50,28,267,58,19565
15000US060830019061,552,119,0,12,0,12,0,12,552,119,57,46,495,122,19566
15000US060830019062,475,102,0,12,0,12,0,12,475,102,45,38,430,105,19567
15000US060830019063,347,73,0,12,0,12,0,12,347,73,79,50,268,62,19568
15000US060830019064,340,120,0,12,0,12,0,12,340,120,124,93,216,100,19569
15000US060830019065,555,105,11,12,1,5,10,11,544,103,183,81,361,115,19570
15000US060830020051,201,46,24,38,0,12,24,38,177,44,52,34,125,46,19571
15000US060830020052,469,77,22,26,0,12,22,26,447,77,97,53,350,73,19572
15000US060830020053,682,78,90,71,40,43,50,58,592,76,163,60,429,81,19573
15000US060830020054,543,79,0,12,0,12,0,12,543,79,113,47,430,85,19574
15000US060830020061,498,55,9,9,2,3,7,9,489,56,95,32,394,56,19575
15000US060830020062,314,51,22,24,16,22,6,9,292,52,58,22,234,50,19576
15000US060830020071,344,82,0,12,0,12,0,12,344,82,56,54,288,87,19577
15000US060830020072,294,104,0,12,0,12,0,12,294,104,46,41,248,109,19578
15000US060830020073,384,82,13,22,13,22,0,12,371,85,111,69,260,86,19579
15000US060830020074,975,154,26,31,0,12,26,31,949,158,267,109,682,157,19580
15000US060830020075,496,155,65,83,18,29,47,77,431,147,269,125,162,114,19581
15000US060830020076,453,115,0,12,0,12,0,12,453,115,30,34,423,119,19582
15000US060830020077,771,141,14,22,14,22,0,12,757,145,123,63,634,151,19583
15000US060830020081,897,149,0,12,0,12,0,12,897,149,199,96,698,169,19584
15000US060830020082,211,60,15,24,15,24,0,12,196,58,12,19,184,60,19585
15000US060830020083,317,82,0,12,0,12,0,12,317,82,105,68,212,79,19586
15000US060830020084,477,102,49,45,0,12,49,45,428,106,82,64,346,100,19587
15000US060830020085,289,81,29,35,0,12,29,35,260,88,163,82,97,55,19588
15000US060830020091,484,79,0,12,0,12,0,12,484,79,175,68,309,86,19589
15000US060830020092,354,99,8,14,0,12,8,14,346,100,133,64,213,93,19590
15000US060830020093,534,112,59,54,34,40,25,36,475,102,112,60,363,102,19591
15000US060830020101,734,79,21,32,21,32,0,12,713,84,118,52,595,89,19592
15000US060830020102,371,69,6,9,0,12,6,9,365,70,142,61,223,84,19593
15000US060830020103,211,50,14,13,14,13,0,12,197,52,64,31,133,57,19594
15000US060830020104,209,54,9,17,0,12,9,17,200,54,42,27,158,62,19595
15000US060830020111,923,93,22,32,0,12,22,32,901,86,104,45,797,94,19596
15000US060830020112,243,61,10,15,0,12,10,15,233,58,70,36,163,63,19597
15000US060830020113,535,83,206,94,111,79,95,56,329,77,111,60,218,70,19598
15000US060830020121,460,53,0,12,0,12,0,12,460,53,57,36,403,65,19599
15000US060830020122,378,71,25,30,25,30,0,12,353,70,49,39,304,76,19600
15000US060830020123,379,70,32,29,13,20,19,21,347,69,67,58,280,69,19601
15000US060830020131,466,74,0,12,0,12,0,12,466,74,143,53,323,67,19602
15000US060830020132,514,68,0,12,0,12,0,12,514,68,87,41,427,74,19603
15000US060830021011,560,101,156,72,82,63,74,52,404,91,87,47,317,82,19604
15000US060830021012,632,113,179,102,80,77,99,81,453,117,82,69,371,107,19605
15000US060830021021,503,59,21,20,13,19,8,10,482,61,57,30,425,62,19606
15000US060830021022,263,49,20,16,11,13,9,9,243,49,79,40,164,48,19607
15000US060830021031,489,110,92,39,29,28,63,35,397,110,49,28,348,107,19608
15000US060830021032,670,117,132,82,0,12,132,82,538,110,168,77,370,107,19609
15000US060830021033,339,65,8,13,8,13,0,12,331,67,76,35,255,64,19610
15000US060830022051,387,71,90,51,39,37,51,36,297,67,59,27,238,69,19611
15000US060830022052,385,87,85,55,34,35,51,45,300,75,131,55,169,58,19612
15000US060830022053,612,115,104,57,22,23,82,52,508,118,103,65,405,107,19613
15000US060830022061,467,92,51,55,0,12,51,55,416,89,145,63,271,91,19614
15000US060830022062,619,98,125,63,54,42,71,57,494,94,175,70,319,103,19615
15000US060830022063,400,74,95,57,0,12,95,57,305,85,124,55,181,76,19616
15000US060830022091,520,77,106,50,65,42,41,30,414,86,125,52,289,88,19617
15000US060830022092,365,65,80,43,13,15,67,43,285,74,103,48,182,67,19618
15000US060830022101,756,108,38,38,29,35,9,16,718,107,160,58,558,100,19619
15000US060830022102,500,94,45,40,0,12,45,40,455,93,122,68,333,95,19620
15000US060830022103,307,84,0,12,0,12,0,12,307,84,28,21,279,88,19621
15000US060830022111,518,106,0,12,0,12,0,12,518,106,317,109,201,82,19622
15000US060830022112,491,106,31,41,31,41,0,12,460,106,140,69,320,92,19623
15000US060830022113,721,155,44,69,0,12,44,69,677,152,186,117,491,144,19624
15000US060830022114,326,97,32,37,32,37,0,12,294,97,53,48,241,102,19625
15000US060830023031,299,79,75,55,52,44,23,35,224,77,40,32,184,71,19626
15000US060830023032,301,71,13,21,0,12,13,21,288,73,60,36,228,78,19627
15000US060830023033,362,83,103,60,36,32,67,56,259,82,63,41,196,82,19628
15000US060830023034,289,81,44,31,12,18,32,27,245,83,99,66,146,75,19629
15000US060830023035,135,51,6,11,0,12,6,11,129,52,69,42,60,40,19630
15000US060830023041,251,78,79,52,19,29,60,44,172,70,26,21,146,68,19631
15000US060830023042,307,62,44,32,7,11,37,31,263,67,47,33,216,68,19632
15000US060830023043,367,83,84,48,18,20,66,46,283,72,47,35,236,76,19633
15000US060830023044,428,87,118,67,0,12,118,67,310,81,83,52,227,80,19634
15000US060830023051,351,81,115,77,28,30,87,72,236,65,115,45,121,57,19635
15000US060830023052,309,94,17,18,10,16,7,11,292,94,94,41,198,84,19636
15000US060830023053,355,81,53,33,33,25,20,21,302,77,51,34,251,80,19637
15000US060830023054,523,92,131,61,100,62,31,40,392,78,61,34,331,77,19638
15000US060830023061,225,117,0,12,0,12,0,12,225,117,0,12,225,117,19639
15000US060830023062,434,122,14,22,0,12,14,22,420,121,98,67,322,127,19640
15000US060830023063,655,134,28,31,28,31,0,12,627,136,418,119,209,113,19641
15000US060830023064,1126,193,107,73,51,46,56,68,1019,202,206,126,813,195,19642
15000US060830024021,316,73,28,32,13,22,15,22,288,70,118,63,170,69,19643
15000US060830024022,1949,180,337,122,51,58,286,126,1612,203,261,92,1351,196,19644
15000US060830024023,306,96,168,86,28,26,140,95,138,78,27,41,111,67,19645
15000US060830024024,659,131,100,91,31,43,69,77,559,152,107,61,452,145,19646
15000US060830024031,525,86,93,58,0,12,93,58,432,93,98,50,334,94,19647
15000US060830024032,442,82,171,68,57,38,114,66,271,80,91,52,180,72,19648
15000US060830024033,557,87,192,85,81,62,111,54,365,92,69,52,296,80,19649
15000US060830024041,507,87,109,58,16,26,93,53,398,74,33,38,365,66,19650
15000US060830024042,575,109,95,58,44,36,51,47,480,117,13,15,467,115,19651
15000US060830024043,186,69,81,53,38,32,43,47,105,52,42,29,63,48,19652
15000US060830024044,496,102,122,62,2,6,120,62,374,103,64,43,310,109,19653
15000US060830025021,286,70,49,45,45,44,4,8,237,71,105,56,132,70,19654
15000US060830025022,852,112,110,66,39,33,71,56,742,113,214,72,528,113,19655
15000US060830025023,390,81,119,73,42,43,77,63,271,94,49,30,222,96,19656
15000US060830025024,486,102,86,59,8,13,78,58,400,104,78,56,322,99,19657
15000US060830026041,33,14,0,12,0,12,0,12,33,14,4,7,29,12,19658
15000US060830026061,943,80,0,12,0,12,0,12,943,80,81,37,862,76,19659
15000US060830027021,242,89,142,84,0,12,142,84,100,58,17,24,83,52,19660
15000US060830027022,366,133,155,106,40,51,115,104,211,94,60,58,151,87,19661
15000US060830027023,619,146,168,111,14,22,154,114,451,144,132,76,319,135,19662
15000US060830027024,742,159,240,108,53,49,187,109,502,149,154,112,348,122,19663
15000US060830027025,396,131,100,80,0,12,100,80,296,122,62,68,234,117,19664
15000US060830027031,627,79,89,61,84,63,5,8,538,83,144,87,394,82,19665
15000US060830027032,840,125,164,102,98,95,66,42,676,136,211,96,465,125,19666
15000US060830027051,561,107,36,39,0,12,36,39,525,107,144,73,381,93,19667
15000US060830027052,721,103,246,88,68,58,178,81,475,96,212,63,263,91,19668
15000US060830027053,247,63,15,18,8,12,7,14,232,64,117,45,115,59,19669
15000US060830027061,395,90,17,20,8,12,9,17,378,91,122,55,256,84,19670
15000US060830027062,428,92,68,51,40,41,28,35,360,96,67,40,293,95,19671
15000US060830027063,643,117,123,76,20,24,103,76,520,116,116,61,404,116,19672
15000US060830027064,271,70,50,45,10,16,40,43,221,63,103,53,118,56,19673
15000US060830027065,216,84,154,70,19,22,135,72,62,48,17,23,45,40,19674
15000US060830027071,280,51,20,16,0,12,20,16,260,50,78,35,182,49,19675
15000US060830027072,257,58,42,33,34,32,8,8,215,51,29,30,186,48,19676
15000US060830027073,431,65,29,26,25,25,4,7,402,66,99,38,303,59,19677
15000US060830027081,310,70,16,18,5,7,11,17,294,71,21,24,273,67,19678
15000US060830027082,441,78,62,59,0,12,62,59,379,74,101,46,278,68,19679
15000US060830027083,371,73,22,22,7,13,15,18,349,76,68,41,281,82,19680
15000US060830028021,594,115,147,105,40,53,107,100,447,120,85,52,362,121,19681
15000US060830028022,335,117,67,95,0,12,67,95,268,71,103,54,165,65,19682
15000US060830028023,1009,196,43,50,14,23,29,45,966,195,273,160,693,170,19683
15000US060830028024,520,132,0,12,0,12,0,12,520,132,180,90,340,123,19684
15000US060830028061,500,56,17,15,12,13,5,8,483,55,123,48,360,63,19685
15000US060830028062,308,46,51,37,20,29,31,23,257,47,127,46,130,53,19686
15000US060830028081,223,80,0,12,0,12,0,12,223,80,79,60,144,70,19687
15000US060830028082,213,95,0,12,0,12,0,12,213,95,86,59,127,91,19688
15000US060830028083,499,127,0,12,0,12,0,12,499,127,128,63,371,128,19689
15000US060830028084,516,121,22,35,0,12,22,35,494,114,236,105,258,85,19690
15000US060830028085,330,99,17,28,0,12,17,28,313,99,166,96,147,65,19691
15000US060830028086,792,136,47,48,10,17,37,43,745,137,141,84,604,147,19692
15000US060830028091,268,55,9,15,0,12,9,15,259,54,102,47,157,56,19693
15000US060830028092,398,80,7,10,0,12,7,10,391,80,68,41,323,82,19694
15000US060830028093,294,70,9,14,9,14,0,12,285,70,58,34,227,70,19695
15000US060830028094,589,74,17,19,9,15,8,13,572,75,85,44,487,84,19696
15000US060830029061,315,45,0,12,0,12,0,12,315,45,86,37,229,50,19697
15000US060830029062,530,87,0,12,0,12,0,12,530,87,133,63,397,92,19698
15000US060830029063,528,66,10,15,10,15,0,12,518,66,95,37,423,67,19699
15000US060830029071,669,77,8,13,8,13,0,12,661,80,121,51,540,88,19700
15000US060830029072,444,67,9,14,0,12,9,14,435,68,52,33,383,73,19701
15000US060830029073,420,82,0,12,0,12,0,12,420,82,63,35,357,90,19702
15000US060830029091,612,88,16,25,0,12,16,25,596,90,156,62,440,88,19703
15000US060830029092,603,99,9,13,0,12,9,13,594,103,108,63,486,114,19704
15000US060830029093,509,68,9,14,9,14,0,12,500,70,97,44,403,78,19705
15000US060830029131,597,88,12,17,0,12,12,17,585,88,91,58,494,76,19706
15000US060830029132,913,107,52,59,52,59,0,12,861,104,308,71,553,101,19707
15000US060830029141,369,77,0,12,0,12,0,12,369,77,172,65,197,68,19708
15000US060830029142,415,71,42,54,0,12,42,54,373,60,53,26,320,64,19709
15000US060830029143,470,66,0,12,0,12,0,12,470,66,113,51,357,66,19710
15000US060830029151,236,33,16,14,0,12,16,14,220,35,25,19,195,38,19711
15000US060830029221,9,9,0,17,0,17,0,17,9,9,0,17,9,9,19712
15000US060830029222,0,12,0,12,0,12,0,12,0,12,0,12,0,12,19713
15000US060830029223,0,12,0,12,0,12,0,12,0,12,0,12,0,12,19714
15000US060830029224,466,56,3,4,3,4,0,12,463,55,56,28,407,60,19715
15000US060830029225,318,54,23,18,0,12,23,18,295,54,18,16,277,55,19716
15000US060830029241,461,110,33,33,0,12,33,33,428,112,13,20,415,116,19717
15000US060830029242,479,110,29,35,0,12,29,35,450,107,7,11,443,107,19718
15000US060830029243,177,68,0,12,0,12,0,12,177,68,35,42,142,58,19719
15000US060830029244,379,91,26,42,0,12,26,42,353,88,19,18,334,89,19720
15000US060830029261,663,91,56,32,9,11,47,31,607,91,51,32,556,88,19721
15000US060830029262,336,71,0,12,0,12,0,12,336,71,24,37,312,67,19722
15000US060830029263,771,94,95,46,24,23,71,43,676,88,199,61,477,96,19723
15000US060830029281,697,120,27,26,0,12,27,26,670,124,83,58,587,131,19724
15000US060830029282,675,142,16,20,0,12,16,20,659,140,78,86,581,122,19725
15000US060830029301,735,153,0,12,0,12,0,12,735,153,155,84,580,146,19726
15000US060830029302,345,84,0,12,0,12,0,12,345,84,68,83,277,78,19727
15000US060830029303,361,102,32,39,13,22,19,32,329,95,31,37,298,93,19728
15000US060830029304,347,112,0,12,0,12,0,12,347,112,36,41,311,116,19729
15000US060830029305,583,137,17,26,0,12,17,26,566,141,28,34,538,150,19730
15000US060830029306,571,123,52,60,16,26,36,55,519,129,46,44,473,128,19731
15000US060830029321,176,48,2,3,0,12,2,3,174,48,10,9,164,48,19732
15000US060830029322,553,60,11,13,0,12,11,13,542,59,67,25,475,60,19733
15000US060830030011,269,75,0,12,0,12,0,12,269,75,65,52,204,74,19734
15000US060830030012,727,121,25,40,0,12,25,40,702,115,111,59,591,117,19735
15000US060830030013,492,119,0,12,0,12,0,12,492,119,42,39,450,131,19736
15000US060830030014,493,112,134,98,37,60,97,79,359,111,76,60,283,106,19737
15000US060830030015,251,106,37,49,0,12,37,49,214,105,29,33,185,96,19738
15000US060830030041,474,63,0,12,0,12,0,12,474,63,65,40,409,67,19739
15000US060830030042,639,78,0,12,0,12,0,12,639,78,142,50,497,78,19740
15000US060830030043,504,64,5,10,5,10,0,12,499,66,92,49,407,81,19741
15000US060830030051,310,73,8,13,8,13,0,12,302,74,57,34,245,76,19742
15000US060830030052,586,82,0,12,0,12,0,12,586,82,212,76,374,80,19743
15000US060830030053,596,61,43,41,26,35,17,19,553,70,82,58,471,69,19744
15000US060830030071,461,74,0,12,0,12,0,12,461,74,68,32,393,70,19745
15000US060830030072,381,65,11,14,11,14,0,12,370,67,60,28,310,73,19746
15000US060830030073,553,94,7,10,0,12,7,10,546,93,148,52,398,93,19747
15000US060830031021,269,66,0,12,0,12,0,12,269,66,99,44,170,62,19748
15000US060830031022,418,77,34,27,9,15,25,23,384,82,106,55,278,88,19749
15000US060830031023,442,64,18,19,0,12,18,19,424,68,102,55,322,73,19750
15000US060839800001,4,7,0,12,0,12,0,12,4,7,0,12,4,7,19751
15000US060839801001,0,12,0,12,0,12,0,12,0,12,0,12,0,12,19752
15000US060839900000,0,12,0,12,0,12,0,12,0,12,0,12,0,12,19753
15000US060855001001,286,118,48,79,0,12,48,79,238,82,31,25,207,88,19754
15000US060855001002,664,133,55,49,21,32,34,37,609,141,65,47,544,142,19755
15000US060855001003,561,166,118,78,0,12,118,78,443,169,120,95,323,162,19756
15000US060855001004,884,160,154,108,34,38,120,102,730,147,58,41,672,153,19757
15000US060855002001,526,102,16,27,16,27,0,12,510,106,30,36,480,105,19758
15000US060855002002,0,12,0,12,0,12,0,12,0,12,0,12,0,12,19759
15000US060855002003,615,120,29,45,29,45,0,12,586,121,63,49,523,131,19760
15000US060855002004,1004,147,16,27,16,27,0,12,988,143,59,48,929,140,19761
15000US060855003001,142,62,0,12,0,12,0,12,142,62,11,17,131,61,19762
15000US060855003002,1322,80,70,51,8,12,62,45,1252,91,111,69,1141,113,19763
15000US060855004001,593,55,51,38,0,12,51,38,542,58,121,51,421,66,19764
15000US060855004002,404,46,5,7,5,7,0,12,399,47,41,21,358,52,19765
15000US060855005001,455,82,0,12,0,12,0,12,455,82,99,71,356,73,19766
15000US060855005002,674,102,34,38,21,29,13,21,640,115,83,47,557,112,19767
15000US060855005003,249,84,19,29,0,12,19,29,230,79,24,24,206,79,19768
15000US060855005004,408,84,22,25,15,22,7,10,386,88,96,48,290,100,19769
15000US060855005005,265,57,18,20,0,12,18,20,247,59,66,37,181,59,19770
15000US060855006001,1494,126,74,49,9,17,65,44,1420,139,210,95,1210,150,19771
15000US060855006002,471,97,0,12,0,12,0,12,471,97,62,61,409,110,19772
15000US060855006003,399,92,13,22,13,22,0,12,386,96,21,24,365,94,19773
15000US060855008001,847,110,24,22,15,19,9,12,823,111,167,72,656,104,19774
15000US060855008002,917,112,60,45,9,14,51,45,857,114,129,70,728,129,19775
15000US060855009011,386,92,41,44,7,14,34,42,345,88,29,31,316,84,19776
15000US060855009012,1677,133,155,96,9,12,146,96,1522,135,121,55,1401,138,19777
15000US060855009021,354,45,39,26,11,12,28,23,315,43,24,20,291,42,19778
15000US060855009022,256,46,57,32,0,17,57,32,199,42,14,11,185,40,19779
15000US060855010001,425,130,112,94,20,39,92,83,313,122,59,65,254,105,19780
15000US060855010002,358,122,15,24,15,24,0,12,343,119,56,65,287,110,19781
15000US060855010003,433,105,28,32,13,21,15,24,405,105,164,72,241,101,19782
15000US060855010004,489,128,45,66,0,12,45,66,444,136,154,85,290,126,19783
15000US060855010005,292,96,19,31,19,31,0,12,273,99,0,12,273,99,19784
15000US060855011011,1040,112,58,39,56,40,2,8,982,120,139,73,843,119,19785
15000US060855011012,904,108,36,27,8,13,28,25,868,111,143,72,725,109,19786
15000US060855011021,385,81,6,10,6,10,0,12,379,82,121,42,258,84,19787
15000US060855011022,524,83,69,56,10,15,59,55,455,90,107,66,348,97,19788
15000US060855011023,470,78,16,23,0,12,16,23,454,77,90,64,364,78,19789
15000US060855012001,251,75,8,13,0,12,8,13,243,74,64,47,179,70,19790
15000US060855012002,426,100,89,68,82,68,7,11,337,84,69,48,268,87,19791
15000US060855012003,400,97,29,42,0,12,29,42,371,91,105,50,266,84,19792
15000US060855012004,296,86,52,31,38,28,14,17,244,81,43,31,201,79,19793
15000US060855013001,177,36,7,12,7,12,0,12,170,35,31,26,139,39,19794
15000US060855013002,197,49,0,12,0,12,0,12,197,49,25,23,172,53,19795
15000US060855013003,536,90,57,45,0,12,57,45,479,93,71,60,408,94,19796
15000US060855013004,228,53,31,26,31,26,0,12,197,54,16,18,181,56,19797
15000US060855014011,806,57,155,69,25,25,130,63,651,83,122,46,529,76,19798
15000US060855014012,231,50,49,35,33,29,16,20,182,46,60,30,122,45,19799
15000US060855014021,426,55,57,33,0,12,57,33,369,60,64,34,305,62,19800
15000US060855014022,491,62,131,49,10,12,121,49,360,61,77,38,283,59,19801
15000US060855015011,662,92,60,45,14,16,46,42,602,91,135,65,467,98,19802
15000US060855015012,660,86,127,74,41,48,86,57,533,100,130,71,403,100,19803
15000US060855015021,502,85,44,49,0,12,44,49,458,92,102,61,356,85,19804
15000US060855015022,679,88,106,66,18,18,88,62,573,101,135,67,438,96,19805
15000US060855016001,193,97,0,12,0,12,0,12,193,97,39,49,154,91,19806
15000US060855016002,401,144,15,25,15,25,0,12,386,141,17,28,369,140,19807
15000US060855016003,666,154,59,74,43,70,16,26,607,148,47,44,560,156,19808
15000US060855016004,800,161,72,82,36,59,36,58,728,153,10,17,718,155,19809
15000US060855016005,435,124,34,49,34,49,0,12,401,128,52,43,349,137,19810
15000US060855017001,220,58,23,25,0,12,23,25,197,59,45,34,152,60,19811
15000US060855017002,180,74,47,37,26,40,21,23,133,71,12,16,121,68,19812
15000US060855017003,584,105,144,80,39,43,105,72,440,107,83,59,357,103,19813
15000US060855017004,360,79,93,72,0,12,93,72,267,65,97,56,170,54,19814
15000US060855018001,434,86,53,35,18,23,35,37,381,88,57,52,324,78,19815
15000US060855018002,409,92,43,36,26,40,17,18,366,96,63,39,303,99,19816
15000US060855018003,434,92,33,30,20,22,13,19,401,89,108,68,293,78,19817
15000US060855018004,460,80,10,15,0,12,10,15,450,81,73,36,377,89,19818
15000US060855019001,1690,174,29,37,0,12,29,37,1661,174,237,102,1424,183,19819
15000US060855019002,947,157,57,70,17,30,40,64,890,157,93,81,797,174,19820
15000US060855020011,517,104,89,80,0,12,89,80,428,98,73,61,355,91,19821
15000US060855020012,408,86,17,19,7,11,10,15,391,87,48,32,343,89,19822
15000US060855020013,409,81,9,14,9,14,0,12,400,81,50,32,350,81,19823
15000US060855020014,779,117,72,65,17,19,55,61,707,117,121,63,586,113,19824
15000US060855020021,296,72,62,40,11,16,51,37,234,72,29,20,205,74,19825
15000US060855020022,509,103,124,63,45,43,79,49,385,111,102,68,283,96,19826
15000US060855020023,848,107,48,32,25,28,23,29,800,108,145,66,655,114,19827
15000US060855021011,501,77,0,12,0,12,0,12,501,77,110,45,391,77,19828
15000US060855021012,335,71,6,10,0,12,6,10,329,72,48,29,281,72,19829
15000US060855021013,1099,97,14,18,14,18,0,12,1085,101,167,55,918,115,19830
15000US060855021021,861,144,181,117,71,68,110,99,680,135,80,67,600,128,19831
15000US060855021022,824,167,113,101,81,98,32,33,711,168,151,62,560,169,19832
15000US060855021023,548,115,40,47,26,41,14,21,508,110,34,40,474,114,19833
15000US060855021024,460,119,0,12,0,12,0,12,460,119,51,49,409,124,19834
15000US060855022011,1691,186,102,66,49,50,53,48,1589,201,314,121,1275,196,19835
15000US060855022012,1341,203,138,70,86,75,52,50,1203,213,158,118,1045,227,19836
15000US060855022021,758,72,11,17,0,12,11,17,747,70,80,42,667,79,19837
15000US060855022022,342,64,8,12,8,12,0,12,334,65,16,19,318,69,19838
15000US060855022023,346,66,8,13,0,12,8,13,338,64,53,37,285,77,19839
15000US060855023011,646,73,8,12,0,12,8,12,638,76,60,45,578,77,19840
15000US060855023012,708,71,0,12,0,12,0,12,708,71,80,46,628,76,19841
15000US060855023021,605,69,33,31,10,15,23,26,572,70,34,22,538,72,19842
15000US060855023022,670,69,10,15,0,12,10,15,660,69,93,55,567,82,19843
15000US060855024001,230,51,0,12,0,12,0,12,230,51,11,17,219,49,19844
15000US060855024002,250,67,0,12,0,12,0,12,250,67,52,41,198,68,19845
15000US060855024003,246,66,0,12,0,12,0,12,246,66,0,12,246,66,19846
15000US060855024004,414,111,0,12,0,12,0,12,414,111,13,21,401,114,19847
15000US060855024005,758,127,40,59,0,12,40,59,718,123,169,71,549,124,19848
15000US060855024006,564,114,0,12,0,12,0,12,564,114,17,30,547,111,19849
15000US060855024007,313,85,19,30,19,30,0,12,294,89,28,31,266,87,19850
15000US060855025001,386,79,0,12,0,12,0,12,386,79,41,49,345,89,19851
15000US060855025002,452,82,13,22,13,22,0,12,439,80,69,47,370,91,19852
15000US060855025003,428,85,0,12,0,12,0,12,428,85,36,35,392,92,19853
15000US060855025004,405,62,0,12,0,12,0,12,405,62,29,32,376,71,19854
15000US060855025005,309,85,17,24,17,24,0,12,292,82,19,28,273,85,19855
15000US060855025006,481,73,0,12,0,12,0,12,481,73,135,60,346,87,19856
15000US060855026011,256,56,0,12,0,12,0,12,256,56,12,18,244,57,19857
15000US060855026012,328,52,0,12,0,12,0,12,328,52,54,34,274,59,19858
15000US060855026013,623,70,0,12,0,12,0,12,623,70,252,87,371,84,19859
15000US060855026031,302,56,7,11,7,11,0,12,295,56,47,30,248,57,19860
15000US060855026032,295,48,0,12,0,12,0,12,295,48,44,26,251,52,19861
15000US060855026033,379,57,10,15,10,15,0,12,369,58,39,27,330,62,19862
15000US060855026041,918,152,0,12,0,12,0,12,918,152,127,95,791,138,19863
15000US060855026042,667,157,17,31,0,12,17,31,650,160,57,75,593,162,19864
15000US060855026043,405,124,8,22,8,22,0,12,397,120,127,76,270,115,19865
15000US060855027011,708,88,26,22,26,22,0,12,682,88,176,70,506,92,19866
15000US060855027012,568,81,19,21,3,9,16,20,549,81,79,39,470,82,19867
15000US060855027013,696,103,84,65,10,17,74,63,612,105,128,72,484,99,19868
15000US060855027021,961,121,0,12,0,12,0,12,961,121,197,77,764,127,19869
15000US060855027022,674,107,38,39,0,12,38,39,636,105,132,73,504,114,19870
15000US060855027023,350,81,0,12,0,12,0,12,350,81,53,49,297,84,19871
15000US060855027024,578,80,0,12,0,12,0,12,578,80,82,53,496,102,19872
15000US060855027025,421,86,0,12,0,12,0,12,421,86,72,38,349,83,19873
15000US060855028001,499,71,0,12,0,12,0,12,499,71,158,63,341,87,19874
15000US060855028002,606,76,19,21,0,12,19,21,587,78,122,66,465,86,19875
15000US060855028003,339,55,4,9,4,9,0,12,335,56,79,44,256,64,19876
15000US060855029011,538,96,95,84,48,76,47,54,443,110,96,52,347,113,19877
15000US060855029012,515,112,9,15,9,15,0,12,506,115,46,47,460,123,19878
15000US060855029013,398,81,0,12,0,12,0,12,398,81,101,73,297,101,19879
15000US060855029014,780,127,39,39,24,30,15,24,741,135,75,46,666,132,19880
15000US060855029021,873,114,0,12,0,12,0,12,873,114,208,79,665,127,19881
15000US060855029022,896,130,0,12,0,12,0,12,896,130,172,94,724,145,19882
15000US060855029023,938,124,0,12,0,12,0,12,938,124,216,95,722,137,19883
15000US060855029031,815,79,8,13,8,13,0,12,807,81,220,74,587,87,19884
15000US060855029032,519,62,0,12,0,12,0,12,519,62,121,55,398,69,19885
15000US060855029033,590,66,13,15,0,12,13,15,577,68,80,38,497,73,19886
15000US060855029061,488,86,70,58,0,12,70,58,418,90,47,33,371,91,19887
15000US060855029062,586,73,13,21,12,20,1,7,573,74,165,48,408,72,19888
15000US060855029063,465,80,35,42,0,12,35,42,430,73,114,66,316,77,19889
15000US060855029071,743,66,9,14,9,14,0,12,734,69,111,49,623,69,19890
15000US060855029072,571,56,0,12,0,12,0,12,571,56,139,62,432,64,19891
15000US060855029081,805,140,0,12,0,12,0,12,805,140,103,82,702,161,19892
15000US060855029082,977,139,9,16,9,16,0,12,968,144,149,107,819,135,19893
15000US060855029083,640,138,0,12,0,12,0,12,640,138,168,110,472,134,19894
15000US060855029091,444,77,7,11,0,12,7,11,437,78,83,41,354,84,19895
15000US060855029092,321,64,0,12,0,12,0,12,321,64,31,23,290,64,19896
15000US060855029093,614,86,18,20,18,20,0,12,596,91,76,53,520,88,19897
15000US060855029094,698,104,110,83,7,11,103,85,588,108,65,37,523,108,19898
15000US060855029101,283,47,15,22,15,22,0,12,268,51,84,36,184,52,19899
15000US060855029102,303,63,8,12,0,12,8,12,295,64,72,47,223,62,19900
15000US060855029103,173,70,0,12,0,12,0,12,173,70,16,18,157,68,19901
15000US060855029104,614,92,8,12,8,12,0,12,606,92,38,25,568,97,19902
15000US060855030011,524,65,18,21,0,12,18,21,506,64,66,36,440,72,19903
15000US060855030012,382,68,0,12,0,12,0,12,382,68,103,51,279,70,19904
15000US060855030013,728,70,16,22,0,12,16,22,712,75,59,38,653,81,19905
15000US060855030021,534,83,51,54,11,13,40,52,483,87,126,49,357,88,19906
15000US060855030022,666,78,0,12,0,12,0,12,666,78,199,73,467,73,19907
15000US060855030031,361,63,12,18,0,12,12,18,349,64,98,45,251,72,19908
15000US060855030032,783,79,12,16,12,16,0,12,771,82,111,47,660,81,19909
15000US060855030033,490,66,34,45,6,10,28,44,456,64,97,58,359,72,19910
15000US060855030034,202,42,0,12,0,12,0,12,202,42,27,24,175,44,19911
15000US060855031051,765,46,109,43,40,28,69,37,656,58,239,74,417,67,19912
15000US060855031081,778,164,25,41,25,41,0,12,753,156,193,102,560,155,19913
15000US060855031082,1184,144,15,23,0,12,15,23,1169,142,85,63,1084,148,19914
15000US060855031083,452,157,0,12,0,12,0,12,452,157,107,56,345,169,19915
15000US060855031084,367,113,89,69,47,60,42,50,278,111,0,12,278,111,19916
15000US060855031101,603,74,173,72,23,31,150,67,430,81,38,36,392,78,19917
15000US060855031102,302,60,95,48,22,23,73,40,207,62,50,31,157,62,19918
15000US060855031103,246,58,116,64,0,12,116,64,130,63,19,22,111,61,19919
15000US060855031111,305,91,40,57,40,57,0,12,265,78,32,27,233,77,19920
15000US060855031112,382,101,12,19,12,19,0,12,370,97,85,45,285,98,19921
15000US060855031113,440,83,87,58,15,17,72,55,353,89,133,66,220,89,19922
15000US060855031121,1114,104,84,57,22,25,62,51,1030,117,143,60,887,121,19923
15000US060855031122,348,83,50,42,21,32,29,25,298,84,99,57,199,70,19924
15000US060855031131,587,89,54,43,38,39,16,17,533,93,126,62,407,84,19925
15000US060855031132,782,85,135,85,33,46,102,74,647,102,130,59,517,109,19926
15000US060855031151,2696,56,110,96,0,17,110,96,2586,112,387,116,2199,159,19927
15000US060855031161,1432,120,71,50,24,29,47,41,1361,139,236,114,1125,159,19928
15000US060855031162,844,115,55,51,29,35,26,37,789,128,140,102,649,132,19929
15000US060855031171,393,62,132,55,32,25,100,48,261,58,44,34,217,53,19930
15000US060855031172,375,64,91,51,33,25,58,41,284,63,94,33,190,62,19931
15000US060855031181,223,52,7,11,7,11,0,12,216,52,81,47,135,48,19932
15000US060855031182,635,89,107,70,0,12,107,70,528,99,66,31,462,99,19933
15000US060855031183,812,97,103,54,25,31,78,52,709,105,36,36,673,101,19934
15000US060855031211,1371,80,123,69,20,20,103,70,1248,90,136,69,1112,111,19935
15000US060855031212,130,48,22,25,9,14,13,21,108,43,19,22,89,42,19936
15000US060855031221,902,104,246,113,96,65,150,86,656,120,219,93,437,104,19937
15000US060855031222,252,69,49,40,38,36,11,17,203,65,33,23,170,63,19938
15000US060855031231,845,108,29,38,0,12,29,38,816,108,158,64,658,104,19939
15000US060855031232,799,92,154,87,88,63,66,56,645,100,231,69,414,104,19940
15000US060855032041,693,147,143,94,80,67,63,64,550,148,333,126,217,107,19941
15000US060855032042,456,102,23,39,23,39,0,12,433,96,51,44,382,95,19942
15000US060855032043,425,98,75,63,36,37,39,50,350,110,117,73,233,96,19943
15000US060855032044,88,65,14,26,0,12,14,26,74,64,25,39,49,50,19944
15000US060855032045,617,160,152,90,73,73,79,93,465,152,162,139,303,115,19945
15000US060855032071,658,59,41,33,23,20,18,20,617,60,121,43,496,67,19946
15000US060855032072,401,64,50,45,21,33,29,27,351,59,54,22,297,56,19947
15000US060855032081,563,53,131,65,42,38,89,58,432,68,170,45,262,72,19948
15000US060855032082,334,50,26,19,16,16,10,11,308,51,83,36,225,46,19949
15000US060855032101,574,54,92,44,40,30,52,34,482,62,120,51,362,67,19950
15000US060855032102,394,55,41,22,26,18,15,14,353,61,110,42,243,50,19951
15000US060855032111,588,79,27,30,11,16,16,25,561,81,91,42,470,91,19952
15000US060855032112,565,81,39,33,27,26,12,21,526,85,101,52,425,83,19953
15000US060855032121,204,36,29,18,6,9,23,16,175,38,54,27,121,36,19954
15000US060855032122,508,55,56,36,26,26,30,26,452,57,128,41,324,64,19955
15000US060855032123,245,46,2,5,2,5,0,12,243,48,50,27,193,48,19956
15000US060855032131,478,83,119,50,7,12,112,50,359,89,158,71,201,76,19957
15000US060855032132,786,85,162,69,58,43,104,63,624,92,176,80,448,104,19958
15000US060855032141,1420,151,434,136,160,91,274,119,986,150,255,104,731,141,19959
15000US060855032142,910,153,178,89,43,52,135,73,732,159,305,138,427,130,19960
15000US060855032171,504,108,120,61,31,33,89,64,384,117,38,35,346,116,19961
15000US060855032172,330,105,65,40,20,24,45,35,265,109,17,22,248,109,19962
15000US060855032173,259,85,45,53,4,8,41,54,214,85,92,69,122,58,19963
15000US060855032181,909,79,188,83,41,43,147,69,721,111,94,55,627,113,19964
15000US060855032182,272,69,41,39,5,8,36,38,231,71,76,44,155,75,19965
15000US060855033041,635,91,78,55,21,23,57,48,557,104,165,67,392,101,19966
15000US060855033042,515,64,77,48,42,37,35,34,438,69,68,45,370,74,19967
15000US060855033043,386,73,41,36,18,28,23,22,345,71,58,42,287,65,19968
15000US060855033044,372,72,19,22,19,22,0,12,353,73,131,59,222,71,19969
15000US060855033051,318,69,54,54,7,15,47,50,264,63,96,52,168,57,19970
15000US060855033052,622,101,58,44,0,12,58,44,564,102,136,67,428,124,19971
15000US060855033053,560,93,126,76,42,31,84,70,434,89,216,83,218,70,19972
15000US060855033061,251,42,15,7,11,8,4,7,236,42,114,39,122,40,19973
15000US060855033062,387,52,56,35,21,21,35,29,331,53,98,30,233,54,19974
15000US060855033063,268,44,31,17,15,16,16,14,237,48,79,34,158,45,19975
15000US060855033121,207,45,8,15,0,12,8,15,199,46,26,28,173,47,19976
15000US060855033122,562,68,0,12,0,12,0,12,562,68,56,41,506,74,19977
15000US060855033123,310,74,28,35,6,12,22,33,282,73,89,60,193,64,19978
15000US060855033131,446,50,12,19,12,19,0,12,434,52,59,38,375,59,19979
15000US060855033132,430,63,0,12,0,12,0,12,430,63,119,58,311,68,19980
15000US060855033133,421,68,0,12,0,12,0,12,421,68,50,47,371,71,19981
15000US060855033151,497,98,23,29,0,12,23,29,474,95,85,47,389,101,19982
15000US060855033152,327,82,20,21,6,10,14,17,307,84,32,21,275,84,19983
15000US060855033153,1216,105,79,62,47,49,32,36,1137,118,223,67,914,121,19984
15000US060855033211,448,53,33,26,16,17,17,20,415,58,179,63,236,63,19985
15000US060855033212,642,57,72,49,53,46,19,16,570,62,133,45,437,74,19986
15000US060855033221,357,50,16,13,11,11,5,8,341,50,86,33,255,58,19987
15000US060855033222,406,45,49,30,49,30,0,12,357,52,69,28,288,57,19988
15000US060855033223,304,45,27,27,13,21,14,17,277,48,52,27,225,52,19989
15000US060855033231,591,94,18,21,10,17,8,14,573,97,51,31,522,100,19990
15000US060855033232,592,79,50,36,8,11,42,35,542,84,178,82,364,89,19991
15000US060855033241,520,41,33,21,23,18,10,11,487,43,127,40,360,50,19992
15000US060855033242,388,41,13,13,6,8,7,10,375,41,63,29,312,48,19993
15000US060855033251,598,90,71,56,0,12,71,56,527,96,108,53,419,92,19994
15000US060855033252,559,83,34,35,21,31,13,19,525,80,211,76,314,80,19995
15000US060855033261,1267,75,59,53,15,23,44,48,1208,82,176,70,1032,104,19996
15000US060855033262,546,80,63,62,0,12,63,62,483,81,62,44,421,80,19997
15000US060855033271,463,83,67,45,27,31,40,33,396,87,154,68,242,76,19998
15000US060855033272,451,93,31,29,19,23,12,18,420,96,61,41,359,102,19999
15000US060855033273,519,81,8,14,0,12,8,14,511,82,303,72,208,70,20000
15000US060855033291,498,46,14,13,0,12,14,13,484,48,61,33,423,53,20001
15000US060855033292,482,46,7,8,7,8,0,12,475,47,90,38,385,47,20002
15000US060855033301,582,110,0,12,0,12,0,12,582,110,27,32,555,108,20003
15000US060855033302,520,98,0,12,0,12,0,12,520,98,0,12,520,98,20004
15000US060855033303,1056,105,26,29,0,12,26,29,1030,104,82,60,948,109,20005
15000US060855033311,1005,80,49,29,30,26,19,19,956,80,310,83,646,91,20006
15000US060855033312,355,53,20,27,20,27,0,12,335,51,55,38,280,55,20007
15000US060855033321,928,81,0,12,0,12,0,12,928,81,383,116,545,119,20008
15000US060855033322,406,71,0,12,0,12,0,12,406,71,161,63,245,73,20009
15000US060855033323,301,77,0,12,0,12,0,12,301,77,21,22,280,75,20010
15000US060855033324,944,93,0,12,0,12,0,12,944,93,216,95,728,105,20011
15000US060855033331,465,74,0,12,0,12,0,12,465,74,69,40,396,76,20012
15000US060855033332,831,76,19,22,6,12,13,20,812,81,201,84,611,98,20013
15000US060855033341,1279,143,36,40,15,26,21,33,1243,144,98,60,1145,138,20014
15000US060855033342,494,104,0,12,0,12,0,12,494,104,72,60,422,99,20015
15000US060855033343,752,108,0,12,0,12,0,12,752,108,49,47,703,114,20016
15000US060855033361,390,43,41,28,12,12,29,27,349,55,52,24,297,56,20017
15000US060855033362,505,46,32,22,5,9,27,20,473,52,161,53,312,60,20018
15000US060855033371,634,61,31,19,14,11,17,17,603,62,172,60,431,67,20019
15000US060855033372,327,52,8,9,0,12,8,9,319,52,54,26,265,54,20020
15000US060855034011,218,58,38,34,23,31,15,16,180,53,38,26,142,53,20021
15000US060855034012,356,69,26,24,26,24,0,12,330,70,97,38,233,62,20022
15000US060855034013,374,59,18,14,5,8,13,12,356,57,82,37,274,60,20023
15000US060855034021,0,12,0,12,0,12,0,12,0,12,0,12,0,12,20024
15000US060855034022,520,95,208,91,53,46,155,84,312,81,66,43,246,79,20025
15000US060855034023,735,98,138,76,42,37,96,68,597,112,196,67,401,107,20026
15000US060855035041,292,82,107,72,22,31,85,65,185,67,66,48,119,62,20027
15000US060855035042,358,86,72,57,11,18,61,55,286,90,72,51,214,79,20028
15000US060855035043,271,92,32,38,12,20,20,33,239,90,12,18,227,91,20029
15000US060855035044,157,74,34,43,0,12,34,43,123,61,9,15,114,62,20030
15000US060855035045,140,46,0,12,0,12,0,12,140,46,20,15,120,47,20031
15000US060855035061,554,82,97,59,58,51,39,27,457,81,76,55,381,80,20032
15000US060855035062,491,82,39,30,22,27,17,21,452,87,134,48,318,83,20033
15000US060855035063,245,57,6,9,0,12,6,9,239,59,58,35,181,60,20034
15000US060855035071,283,27,39,19,5,7,34,18,244,32,46,22,198,37,20035
15000US060855035072,106,25,25,18,8,12,17,17,81,23,22,14,59,23,20036
15000US060855035081,788,87,167,89,44,46,123,81,621,101,185,87,436,105,20037
15000US060855035082,479,79,92,51,43,44,49,45,387,85,109,56,278,89,20038
15000US060855035091,454,61,24,21,0,12,24,21,430,58,102,49,328,73,20039
15000US060855035092,188,56,28,35,0,12,28,35,160,49,7,10,153,49,20040
15000US060855035093,259,41,12,12,0,12,12,12,247,42,51,27,196,43,20041
15000US060855035101,733,92,157,79,36,34,121,77,576,101,121,51,455,97,20042
15000US060855035102,291,71,11,20,11,20,0,12,280,70,87,38,193,71,20043
15000US060855035103,383,75,45,42,0,12,45,42,338,76,85,36,253,74,20044
15000US060855035111,401,54,11,13,11,13,0,12,390,55,104,46,286,52,20045
15000US060855035112,464,51,32,27,11,16,21,22,432,49,136,37,296,58,20046
15000US060855036011,276,56,17,19,11,17,6,8,259,56,45,29,214,50,20047
15000US060855036012,605,60,53,32,17,14,36,30,552,67,166,45,386,67,20048
15000US060855036021,449,77,50,39,0,12,50,39,399,89,54,38,345,92,20049
15000US060855036022,670,76,108,54,13,15,95,54,562,89,202,67,360,86,20050
15000US060855036023,233,63,71,42,7,16,64,42,162,63,69,53,93,45,20051
15000US060855037031,179,48,23,17,6,9,17,16,156,50,29,19,127,55,20052
15000US060855037032,294,54,59,30,22,18,37,29,235,56,82,34,153,53,20053
15000US060855037033,480,70,113,49,26,20,87,48,367,71,73,36,294,70,20054
15000US060855037071,617,89,184,91,18,25,166,86,433,101,45,32,388,98,20055
15000US060855037072,562,73,72,41,10,15,62,40,490,80,113,49,377,85,20056
15000US060855037073,252,65,27,25,17,19,10,14,225,64,42,33,183,61,20057
15000US060855037081,579,46,56,30,26,18,30,28,523,53,144,58,379,59,20058
15000US060855037082,183,48,15,14,9,11,6,9,168,48,45,27,123,46,20059
15000US060855037091,726,82,164,86,27,33,137,80,562,95,171,79,391,113,20060
15000US060855037092,408,86,191,78,64,44,127,71,217,78,117,60,100,58,20061
15000US060855037093,564,82,135,52,72,44,63,40,429,84,175,63,254,87,20062
15000US060855037101,505,81,222,83,25,21,197,81,283,88,145,68,138,71,20063
15000US060855037102,539,71,89,42,36,29,53,30,450,63,113,44,337,68,20064
15000US060855037111,258,57,33,32,18,23,15,24,225,58,58,32,167,58,20065
15000US060855037112,426,69,101,47,20,14,81,46,325,62,91,37,234,58,20066
15000US060855037113,354,56,53,33,15,22,38,25,301,58,60,29,241,55,20067
15000US060855037121,307,60,18,19,9,15,9,12,289,59,90,56,199,58,20068
15000US060855037122,1062,66,147,71,33,30,114,68,915,93,207,75,708,117,20069
15000US060855037131,946,71,76,51,74,51,2,10,870,81,260,91,610,101,20070
15000US060855037132,226,60,28,34,3,13,25,33,198,61,37,40,161,57,20071
15000US060855038021,1018,117,39,50,8,17,31,48,979,132,396,142,583,137,20072
15000US060855038022,241,82,21,32,0,12,21,32,220,76,0,12,220,76,20073
15000US060855038023,301,115,24,31,0,12,24,31,277,110,115,99,162,104,20074
15000US060855038024,692,120,53,49,27,32,26,39,639,120,133,89,506,123,20075
15000US060855038031,1007,97,26,23,16,17,10,16,981,98,156,57,825,98,20076
15000US060855038032,410,78,47,40,39,37,8,14,363,74,65,47,298,78,20077
15000US060855038041,651,100,56,56,0,12,56,56,595,116,100,53,495,113,20078
15000US060855038042,359,92,44,44,17,21,27,42,315,93,80,39,235,89,20079
15000US060855038043,654,113,9,14,0,12,9,14,645,113,105,49,540,114,20080
15000US060855039021,482,91,72,46,13,19,59,43,410,90,64,41,346,93,20081
15000US060855039022,272,83,44,48,8,12,36,52,228,76,135,73,93,56,20082
15000US060855039023,318,76,34,37,0,12,34,37,284,77,40,25,244,79,20083
15000US060855039024,461,93,49,48,12,17,37,45,412,98,56,32,356,101,20084
15000US060855039031,623,57,100,47,23,24,77,51,523,63,125,46,398,65,20085
15000US060855039032,313,53,20,24,0,12,20,24,293,56,79,45,214,56,20086
15000US060855040011,395,94,110,77,0,12,110,77,285,73,91,40,194,72,20087
15000US060855040012,551,103,35,43,0,12,35,43,516,101,103,63,413,99,20088
15000US060855040013,621,108,104,58,20,22,84,54,517,111,122,61,395,110,20089
15000US060855040021,690,82,86,46,19,22,67,40,604,84,191,68,413,74,20090
15000US060855040022,740,80,223,67,84,53,139,60,517,94,102,58,415,102,20091
15000US060855041011,347,77,40,36,5,7,35,35,307,78,90,48,217,69,20092
15000US060855041012,748,82,65,35,24,24,41,29,683,84,161,61,522,97,20093
15000US060855041021,661,96,28,28,7,11,21,26,633,92,98,49,535,88,20094
15000US060855041022,325,75,23,24,23,24,0,12,302,75,37,33,265,79,20095
15000US060855041023,366,94,56,51,0,12,56,51,310,86,18,19,292,89,20096
15000US060855042011,968,87,27,27,6,10,21,24,941,93,226,88,715,112,20097
15000US060855042012,374,60,4,12,0,12,4,12,370,61,96,50,274,60,20098
15000US060855042013,464,65,0,12,0,12,0,12,464,65,101,39,363,74,20099
15000US060855042021,355,62,0,12,0,12,0,12,355,62,72,36,283,57,20100
15000US060855042022,608,100,0,12,0,12,0,12,608,100,96,59,512,106,20101
15000US060855042023,510,79,12,16,0,12,12,16,498,80,68,42,430,86,20102
15000US060855043071,762,85,19,21,19,21,0,12,743,84,119,43,624,84,20103
15000US060855043072,954,81,46,51,28,42,18,18,908,81,200,66,708,96,20104
15000US060855043081,583,57,29,25,0,12,29,25,554,63,89,43,465,67,20105
15000US060855043082,508,62,25,33,25,33,0,12,483,63,171,72,312,57,20106
15000US060855043083,434,55,0,12,0,12,0,12,434,55,150,54,284,69,20107
15000US060855043111,1006,125,13,21,0,12,13,21,993,126,92,59,901,134,20108
15000US060855043112,928,119,48,77,48,77,0,12,880,115,96,85,784,117,20109
15000US060855043113,477,81,18,27,18,27,0,12,459,87,111,78,348,113,20110
15000US060855043141,289,56,49,51,10,16,39,48,240,55,75,49,165,49,20111
15000US060855043142,333,64,0,12,0,12,0,12,333,64,53,31,280,63,20112
15000US060855043143,307,50,39,50,0,12,39,50,268,58,30,27,238,59,20113
15000US060855043144,404,64,30,38,7,11,23,36,374,69,25,21,349,72,20114
15000US060855043151,607,91,29,24,0,12,29,24,578,93,47,31,531,94,20115
15000US060855043152,288,60,0,12,0,12,0,12,288,60,81,34,207,70,20116
15000US060855043153,406,72,0,12,0,12,0,12,406,72,48,33,358,76,20117
15000US060855043154,270,65,0,12,0,12,0,12,270,65,56,35,214,64,20118
15000US060855043155,429,84,85,67,30,47,55,52,344,81,50,42,294,83,20119
15000US060855043161,672,91,63,64,10,16,53,61,609,86,136,58,473,85,20120
15000US060855043162,476,79,10,15,0,12,10,15,466,81,49,36,417,87,20121
15000US060855043163,261,64,18,20,18,20,0,12,243,67,56,37,187,66,20122
15000US060855043171,636,84,23,20,7,10,16,18,613,89,126,76,487,97,20123
15000US060855043172,562,93,18,20,8,12,10,16,544,92,132,57,412,102,20124
15000US060855043181,922,92,38,27,0,12,38,27,884,94,141,55,743,102,20125
15000US060855043182,40,28,0,12,0,12,0,12,40,28,8,13,32,32,20126
15000US060855043183,543,78,86,50,19,22,67,52,457,82,90,44,367,87,20127
15000US060855043191,717,120,16,25,16,25,0,12,701,118,63,48,638,119,20128
15000US060855043192,528,93,0,12,0,12,0,12,528,93,82,45,446,101,20129
15000US060855043193,816,103,24,39,0,12,24,39,792,113,151,86,641,129,20130
15000US060855043201,522,53,7,11,7,11,0,12,515,52,97,42,418,60,20131
15000US060855043202,322,47,8,12,0,12,8,12,314,46,101,45,213,41,20132
15000US060855043211,704,75,21,23,10,17,11,17,683,78,88,51,595,82,20133
15000US060855043212,489,80,29,46,0,12,29,46,460,78,47,43,413,83,20134
15000US060855043213,396,60,25,40,0,12,25,40,371,62,116,53,255,70,20135
15000US060855043221,547,112,10,18,0,12,10,18,537,111,65,51,472,117,20136
15000US060855043222,602,107,25,38,0,12,25,38,577,101,33,38,544,108,20137
15000US060855043223,894,157,0,12,0,12,0,12,894,157,78,67,816,165,20138
15000US060855043231,387,78,51,52,9,13,42,49,336,68,85,43,251,68,20139
15000US060855043232,1283,109,0,12,0,12,0,12,1283,109,96,75,1187,133,20140
15000US060855043233,223,73,0,12,0,12,0,12,223,73,12,16,211,73,20141
15000US060855044101,534,65,67,48,33,48,34,28,467,64,113,50,354,71,20142
15000US060855044102,658,70,51,27,51,27,0,12,607,69,184,56,423,70,20143
15000US060855044111,848,78,43,34,30,28,13,19,805,79,150,57,655,90,20144
15000US060855044112,713,78,0,12,0,12,0,12,713,78,123,51,590,82,20145
15000US060855044121,313,62,14,20,0,12,14,20,299,60,107,56,192,57,20146
15000US060855044122,312,81,9,14,0,12,9,14,303,80,41,40,262,79,20147
15000US060855044123,448,78,74,58,24,23,50,55,374,88,57,44,317,91,20148
15000US060855044124,269,62,13,19,0,12,13,19,256,62,38,30,218,59,20149
15000US060855044131,721,29,5,9,0,12,5,9,716,32,195,53,521,55,20150
15000US060855044141,819,108,37,43,11,18,26,38,782,112,131,64,651,103,20151
15000US060855044142,368,81,14,21,0,12,14,21,354,82,50,33,304,81,20152
15000US060855044143,365,78,9,15,9,15,0,12,356,79,86,57,270,69,20153
15000US060855044151,599,80,0,12,0,12,0,12,599,80,40,29,559,78,20154
15000US060855044152,461,59,27,32,9,14,18,28,434,69,170,68,264,72,20155
15000US060855044153,533,70,17,19,17,19,0,12,516,72,77,48,439,84,20156
15000US060855044161,552,69,13,19,13,19,0,12,539,68,57,34,482,73,20157
15000US060855044162,564,69,26,27,0,12,26,27,538,75,110,58,428,74,20158
15000US060855044171,129,34,15,23,0,12,15,23,114,28,16,11,98,29,20159
15000US060855044181,613,90,135,96,51,64,84,74,478,102,62,51,416,106,20160
15000US060855044182,548,75,49,33,49,33,0,12,499,71,106,51,393,77,20161
15000US060855044183,191,45,8,14,8,14,0,12,183,44,21,21,162,41,20162
15000US060855044201,732,78,47,42,12,17,35,48,685,83,85,44,600,85,20163
15000US060855044202,494,92,11,18,0,12,11,18,483,92,57,37,426,96,20164
15000US060855044203,190,51,26,26,16,21,10,16,164,48,30,27,134,46,20165
15000US060855044211,399,69,9,15,9,15,0,12,390,68,123,59,267,71,20166
15000US060855044212,486,73,0,12,0,12,0,12,486,73,106,43,380,79,20167
15000US060855044213,499,69,12,19,0,12,12,19,487,70,141,50,346,72,20168
15000US060855044221,533,66,81,39,29,22,52,34,452,61,172,45,280,57,20169
15000US060855044222,528,69,38,33,31,31,7,11,490,70,81,31,409,70,20170
15000US060855044231,691,20,22,20,22,20,0,12,669,27,159,51,510,52,20171
15000US060855045041,257,101,0,12,0,12,0,12,257,101,32,48,225,96,20172
15000US060855045042,0,12,0,12,0,12,0,12,0,12,0,12,0,12,20173
15000US060855045043,361,86,0,12,0,12,0,12,361,86,0,12,361,86,20174
15000US060855045044,2281,153,48,55,18,29,30,45,2233,167,119,75,2114,173,20175
15000US060855045051,197,50,78,47,30,32,48,34,119,46,12,16,107,44,20176
15000US060855045052,695,93,23,25,23,25,0,12,672,93,153,60,519,107,20177
15000US060855045053,1128,110,44,40,9,14,35,37,1084,113,89,40,995,121,20178
15000US060855045061,457,153,0,12,0,12,0,12,457,153,81,90,376,148,20179
15000US060855045062,989,155,34,38,10,23,24,32,955,146,49,40,906,153,20180
15000US060855045063,798,159,13,21,0,12,13,21,785,158,193,117,592,169,20181
15000US060855045071,360,89,27,41,27,41,0,12,333,76,85,33,248,77,20182
15000US060855045072,515,104,33,27,15,16,18,21,482,105,95,56,387,105,20183
15000US060855045073,499,91,20,21,10,16,10,14,479,93,83,50,396,99,20184
15000US060855045074,457,77,0,12,0,12,0,12,457,77,145,65,312,79,20185
15000US060855046011,353,25,13,12,9,11,4,6,340,27,55,27,285,37,20186
15000US060855046021,635,56,65,38,20,16,45,34,570,58,91,42,479,56,20187
15000US060855047001,200,60,18,21,0,12,18,21,182,58,25,22,157,55,20188
15000US060855048021,813,105,19,20,6,10,13,17,794,105,130,66,664,111,20189
15000US060855048022,297,59,0,12,0,12,0,12,297,59,75,38,222,68,20190
15000US060855048023,687,99,4,12,4,12,0,12,683,100,96,48,587,101,20191
15000US060855048031,552,105,22,30,0,12,22,30,530,112,69,54,461,109,20192
15000US060855048032,1939,142,0,12,0,12,0,12,1939,142,170,87,1769,163,20193
15000US060855048051,1764,156,69,70,26,44,43,57,1695,169,345,129,1350,181,20194
15000US060855048052,930,123,0,12,0,12,0,12,930,123,228,94,702,133,20195
15000US060855048061,350,33,11,12,6,9,5,8,339,37,57,25,282,42,20196
15000US060855048062,425,44,37,21,19,16,18,15,388,48,97,32,291,54,20197
15000US060855049011,4123,158,26,41,26,41,0,19,4097,160,181,117,3916,196,20198
15000US060855050011,1039,149,48,46,0,12,48,46,991,146,123,73,868,149,20199
15000US060855050012,912,177,0,12,0,12,0,12,912,177,18,26,894,180,20200
15000US060855050013,896,147,17,30,17,30,0,12,879,147,77,63,802,154,20201
15000US060855050014,184,71,15,34,0,12,15,34,169,66,16,26,153,60,20202
15000US060855050015,419,104,0,12,0,12,0,12,419,104,48,44,371,115,20203
15000US060855050061,971,153,0,12,0,12,0,12,971,153,82,85,889,148,20204
15000US060855050062,2280,199,0,12,0,12,0,12,2280,199,34,45,2246,201,20205
15000US060855050071,250,60,13,12,7,8,6,9,237,59,65,27,172,54,20206
15000US060855050072,702,62,64,30,18,15,46,28,638,62,131,48,507,70,20207
15000US060855050081,2422,196,11,20,0,17,11,20,2411,196,105,74,2306,210,20208
15000US060855050082,40,65,0,12,0,12,0,12,40,65,0,12,40,65,20209
15000US060855050091,1389,198,61,66,39,56,22,31,1328,209,299,126,1029,223,20210
15000US060855050092,431,107,53,49,19,31,34,39,378,121,93,63,285,104,20211
15000US060855050093,1532,202,38,42,23,34,15,26,1494,208,139,77,1355,206,20212
15000US060855051001,1633,81,86,47,69,45,17,18,1547,94,285,84,1262,113,20213
15000US060855051002,37,31,14,22,14,22,0,12,23,29,8,18,15,25,20214
15000US060855052021,624,146,43,38,28,30,15,23,581,147,160,88,421,144,20215
15000US060855052022,1269,139,54,56,14,21,40,51,1215,148,285,98,930,147,20216
15000US060855052023,481,99,140,78,76,80,64,71,341,109,38,36,303,107,20217
15000US060855052031,1005,95,12,13,0,12,12,13,993,98,39,28,954,100,20218
15000US060855052032,442,79,42,38,42,38,0,12,400,76,80,58,320,79,20219
15000US060855053011,369,74,18,20,0,12,18,20,351,82,82,37,269,90,20220
15000US060855053012,284,63,14,15,14,15,0,12,270,68,56,37,214,69,20221
15000US060855053013,226,56,0,12,0,12,0,12,226,56,69,41,157,47,20222
15000US060855053014,533,105,46,46,0,12,46,46,487,112,59,41,428,114,20223
15000US060855053021,949,94,30,29,16,19,14,22,919,102,191,70,728,118,20224
15000US060855053022,438,70,27,30,0,12,27,30,411,68,82,46,329,70,20225
15000US060855053031,675,137,0,12,0,12,0,12,675,137,63,47,612,137,20226
15000US060855053032,598,125,0,12,0,12,0,12,598,125,68,52,530,139,20227
15000US060855053033,182,51,0,12,0,12,0,12,182,51,34,37,148,58,20228
15000US060855053034,708,134,150,79,12,20,138,77,558,147,151,62,407,148,20229
15000US060855053041,278,58,0,12,0,12,0,12,278,58,49,32,229,56,20230
15000US060855053042,313,45,0,12,0,12,0,12,313,45,81,41,232,43,20231
15000US060855053043,211,51,0,12,0,12,0,12,211,51,55,44,156,46,20232
15000US060855053044,297,68,0,12,0,12,0,12,297,68,42,34,255,73,20233
15000US060855053051,528,118,20,30,20,30,0,12,508,124,215,99,293,100,20234
15000US060855053052,366,94,0,12,0,12,0,12,366,94,31,39,335,100,20235
15000US060855053053,775,129,0,12,0,12,0,12,775,129,118,98,657,148,20236
15000US060855053054,407,89,4,10,0,12,4,10,403,93,24,32,379,87,20237
15000US060855054011,209,89,18,28,18,28,0,12,191,92,23,25,168,91,20238
15000US060855054012,825,130,0,12,0,12,0,12,825,130,23,31,802,133,20239
15000US060855054013,940,157,0,12,0,12,0,12,940,157,58,69,882,166,20240
15000US060855054014,368,72,0,12,0,12,0,12,368,72,142,65,226,71,20241
15000US060855054015,239,93,0,12,0,12,0,12,239,93,101,65,138,100,20242
15000US060855054021,368,68,0,12,0,12,0,12,368,68,68,38,300,79,20243
15000US060855054022,769,78,39,35,26,26,13,21,730,82,86,41,644,87,20244
15000US060855054031,739,126,19,33,19,33,0,12,720,127,89,58,631,125,20245
15000US060855054032,812,175,11,17,0,12,11,17,801,176,138,85,663,164,20246
15000US060855054033,1016,153,34,50,0,12,34,50,982,148,129,70,853,158,20247
15000US060855055001,325,61,0,12,0,12,0,12,325,61,58,31,267,67,20248
15000US060855055002,758,90,0,12,0,12,0,12,758,90,128,59,630,104,20249
15000US060855055003,495,66,19,30,0,12,19,30,476,68,83,42,393,69,20250
15000US060855056001,487,88,20,20,10,15,10,15,467,92,98,47,369,97,20251
15000US060855056002,252,61,0,12,0,12,0,12,252,61,86,55,166,52,20252
15000US060855056003,496,74,0,12,0,12,0,12,496,74,84,41,412,71,20253
15000US060855057001,316,103,0,12,0,12,0,12,316,103,26,37,290,102,20254
15000US060855057002,483,110,44,69,44,69,0,12,439,100,102,68,337,98,20255
15000US060855057003,715,140,0,12,0,12,0,12,715,140,37,57,678,135,20256
15000US060855057004,947,160,74,74,0,12,74,74,873,156,43,40,830,161,20257
15000US060855058001,417,82,7,11,0,12,7,11,410,80,50,33,360,86,20258
15000US060855058002,334,72,0,12,0,12,0,12,334,72,47,36,287,74,20259
15000US060855058003,375,56,0,12,0,12,0,12,375,56,73,46,302,52,20260
15000US060855058004,424,74,34,37,34,37,0,12,390,77,49,47,341,65,20261
15000US060855059001,1066,142,89,102,0,12,89,102,977,155,155,100,822,149,20262
15000US060855059002,463,121,0,12,0,12,0,12,463,121,178,87,285,125,20263
15000US060855059003,343,51,0,12,0,12,0,12,343,51,102,43,241,62,20264
15000US060855059004,738,130,20,31,20,31,0,12,718,133,90,64,628,137,20265
15000US060855059005,506,96,0,12,0,12,0,12,506,96,99,58,407,120,20266
15000US060855060001,405,85,29,37,0,12,29,37,376,84,88,47,288,84,20267
15000US060855060002,284,56,8,12,8,12,0,12,276,54,67,32,209,59,20268
15000US060855060003,863,95,0,12,0,12,0,12,863,95,57,38,806,95,20269
15000US060855060004,262,71,14,20,14,20,0,12,248,72,19,21,229,73,20270
15000US060855061011,423,68,17,25,17,25,0,12,406,70,136,54,270,69,20271
15000US060855061012,664,97,23,21,8,12,15,18,641,97,87,39,554,105,20272
15000US060855061013,643,82,0,12,0,12,0,12,643,82,129,61,514,84,20273
15000US060855061021,529,60,7,11,0,12,7,11,522,61,100,44,422,65,20274
15000US060855061022,964,80,0,12,0,12,0,12,964,80,189,62,775,87,20275
15000US060855061031,674,69,10,16,10,16,0,12,664,72,115,59,549,88,20276
15000US060855061032,272,49,0,12,0,12,0,12,272,49,43,27,229,51,20277
15000US060855061033,306,56,0,12,0,12,0,12,306,56,62,29,244,59,20278
15000US060855061034,393,65,0,12,0,12,0,12,393,65,61,31,332,75,20279
15000US060855062021,619,96,17,26,0,12,17,26,602,98,66,49,536,97,20280
15000US060855062022,935,107,0,12,0,12,0,12,935,107,113,70,822,112,20281
15000US060855062023,961,136,0,12,0,12,0,12,961,136,274,108,687,138,20282
15000US060855062031,547,138,9,16,0,12,9,16,538,139,69,73,469,145,20283
15000US060855062032,989,135,109,87,18,27,91,83,880,136,216,97,664,141,20284
15000US060855062033,843,143,0,12,0,12,0,12,843,143,80,79,763,144,20285
15000US060855062041,774,121,0,12,0,12,0,12,774,121,140,91,634,117,20286
15000US060855062042,473,100,14,23,0,12,14,23,459,103,46,41,413,101,20287
15000US060855062043,357,58,0,12,0,12,0,12,357,58,88,53,269,66,20288
15000US060855062044,482,104,0,12,0,12,0,12,482,104,68,68,414,100,20289
15000US060855063011,553,135,0,12,0,12,0,12,553,135,76,70,477,121,20290
15000US060855063012,866,164,109,72,42,46,67,61,757,179,95,71,662,176,20291
15000US060855063013,524,111,17,28,17,28,0,12,507,109,118,77,389,107,20292
15000US060855063014,347,107,0,12,0,12,0,12,347,107,77,58,270,103,20293
15000US060855063021,1070,158,51,81,0,12,51,81,1019,157,118,89,901,173,20294
15000US060855063022,717,130,0,12,0,12,0,12,717,130,124,68,593,134,20295
15000US060855063023,717,108,55,56,33,46,22,28,662,118,185,109,477,118,20296
15000US060855063041,776,133,77,73,22,32,55,65,699,117,89,56,610,123,20297
15000US060855063042,209,93,44,65,0,12,44,65,165,65,31,30,134,68,20298
15000US060855063043,1103,153,27,34,0,12,27,34,1076,159,62,65,1014,160,20299
15000US060855063051,386,132,155,114,72,88,83,99,231,100,29,34,202,101,20300
15000US060855063052,899,128,42,42,0,12,42,42,857,136,113,66,744,147,20301
15000US060855063053,570,124,5,11,0,12,5,11,565,124,103,61,462,118,20302
15000US060855063054,714,143,26,28,18,24,8,13,688,147,206,107,482,150,20303
15000US060855064011,1070,120,92,72,0,12,92,72,978,109,220,76,758,113,20304
15000US060855064012,1033,148,20,28,20,28,0,12,1013,155,155,71,858,143,20305
15000US060855064021,718,118,49,50,15,23,34,46,669,121,144,87,525,113,20306
15000US060855064022,240,50,0,12,0,12,0,12,240,50,55,40,185,64,20307
15000US060855064023,929,133,92,70,67,70,25,30,837,132,186,92,651,123,20308
15000US060855064024,366,101,19,30,0,12,19,30,347,99,53,35,294,97,20309
15000US060855065011,621,155,175,99,132,90,43,53,446,139,71,46,375,136,20310
15000US060855065012,1225,171,117,79,44,55,73,61,1108,174,255,105,853,174,20311
15000US060855065013,641,134,165,100,7,13,158,100,476,141,107,91,369,129,20312
15000US060855065021,704,70,50,56,28,46,22,35,654,86,81,55,573,73,20313
15000US060855065022,381,76,16,17,0,12,16,17,365,78,36,26,329,77,20314
15000US060855065023,793,94,21,23,0,12,21,23,772,94,104,49,668,96,20315
15000US060855065031,880,150,14,22,0,12,14,22,866,153,215,109,651,137,20316
15000US060855065032,770,128,12,20,12,20,0,12,758,128,234,102,524,124,20317
15000US060855065033,959,157,39,65,39,65,0,12,920,154,171,100,749,158,20318
15000US060855066011,678,76,0,12,0,12,0,12,678,76,101,54,577,91,20319
15000US060855066012,278,58,16,23,16,23,0,12,262,58,16,13,246,57,20320
15000US060855066013,737,98,40,45,27,42,13,14,697,95,105,51,592,94,20321
15000US060855066031,234,49,0,12,0,12,0,12,234,49,51,28,183,49,20322
15000US060855066032,667,74,21,22,0,12,21,22,646,73,190,56,456,89,20323
15000US060855066033,439,69,77,73,0,12,77,73,362,60,74,49,288,63,20324
15000US060855066041,309,83,0,12,0,12,0,12,309,83,27,32,282,78,20325
15000US060855066042,598,95,0,12,0,12,0,12,598,95,79,54,519,105,20326
15000US060855066043,584,95,0,12,0,12,0,12,584,95,172,105,412,93,20327
15000US060855066044,522,87,0,12,0,12,0,12,522,87,75,49,447,96,20328
15000US060855066045,549,85,0,12,0,12,0,12,549,85,91,60,458,99,20329
15000US060855066051,894,93,0,12,0,12,0,12,894,93,99,44,795,95,20330
15000US060855066052,614,81,22,29,0,12,22,29,592,78,126,48,466,85,20331
15000US060855066061,251,61,8,12,0,12,8,12,243,61,56,40,187,60,20332
15000US060855066062,809,105,6,12,0,12,6,12,803,106,209,87,594,103,20333
15000US060855066063,536,87,52,37,0,12,52,37,484,84,72,41,412,83,20334
15000US060855067011,282,51,23,25,13,20,10,15,259,59,12,19,247,59,20335
15000US060855067012,521,73,19,21,8,13,11,16,502,75,81,44,421,71,20336
15000US060855067013,450,62,11,17,11,17,0,12,439,63,51,26,388,61,20337
15000US060855067021,633,121,80,70,31,34,49,61,553,108,113,80,440,101,20338
15000US060855067022,747,121,7,16,0,12,7,16,740,122,137,88,603,113,20339
15000US060855067023,555,113,16,27,0,12,16,27,539,111,77,52,462,113,20340
15000US060855067031,600,90,0,12,0,12,0,12,600,90,100,65,500,102,20341
15000US060855067032,414,72,10,15,0,12,10,15,404,73,34,25,370,75,20342
15000US060855067033,294,69,56,49,38,45,18,20,238,62,78,45,160,58,20343
15000US060855068011,726,115,0,12,0,12,0,12,726,115,129,72,597,112,20344
15000US060855068012,574,98,0,12,0,12,0,12,574,98,96,72,478,94,20345
15000US060855068013,541,95,0,12,0,12,0,12,541,95,110,62,431,103,20346
15000US060855068014,331,72,0,12,0,12,0,12,331,72,53,39,278,75,20347
15000US060855068021,523,70,0,12,0,12,0,12,523,70,129,49,394,78,20348
15000US060855068022,501,85,0,12,0,12,0,12,501,85,70,43,431,89,20349
15000US060855068023,320,87,6,10,0,12,6,10,314,88,88,70,226,72,20350
15000US060855068024,278,44,17,26,0,12,17,26,261,48,35,28,226,55,20351
15000US060855068025,313,53,0,12,0,12,0,12,313,53,41,33,272,53,20352
15000US060855068031,543,90,0,12,0,12,0,12,543,90,150,76,393,94,20353
15000US060855068032,486,77,0,12,0,12,0,12,486,77,104,60,382,86,20354
15000US060855068033,1041,147,0,12,0,12,0,12,1041,147,196,114,845,164,20355
15000US060855068034,293,99,0,12,0,12,0,12,293,99,28,32,265,96,20356
15000US060855068041,281,53,0,12,0,12,0,12,281,53,41,29,240,56,20357
15000US060855068042,415,57,0,12,0,12,0,12,415,57,95,48,320,70,20358
15000US060855068043,380,71,0,12,0,12,0,12,380,71,71,38,309,75,20359
15000US060855068044,202,45,0,12,0,12,0,12,202,45,27,26,175,48,20360
15000US060855069001,439,108,0,12,0,12,0,12,439,108,68,53,371,114,20361
15000US060855069002,643,79,17,26,0,12,17,26,626,83,131,83,495,96,20362
15000US060855069003,670,113,0,12,0,12,0,12,670,113,166,79,504,114,20363
15000US060855069004,882,110,0,12,0,12,0,12,882,110,299,99,583,118,20364
15000US060855070011,1095,155,0,12,0,12,0,12,1095,155,117,97,978,162,20365
15000US060855070012,1013,144,0,12,0,12,0,12,1013,144,183,79,830,146,20366
15000US060855070013,596,125,0,12,0,12,0,12,596,125,20,23,576,128,20367
15000US060855070014,273,84,0,12,0,12,0,12,273,84,34,33,239,88,20368
15000US060855070021,665,65,0,12,0,12,0,12,665,65,103,48,562,72,20369
15000US060855070022,340,56,32,42,0,12,32,42,308,52,65,33,243,56,20370
15000US060855071001,446,68,0,12,0,12,0,12,446,68,60,37,386,78,20371
15000US060855071002,836,86,47,28,9,13,38,27,789,80,106,71,683,90,20372
15000US060855072031,616,76,25,41,25,41,0,12,591,82,81,49,510,82,20373
15000US060855072032,550,77,0,12,0,12,0,12,550,77,111,46,439,91,20374
15000US060855072051,230,53,0,12,0,12,0,12,230,53,62,52,168,43,20375
15000US060855072052,694,67,0,12,0,12,0,12,694,67,173,49,521,72,20376
15000US060855072053,577,67,0,12,0,12,0,12,577,67,119,50,458,65,20377
15000US060855072054,324,54,0,12,0,12,0,12,324,54,76,45,248,66,20378
15000US060855072061,573,58,0,12,0,12,0,12,573,58,91,41,482,68,20379
15000US060855072062,482,47,11,12,11,12,0,12,471,48,87,33,384,47,20380
15000US060855073011,253,72,0,12,0,12,0,12,253,72,82,52,171,70,20381
15000US060855073012,425,97,0,12,0,12,0,12,425,97,98,65,327,103,20382
15000US060855073013,342,85,0,12,0,12,0,12,342,85,26,23,316,87,20383
15000US060855073014,298,62,0,12,0,12,0,12,298,62,29,33,269,75,20384
15000US060855073015,453,109,0,12,0,12,0,12,453,109,11,19,442,106,20385
15000US060855073016,643,123,0,12,0,12,0,12,643,123,295,116,348,122,20386
15000US060855073021,661,68,28,40,0,12,28,40,633,75,69,43,564,83,20387
15000US060855073022,370,60,0,12,0,12,0,12,370,60,50,42,320,63,20388
15000US060855074011,431,42,9,14,0,12,9,14,422,44,57,27,365,52,20389
15000US060855074012,387,54,0,12,0,12,0,12,387,54,50,35,337,60,20390
15000US060855074013,444,47,0,12,0,12,0,12,444,47,69,35,375,56,20391
15000US060855074014,342,43,0,12,0,12,0,12,342,43,50,29,292,48,20392
15000US060855074015,256,38,0,12,0,12,0,12,256,38,19,20,237,43,20393
15000US060855074021,570,85,9,14,0,12,9,14,561,86,158,57,403,82,20394
15000US060855074022,390,54,0,12,0,12,0,12,390,54,100,46,290,61,20395
15000US060855074023,493,83,0,12,0,12,0,12,493,83,73,38,420,86,20396
15000US060855075001,721,104,0,12,0,12,0,12,721,104,75,44,646,106,20397
15000US060855075002,448,63,0,12,0,12,0,12,448,63,23,26,425,62,20398
15000US060855075003,414,62,0,12,0,12,0,12,414,62,68,42,346,76,20399
15000US060855075004,445,65,0,12,0,12,0,12,445,65,150,71,295,67,20400
15000US060855076001,226,61,0,12,0,12,0,12,226,61,39,40,187,75,20401
15000US060855076002,410,66,0,12,0,12,0,12,410,66,71,58,339,66,20402
15000US060855076003,581,71,13,21,13,21,0,12,568,74,75,47,493,90,20403
15000US060855076004,745,95,0,12,0,12,0,12,745,95,47,37,698,99,20404
15000US060855077011,360,51,0,12,0,12,0,12,360,51,68,47,292,55,20405
15000US060855077012,594,81,0,12,0,12,0,12,594,81,69,63,525,74,20406
15000US060855077013,418,60,0,12,0,12,0,12,418,60,132,48,286,66,20407
15000US060855077021,676,97,0,12,0,12,0,12,676,97,71,59,605,105,20408
15000US060855077022,552,85,0,12,0,12,0,12,552,85,113,56,439,96,20409
15000US060855077023,830,106,0,12,0,12,0,12,830,106,87,62,743,112,20410
15000US060855077031,370,80,0,12,0,12,0,12,370,80,41,39,329,87,20411
15000US060855077032,824,100,0,12,0,12,0,12,824,100,184,79,640,104,20412
15000US060855077033,706,109,0,12,0,12,0,12,706,109,123,64,583,117,20413
15000US060855077034,375,90,0,12,0,12,0,12,375,90,92,92,283,76,20414
15000US060855077035,418,64,0,12,0,12,0,12,418,64,28,30,390,68,20415
15000US060855078051,1257,112,15,24,0,12,15,24,1242,117,146,79,1096,123,20416
15000US060855078052,496,94,16,25,0,12,16,25,480,95,83,72,397,89,20417
15000US060855078053,450,76,0,12,0,12,0,12,450,76,108,71,342,89,20418
15000US060855078061,275,48,0,12,0,12,0,12,275,48,72,36,203,50,20419
15000US060855078062,644,95,9,14,0,12,9,14,635,94,37,29,598,95,20420
15000US060855078063,892,96,25,23,0,12,25,23,867,94,80,40,787,94,20421
15000US060855078071,459,54,0,12,0,12,0,12,459,54,76,41,383,62,20422
15000US060855078072,593,55,0,12,0,12,0,12,593,55,82,37,511,59,20423
15000US060855078081,316,54,0,12,0,12,0,12,316,54,20,21,296,58,20424
15000US060855078082,379,58,0,12,0,12,0,12,379,58,28,25,351,60,20425
15000US060855078083,459,73,0,12,0,12,0,12,459,73,30,28,429,77,20426
15000US060855078084,619,53,8,12,0,12,8,12,611,54,36,28,575,62,20427
15000US060855079031,542,52,0,12,0,12,0,12,542,52,52,36,490,63,20428
15000US060855079032,1084,50,0,12,0,12,0,12,1084,50,208,58,876,65,20429
15000US060855079041,609,52,0,12,0,12,0,12,609,52,100,46,509,65,20430
15000US060855079042,489,47,0,12,0,12,0,12,489,47,73,40,416,54,20431
15000US060855079051,667,126,64,75,0,12,64,75,603,145,45,42,558,143,20432
15000US060855079052,739,112,0,12,0,12,0,12,739,112,130,78,609,118,20433
15000US060855079053,746,130,9,17,0,12,9,17,737,131,29,35,708,134,20434
15000US060855079061,428,53,8,15,0,12,8,15,420,51,103,56,317,57,20435
15000US060855079062,405,52,0,12,0,12,0,12,405,52,54,40,351,58,20436
15000US060855079063,292,42,0,12,0,12,0,12,292,42,25,23,267,47,20437
15000US060855079064,286,52,0,12,0,12,0,12,286,52,46,38,240,58,20438
15000US060855080011,784,132,14,23,0,12,14,23,770,133,98,57,672,137,20439
15000US060855080012,369,94,0,12,0,12,0,12,369,94,38,38,331,109,20440
15000US060855080013,1428,149,8,15,0,12,8,15,1420,149,265,109,1155,155,20441
15000US060855080014,277,72,0,12,0,12,0,12,277,72,43,30,234,67,20442
15000US060855080031,517,37,4,7,0,12,4,7,513,37,85,32,428,49,20443
15000US060855080032,253,33,11,19,0,12,11,19,242,33,44,23,198,34,20444
15000US060855080041,921,107,11,17,0,12,11,17,910,108,179,105,731,116,20445
15000US060855080042,422,90,0,12,0,12,0,12,422,90,52,49,370,95,20446
15000US060855080043,867,101,36,43,36,43,0,12,831,100,40,45,791,109,20447
15000US060855081011,655,74,0,12,0,12,0,12,655,74,72,55,583,85,20448
15000US060855081012,690,101,0,12,0,12,0,12,690,101,67,52,623,112,20449
15000US060855081013,982,122,12,20,12,20,0,12,970,125,77,58,893,121,20450
15000US060855081021,1193,79,0,12,0,12,0,12,1193,79,42,27,1151,84,20451
15000US060855082021,419,105,21,33,21,33,0,12,398,103,140,107,258,90,20452
15000US060855082022,848,149,17,27,17,27,0,12,831,148,100,54,731,145,20453
15000US060855082023,331,70,20,33,0,12,20,33,311,66,41,40,270,76,20454
15000US060855082024,585,129,0,12,0,12,0,12,585,129,27,33,558,129,20455
15000US060855082025,589,99,0,12,0,12,0,12,589,99,87,61,502,107,20456
15000US060855082031,431,62,0,12,0,12,0,12,431,62,86,40,345,67,20457
15000US060855082032,595,72,0,12,0,12,0,12,595,72,68,36,527,79,20458
15000US060855082033,771,76,0,12,0,12,0,12,771,76,106,52,665,82,20459
15000US060855082041,634,91,0,12,0,12,0,12,634,91,108,76,526,81,20460
15000US060855082042,348,44,0,12,0,12,0,12,348,44,42,28,306,50,20461
15000US060855082043,499,60,12,20,0,12,12,20,487,58,66,39,421,66,20462
15000US060855083011,520,53,0,12,0,12,0,12,520,53,34,29,486,61,20463
15000US060855083012,421,49,0,12,0,12,0,12,421,49,118,46,303,56,20464
15000US060855083013,626,63,0,12,0,12,0,12,626,63,74,38,552,72,20465
15000US060855083031,505,37,0,12,0,12,0,12,505,37,84,34,421,42,20466
15000US060855083032,419,45,7,11,0,12,7,11,412,43,74,28,338,47,20467
15000US060855083041,547,137,0,12,0,12,0,12,547,137,96,59,451,144,20468
15000US060855083042,250,68,0,12,0,12,0,12,250,68,28,32,222,65,20469
15000US060855083043,360,64,0,12,0,12,0,12,360,64,53,44,307,65,20470
15000US060855083044,756,117,19,31,0,12,19,31,737,119,113,59,624,134,20471
15000US060855083045,1145,168,51,63,0,12,51,63,1094,183,116,87,978,182,20472
15000US060855084011,271,88,0,12,0,12,0,12,271,88,57,59,214,92,20473
15000US060855084012,373,63,0,12,0,12,0,12,373,63,66,40,307,75,20474
15000US060855084013,405,90,0,12,0,12,0,12,405,90,30,23,375,95,20475
15000US060855084014,282,54,0,12,0,12,0,12,282,54,62,41,220,56,20476
15000US060855084015,443,75,0,12,0,12,0,12,443,75,21,25,422,82,20477
15000US060855084016,576,100,0,12,0,12,0,12,576,100,145,72,431,103,20478
15000US060855084031,288,42,0,12,0,12,0,12,288,42,57,26,231,43,20479
15000US060855084032,409,63,0,12,0,12,0,12,409,63,52,27,357,67,20480
15000US060855084033,381,50,0,12,0,12,0,12,381,50,24,18,357,52,20481
15000US060855084041,1271,109,30,33,16,25,14,21,1241,112,121,67,1120,118,20482
15000US060855084042,550,74,0,12,0,12,0,12,550,74,147,65,403,88,20483
15000US060855084043,507,67,13,21,13,21,0,12,494,69,115,68,379,84,20484
15000US060855085031,777,139,0,12,0,12,0,12,777,139,86,74,691,121,20485
15000US060855085032,586,87,0,12,0,12,0,12,586,87,42,39,544,94,20486
15000US060855085033,1267,143,17,26,0,12,17,26,1250,143,157,57,1093,146,20487
15000US060855085041,1178,159,32,38,0,12,32,38,1146,163,222,95,924,162,20488
15000US060855085042,837,140,52,47,14,23,38,41,785,141,135,76,650,138,20489
15000US060855085043,494,109,0,12,0,12,0,12,494,109,29,32,465,118,20490
15000US060855085044,887,141,60,67,40,64,20,37,827,141,27,29,800,143,20491
15000US060855085051,471,59,7,10,7,10,0,12,464,60,69,30,395,68,20492
15000US060855085052,457,58,0,12,0,12,0,12,457,58,91,43,366,61,20493
15000US060855085053,986,104,10,14,0,12,10,14,976,103,125,77,851,106,20494
15000US060855085071,657,70,19,23,9,16,10,16,638,77,31,31,607,88,20495
15000US060855085072,686,80,54,43,10,17,44,40,632,83,44,47,588,86,20496
15000US060855085081,284,51,0,12,0,12,0,12,284,51,45,24,239,54,20497
15000US060855085082,532,86,0,12,0,12,0,12,532,86,67,55,465,88,20498
15000US060855085083,909,135,27,31,27,31,0,12,882,133,172,79,710,136,20499
15000US060855085084,304,90,0,12,0,12,0,12,304,90,65,49,239,93,20500
15000US060855086011,302,66,0,12,0,12,0,12,302,66,30,23,272,69,20501
15000US060855086012,547,61,10,15,10,15,0,12,537,61,65,28,472,64,20502
15000US060855086013,506,76,33,51,33,51,0,12,473,75,84,50,389,73,20503
15000US060855086021,1239,119,38,36,26,31,12,19,1201,121,266,79,935,126,20504
15000US060855086022,408,70,15,24,15,24,0,12,393,69,51,36,342,69,20505
15000US060855086023,369,90,0,12,0,12,0,12,369,90,42,32,327,89,20506
15000US060855087031,396,91,0,12,0,12,0,12,396,91,46,43,350,90,20507
15000US060855087032,731,124,0,12,0,12,0,12,731,124,18,28,713,133,20508
15000US060855087033,569,103,0,12,0,12,0,12,569,103,74,51,495,108,20509
15000US060855087034,434,96,50,37,34,37,16,27,384,96,54,60,330,81,20510
15000US060855087035,1126,164,13,21,13,21,0,12,1113,166,99,67,1014,174,20511
15000US060855087041,973,138,71,57,0,12,71,57,902,157,52,45,850,154,20512
15000US060855087042,1128,154,62,66,27,32,35,56,1066,152,150,74,916,146,20513
15000US060855087043,502,114,0,12,0,12,0,12,502,114,35,34,467,117,20514
15000US060855088001,960,93,39,43,29,40,10,17,921,92,70,38,851,93,20515
15000US060855088002,500,87,65,47,12,18,53,44,435,90,83,50,352,86,20516
15000US060855089001,1053,100,82,59,40,42,42,40,971,104,63,36,908,102,20517
15000US060855089002,412,73,0,12,0,12,0,12,412,73,80,43,332,73,20518
15000US060855089003,235,43,14,17,5,8,9,14,221,45,72,35,149,44,20519
15000US060855090001,681,159,106,116,0,12,106,116,575,137,73,58,502,135,20520
15000US060855090002,561,144,49,80,0,12,49,80,512,152,121,86,391,145,20521
15000US060855090003,837,170,54,50,39,44,15,24,783,169,53,43,730,169,20522
15000US060855090004,461,96,18,30,0,12,18,30,443,105,85,62,358,118,20523
15000US060855091021,1030,113,0,12,0,12,0,12,1030,113,153,72,877,126,20524
15000US060855091022,1244,140,27,37,27,37,0,12,1217,140,66,82,1151,152,20525
15000US060855091051,1044,158,82,99,11,18,71,101,962,166,206,99,756,165,20526
15000US060855091052,784,150,50,64,9,16,41,63,734,154,49,42,685,160,20527
15000US060855091053,593,113,0,12,0,12,0,12,593,113,56,45,537,120,20528
15000US060855091054,636,136,0,12,0,12,0,12,636,136,15,23,621,142,20529
15000US060855091061,537,82,46,49,36,48,10,16,491,73,71,33,420,79,20530
15000US060855091062,391,80,0,12,0,12,0,12,391,80,90,44,301,73,20531
15000US060855091063,765,102,64,60,0,12,64,60,701,100,51,31,650,96,20532
15000US060855091071,829,133,40,40,12,19,28,33,789,132,134,74,655,123,20533
15000US060855091072,1117,142,96,62,8,12,88,62,1021,138,37,29,984,144,20534
15000US060855091081,491,99,45,42,10,15,35,40,446,91,26,25,420,93,20535
15000US060855091082,440,88,0,12,0,12,0,12,440,88,30,27,410,90,20536
15000US060855091083,479,91,18,20,0,12,18,20,461,93,42,42,419,91,20537
15000US060855091084,557,85,29,27,9,15,20,23,528,89,110,48,418,92,20538
15000US060855091091,1288,83,0,12,0,12,0,12,1288,83,54,27,1234,89,20539
15000US060855091092,655,67,0,12,0,12,0,12,655,67,27,24,628,73,20540
15000US060855092011,598,123,0,12,0,12,0,12,598,123,47,46,551,124,20541
15000US060855092012,534,115,12,18,12,18,0,12,522,115,31,32,491,117,20542
15000US060855092013,673,156,0,12,0,12,0,12,673,156,11,18,662,160,20543
15000US060855092014,532,137,0,12,0,12,0,12,532,137,124,70,408,138,20544
15000US060855092021,851,89,29,31,29,31,0,12,822,86,181,54,641,88,20545
15000US060855092022,338,56,7,11,0,12,7,11,331,56,74,59,257,64,20546
15000US060855092023,485,75,0,12,0,12,0,12,485,75,60,52,425,77,20547
15000US060855092024,211,39,9,14,9,14,0,12,202,40,32,21,170,43,20548
15000US060855093021,1222,44,8,13,0,12,8,13,1214,46,201,73,1013,85,20549
15000US060855093031,504,79,13,20,0,12,13,20,491,80,79,46,412,75,20550
15000US060855093032,419,52,40,28,0,12,40,28,379,53,54,33,325,56,20551
15000US060855093033,394,84,31,47,0,12,31,47,363,79,79,49,284,81,20552
15000US060855093034,426,83,26,20,17,20,9,14,400,84,86,39,314,79,20553
15000US060855093041,557,94,59,53,0,12,59,53,498,106,89,44,409,103,20554
15000US060855093042,800,78,4,8,0,12,4,8,796,78,67,35,729,83,20555
15000US060855094011,780,81,50,30,35,27,15,12,730,84,72,40,658,89,20556
15000US060855094012,291,66,0,12,0,12,0,12,291,66,55,36,236,64,20557
15000US060855094013,686,83,8,13,0,12,8,13,678,82,53,43,625,87,20558
15000US060855094031,914,146,95,73,0,12,95,73,819,138,126,100,693,145,20559
15000US060855094032,1138,161,52,50,15,24,37,45,1086,160,80,67,1006,151,20560
15000US060855094041,847,119,0,12,0,12,0,12,847,119,83,59,764,111,20561
15000US060855094042,448,140,71,87,0,12,71,87,377,119,63,74,314,116,20562
15000US060855094043,940,142,17,28,17,28,0,12,923,145,193,132,730,142,20563
15000US060855094044,448,115,0,12,0,12,0,12,448,115,80,57,368,112,20564
15000US060855095001,1014,165,34,38,34,38,0,12,980,177,87,71,893,154,20565
15000US060855095002,646,122,0,12,0,12,0,12,646,122,16,26,630,120,20566
15000US060855095003,580,110,33,37,19,30,14,22,547,115,27,33,520,115,20567
15000US060855096001,936,89,27,27,0,12,27,27,909,90,92,67,817,95,20568
15000US060855096002,547,81,27,42,27,42,0,12,520,82,40,28,480,78,20569
15000US060855097001,422,53,0,12,0,12,0,12,422,53,42,29,380,55,20570
15000US060855097002,508,80,26,42,0,12,26,42,482,73,37,50,445,64,20571
15000US060855097003,478,54,0,12,0,12,0,12,478,54,48,29,430,57,20572
15000US060855098011,782,131,65,71,0,12,65,71,717,130,99,77,618,140,20573
15000US060855098012,298,61,0,12,0,12,0,12,298,61,13,22,285,63,20574
15000US060855098013,575,92,0,12,0,12,0,12,575,92,47,44,528,98,20575
15000US060855098014,517,77,12,19,12,19,0,12,505,78,81,56,424,82,20576
15000US060855098021,659,68,18,27,2,6,16,26,641,69,35,25,606,71,20577
15000US060855098022,472,58,0,12,0,12,0,12,472,58,55,40,417,66,20578
15000US060855099011,339,33,4,8,0,12,4,8,335,33,36,21,299,39,20579
15000US060855099012,350,39,0,12,0,12,0,12,350,39,24,15,326,42,20580
15000US060855099021,977,81,9,13,9,13,0,12,968,80,264,82,704,104,20581
15000US060855099022,367,53,0,12,0,12,0,12,367,53,38,25,329,54,20582
15000US060855099023,495,63,0,12,0,12,0,12,495,63,91,44,404,73,20583
15000US060855100011,317,49,0,12,0,12,0,12,317,49,61,61,256,65,20584
15000US060855100012,529,74,0,12,0,12,0,12,529,74,75,56,454,90,20585
15000US060855100013,377,77,0,12,0,12,0,12,377,77,27,31,350,85,20586
15000US060855100014,271,71,0,12,0,12,0,12,271,71,18,29,253,76,20587
15000US060855100015,293,73,0,12,0,12,0,12,293,73,61,34,232,79,20588
15000US060855100016,276,65,0,12,0,12,0,12,276,65,29,23,247,68,20589
15000US060855100021,539,56,0,12,0,12,0,12,539,56,77,38,462,71,20590
15000US060855100022,371,45,0,12,0,12,0,12,371,45,75,37,296,57,20591
15000US060855100023,381,42,8,13,0,12,8,13,373,44,21,19,352,46,20592
15000US060855101001,566,52,0,12,0,12,0,12,566,52,132,66,434,66,20593
15000US060855101002,151,35,0,12,0,12,0,12,151,35,15,12,136,35,20594
15000US060855101003,364,50,0,12,0,12,0,12,364,50,48,48,316,51,20595
15000US060855102001,566,61,0,12,0,12,0,12,566,61,52,31,514,68,20596
15000US060855102002,335,48,0,12,0,12,0,12,335,48,61,38,274,50,20597
15000US060855102003,539,54,0,12,0,12,0,12,539,54,126,54,413,71,20598
15000US060855103001,564,64,9,14,0,12,9,14,555,65,54,36,501,70,20599
15000US060855103002,717,73,0,12,0,12,0,12,717,73,81,42,636,73,20600
15000US060855103003,435,53,0,12,0,12,0,12,435,53,52,45,383,53,20601
15000US060855104001,543,67,8,13,0,12,8,13,535,67,83,44,452,72,20602
15000US060855104002,248,37,0,12,0,12,0,12,248,37,31,28,217,34,20603
15000US060855104003,374,59,0,12,0,12,0,12,374,59,34,30,340,63,20604
15000US060855105001,465,81,13,16,6,9,7,12,452,83,39,28,413,81,20605
15000US060855105002,637,64,0,12,0,12,0,12,637,64,177,59,460,57,20606
15000US060855105003,789,74,9,14,0,12,9,14,780,72,95,47,685,75,20607
15000US060855106001,257,59,0,12,0,12,0,12,257,59,31,36,226,68,20608
15000US060855106002,957,131,17,27,0,12,17,27,940,134,113,77,827,133,20609
15000US060855106003,660,115,0,12,0,12,0,12,660,115,148,84,512,122,20610
15000US060855106004,476,104,0,12,0,12,0,12,476,104,94,67,382,104,20611
15000US060855107001,271,61,0,12,0,12,0,12,271,61,21,25,250,63,20612
15000US060855107002,862,131,51,80,0,12,51,80,811,133,121,63,690,123,20613
15000US060855107003,913,115,0,12,0,12,0,12,913,115,70,45,843,123,20614
15000US060855108011,503,92,0,12,0,12,0,12,503,92,39,37,464,104,20615
15000US060855108012,688,90,0,12,0,12,0,12,688,90,51,46,637,88,20616
15000US060855108013,1019,116,14,23,0,12,14,23,1005,120,327,129,678,99,20617
15000US060855108021,309,37,0,12,0,12,0,12,309,37,48,30,261,41,20618
15000US060855108022,374,42,18,17,14,15,4,7,356,42,86,35,270,47,20619
15000US060855108031,529,78,34,43,25,40,9,14,495,84,107,61,388,89,20620
15000US060855108032,468,64,0,12,0,12,0,12,468,64,79,60,389,78,20621
15000US060855109001,663,110,0,12,0,12,0,12,663,110,31,36,632,113,20622
15000US060855109002,789,127,25,29,14,22,11,19,764,128,126,99,638,121,20623
15000US060855109003,588,97,0,12,0,12,0,12,588,97,50,45,538,101,20624
15000US060855110001,641,95,0,12,0,12,0,12,641,95,105,85,536,92,20625
15000US060855110002,592,113,16,25,0,12,16,25,576,113,31,31,545,113,20626
15000US060855110003,221,48,0,12,0,12,0,12,221,48,27,30,194,53,20627
15000US060855110004,511,73,22,25,10,16,12,19,489,81,47,56,442,83,20628
15000US060855110005,484,71,0,12,0,12,0,12,484,71,27,30,457,78,20629
15000US060855111001,480,69,0,12,0,12,0,12,480,69,64,36,416,74,20630
15000US060855111002,536,69,0,12,0,12,0,12,536,69,39,29,497,71,20631
15000US060855111003,460,55,0,12,0,12,0,12,460,55,60,37,400,68,20632
15000US060855111004,370,52,0,12,0,12,0,12,370,52,49,28,321,56,20633
15000US060855112001,533,75,15,22,0,12,15,22,518,72,79,54,439,75,20634
15000US060855112002,500,62,18,26,0,12,18,26,482,60,55,31,427,65,20635
15000US060855112003,300,47,0,12,0,12,0,12,300,47,67,42,233,60,20636
15000US060855112004,337,72,0,12,0,12,0,12,337,72,52,30,285,82,20637
15000US060855113011,1332,99,42,49,0,12,42,49,1290,112,217,60,1073,126,20638
15000US060855113012,469,68,8,13,0,12,8,13,461,69,53,35,408,67,20639
15000US060855113021,811,113,0,12,0,12,0,12,811,113,254,88,557,130,20640
15000US060855113022,300,121,16,25,0,12,16,25,284,122,0,12,284,122,20641
15000US060855113023,1025,150,39,53,0,12,39,53,986,152,80,52,906,156,20642
15000US060855114001,332,55,0,12,0,12,0,12,332,55,17,19,315,58,20643
15000US060855114002,406,61,27,33,0,12,27,33,379,59,53,42,326,62,20644
15000US060855114003,199,34,0,12,0,12,0,12,199,34,27,24,172,42,20645
15000US060855114004,398,62,0,12,0,12,0,12,398,62,46,23,352,63,20646
15000US060855115001,394,98,0,12,0,12,0,12,394,98,43,44,351,95,20647
15000US060855115002,838,141,22,26,22,26,0,12,816,143,123,86,693,125,20648
15000US060855115003,908,115,0,12,0,12,0,12,908,115,48,40,860,129,20649
15000US060855115004,336,82,0,12,0,12,0,12,336,82,83,57,253,89,20650
15000US060855115005,567,104,0,12,0,12,0,12,567,104,54,50,513,108,20651
15000US060855116081,16,17,0,12,0,12,0,12,16,17,12,20,4,6,20652
15000US060855116082,77,20,16,19,0,12,16,19,61,19,5,7,56,19,20653
15000US060855116091,1714,80,13,19,13,19,0,12,1701,81,305,98,1396,104,20654
15000US060855117011,458,81,42,66,42,66,0,12,416,68,28,18,388,72,20655
15000US060855117012,745,81,0,12,0,12,0,12,745,81,72,37,673,85,20656
15000US060855117013,362,62,3,7,3,7,0,12,359,62,22,25,337,63,20657
15000US060855117021,657,49,0,12,0,12,0,12,657,49,108,30,549,50,20658
15000US060855117022,288,35,0,12,0,12,0,12,288,35,20,15,268,37,20659
15000US060855117041,830,98,0,12,0,12,0,12,830,98,153,63,677,97,20660
15000US060855117042,239,50,0,12,0,12,0,12,239,50,40,33,199,50,20661
15000US060855117043,654,89,0,12,0,12,0,12,654,89,95,44,559,94,20662
15000US060855117051,357,15,0,12,0,12,0,12,357,15,56,21,301,24,20663
15000US060855117071,1206,76,0,12,0,12,0,12,1206,76,223,70,983,85,20664
15000US060855118001,658,92,39,47,10,15,29,44,619,100,72,40,547,95,20665
15000US060855118002,412,88,5,8,0,12,5,8,407,87,33,29,374,88,20666
15000US060855118003,575,93,38,59,0,12,38,59,537,93,68,40,469,101,20667
15000US060855119051,1063,39,0,12,0,12,0,12,1063,39,220,74,843,84,20668
15000US060855119071,540,75,0,12,0,12,0,12,540,75,47,48,493,84,20669
15000US060855119072,804,78,0,12,0,12,0,12,804,78,130,59,674,85,20670
15000US060855119091,1006,112,0,12,0,12,0,12,1006,112,149,78,857,114,20671
15000US060855119092,790,92,0,12,0,12,0,12,790,92,100,72,690,89,20672
15000US060855119093,862,101,0,12,0,12,0,12,862,101,86,51,776,113,20673
15000US060855119101,356,47,0,12,0,12,0,12,356,47,87,43,269,56,20674
15000US060855119102,242,49,0,12,0,12,0,12,242,49,38,29,204,49,20675
15000US060855119103,453,48,0,12,0,12,0,12,453,48,82,46,371,60,20676
15000US060855119111,948,89,0,12,0,12,0,12,948,89,198,75,750,91,20677
15000US060855119112,372,72,0,12,0,12,0,12,372,72,96,50,276,87,20678
15000US060855119113,559,85,0,12,0,12,0,12,559,85,83,44,476,85,20679
15000US060855119121,672,67,0,12,0,12,0,12,672,67,134,48,538,76,20680
15000US060855119122,688,65,13,20,0,12,13,20,675,73,153,77,522,73,20681
15000US060855119123,388,52,5,8,0,12,5,8,383,52,80,47,303,58,20682
15000US060855119131,440,63,0,12,0,12,0,12,440,63,79,47,361,72,20683
15000US060855119132,554,78,0,12,0,12,0,12,554,78,102,48,452,81,20684
15000US060855119133,433,66,5,9,5,9,0,12,428,69,21,20,407,69,20685
15000US060855119141,413,60,0,12,0,12,0,12,413,60,44,33,369,64,20686
15000US060855119142,1014,70,0,12,0,12,0,12,1014,70,194,61,820,81,20687
15000US060855119143,491,61,0,12,0,12,0,12,491,61,161,54,330,65,20688
15000US060855119151,455,60,8,12,8,12,0,12,447,62,132,45,315,66,20689
15000US060855119152,820,91,192,81,68,53,124,61,628,119,148,61,480,104,20690
15000US060855119161,811,85,35,37,8,14,27,35,776,94,143,75,633,104,20691
15000US060855119162,885,79,5,8,5,8,0,12,880,81,111,52,769,84,20692
15000US060855120011,1034,131,9,13,9,13,0,12,1025,133,80,74,945,140,20693
15000US060855120012,533,108,0,12,0,12,0,12,533,108,57,54,476,106,20694
15000US060855120013,445,84,10,18,10,18,0,12,435,86,55,39,380,89,20695
15000US060855120051,549,119,11,18,11,18,0,12,538,120,35,34,503,125,20696
15000US060855120052,272,83,0,12,0,12,0,12,272,83,95,58,177,81,20697
15000US060855120053,256,59,24,30,24,30,0,12,232,58,94,58,138,67,20698
15000US060855120054,463,112,41,56,0,12,41,56,422,101,173,88,249,102,20699
15000US060855120055,677,150,50,57,13,20,37,53,627,166,156,82,471,179,20700
15000US060855120171,830,128,118,96,15,29,103,94,712,125,111,61,601,124,20701
15000US060855120172,603,112,145,102,40,62,105,89,458,102,274,107,184,105,20702
15000US060855120173,780,104,133,76,31,35,102,80,647,117,245,122,402,105,20703
15000US060855120191,299,51,0,12,0,12,0,12,299,51,83,40,216,51,20704
15000US060855120192,720,76,40,46,8,13,32,45,680,76,85,58,595,81,20705
15000US060855120193,544,71,33,30,8,14,25,25,511,77,89,47,422,75,20706
15000US060855120201,238,89,22,36,22,36,0,12,216,86,40,36,176,92,20707
15000US060855120202,725,142,0,12,0,12,0,12,725,142,159,83,566,142,20708
15000US060855120203,1598,161,31,35,0,12,31,35,1567,167,148,101,1419,176,20709
15000US060855120211,388,91,0,12,0,12,0,12,388,91,56,41,332,91,20710
15000US060855120212,622,117,13,20,0,12,13,20,609,115,46,32,563,119,20711
15000US060855120213,512,97,0,12,0,12,0,12,512,97,73,48,439,103,20712
15000US060855120214,525,127,30,36,19,29,11,20,495,135,30,31,465,138,20713
15000US060855120221,349,72,16,17,9,12,7,11,333,75,72,42,261,76,20714
15000US060855120222,755,104,68,42,52,39,16,18,687,109,257,83,430,85,20715
15000US060855120223,784,96,52,58,0,12,52,58,732,98,132,66,600,111,20716
15000US060855120231,754,99,0,12,0,12,0,12,754,99,176,77,578,100,20717
15000US060855120232,548,115,71,48,10,15,61,47,477,111,126,69,351,94,20718
15000US060855120233,722,116,77,53,27,25,50,46,645,106,210,104,435,110,20719
15000US060855120241,1250,106,201,82,83,52,118,63,1049,116,197,61,852,113,20720
15000US060855120242,385,71,1,7,1,7,0,12,384,72,46,35,338,77,20721
15000US060855120251,758,58,9,15,9,15,0,12,749,58,254,74,495,66,20722
15000US060855120252,321,57,0,12,0,12,0,12,321,57,29,26,292,59,20723
15000US060855120261,669,97,112,59,38,31,74,56,557,101,124,69,433,98,20724
15000US060855120262,643,84,31,23,12,18,19,20,612,91,114,54,498,101,20725
15000US060855120271,811,104,88,69,47,56,41,46,723,112,245,82,478,93,20726
15000US060855120272,766,88,31,32,13,22,18,21,735,91,151,70,584,104,20727
15000US060855120291,460,100,2,5,2,5,0,12,458,100,95,71,363,110,20728
15000US060855120292,880,147,15,25,15,25,0,12,865,153,78,57,787,159,20729
15000US060855120293,364,113,0,12,0,12,0,12,364,113,34,39,330,115,20730
15000US060855120294,768,151,27,39,0,12,27,39,741,151,160,123,581,151,20731
15000US060855120301,620,47,10,11,6,8,4,6,610,48,98,39,512,55,20732
15000US060855120302,373,45,5,7,5,7,0,12,368,46,58,34,310,47,20733
15000US060855120311,226,62,4,8,4,8,0,12,222,63,81,59,141,48,20734
15000US060855120312,398,53,9,13,9,13,0,12,389,56,98,43,291,64,20735
15000US060855120313,427,64,10,16,10,16,0,12,417,65,36,29,381,75,20736
15000US060855120314,318,63,10,17,10,17,0,12,308,64,88,65,220,52,20737
15000US060855120321,452,58,8,15,8,15,0,12,444,59,66,31,378,65,20738
15000US060855120322,264,48,0,12,0,12,0,12,264,48,41,36,223,46,20739
15000US060855120323,290,53,9,15,9,15,0,12,281,53,114,52,167,52,20740
15000US060855120331,407,61,16,18,16,18,0,12,391,64,50,36,341,67,20741
15000US060855120332,763,109,82,74,38,58,44,49,681,103,127,65,554,104,20742
15000US060855120333,399,59,29,42,0,12,29,42,370,62,80,44,290,60,20743
15000US060855120334,464,76,18,27,0,12,18,27,446,80,116,51,330,99,20744
15000US060855120341,819,64,57,35,45,34,12,17,762,80,166,57,596,85,20745
15000US060855120342,200,47,12,18,0,12,12,18,188,48,59,33,129,49,20746
15000US060855120351,676,72,24,23,15,17,9,15,652,75,161,60,491,82,20747
15000US060855120352,736,76,22,22,13,19,9,14,714,79,95,57,619,70,20748
15000US060855120361,1888,70,25,28,25,28,0,17,1863,77,156,58,1707,92,20749
15000US060855120371,586,55,42,23,20,16,22,17,544,61,84,32,460,57,20750
15000US060855120372,389,57,24,28,24,28,0,12,365,59,80,40,285,54,20751
15000US060855120381,1073,48,105,55,51,42,54,44,968,75,171,71,797,87,20752
15000US060855120391,471,92,34,40,0,12,34,40,437,90,134,60,303,93,20753
15000US060855120392,352,72,11,18,0,12,11,18,341,71,63,44,278,64,20754
15000US060855120393,516,78,2,6,0,12,2,6,514,79,124,72,390,80,20755
15000US060855120421,422,55,16,15,0,12,16,15,406,56,82,32,324,53,20756
15000US060855120422,446,51,34,28,6,9,28,26,412,58,125,53,287,65,20757
15000US060855120431,1070,111,305,104,88,56,217,89,765,128,195,77,570,113,20758
15000US060855120432,522,83,52,34,0,12,52,34,470,88,78,45,392,92,20759
15000US060855120451,665,78,47,35,11,17,36,32,618,85,112,46,506,91,20760
15000US060855120452,252,60,10,16,0,12,10,16,242,63,64,34,178,61,20761
15000US060855120453,263,51,0,12,0,12,0,12,263,51,45,26,218,52,20762
15000US060855120454,628,88,14,19,10,16,4,9,614,89,124,70,490,92,20763
15000US060855120471,781,91,57,55,0,12,57,55,724,80,145,62,579,98,20764
15000US060855120472,495,81,15,17,8,13,7,12,480,85,91,46,389,85,20765
15000US060855120473,432,71,9,14,9,14,0,12,423,71,72,41,351,71,20766
15000US060855120521,500,99,10,15,0,12,10,15,490,99,44,46,446,101,20767
15000US060855120522,803,110,18,20,18,20,0,12,785,113,166,59,619,117,20768
15000US060855120523,459,59,0,12,0,12,0,12,459,59,121,53,338,61,20769
15000US060855120531,778,107,52,38,35,32,17,20,726,110,98,57,628,105,20770
15000US060855120532,358,65,13,20,0,12,13,20,345,67,50,38,295,74,20771
15000US060855120533,297,57,21,21,21,21,0,12,276,55,48,36,228,54,20772
15000US060855121001,455,36,48,38,8,10,40,36,407,48,111,43,296,58,20773
15000US060855122001,607,97,0,12,0,12,0,12,607,97,133,65,474,96,20774
15000US060855122002,1050,104,0,12,0,12,0,12,1050,104,122,69,928,114,20775
15000US060855123051,1048,87,0,12,0,12,0,12,1048,87,212,100,836,123,20776
15000US060855123052,432,80,9,13,0,12,9,13,423,81,20,24,403,80,20777
15000US060855123071,430,76,43,48,19,29,24,40,387,76,47,44,340,78,20778
15000US060855123072,914,115,49,54,0,12,49,54,865,117,188,85,677,135,20779
15000US060855123073,1015,126,15,24,0,12,15,24,1000,125,348,91,652,127,20780
15000US060855123081,749,122,0,12,0,12,0,12,749,122,108,76,641,119,20781
15000US060855123082,791,144,0,12,0,12,0,12,791,144,80,64,711,135,20782
15000US060855123083,924,121,0,12,0,12,0,12,924,121,277,109,647,132,20783
15000US060855123091,996,80,106,75,0,12,106,75,890,103,246,75,644,100,20784
15000US060855123092,716,83,11,17,0,12,11,17,705,83,129,52,576,82,20785
15000US060855123101,1056,105,91,70,28,28,63,61,965,110,203,69,762,115,20786
15000US060855123102,391,85,56,52,0,12,56,52,335,82,47,50,288,77,20787
15000US060855123111,1189,59,0,12,0,12,0,12,1189,59,242,82,947,90,20788
15000US060855123121,1079,46,49,35,0,12,49,35,1030,57,210,62,820,76,20789
15000US060855123131,753,98,68,58,0,12,68,58,685,104,92,41,593,108,20790
15000US060855123132,433,98,66,53,42,43,24,40,367,85,97,48,270,89,20791
15000US060855123141,657,98,0,12,0,12,0,12,657,98,125,47,532,104,20792
15000US060855123142,256,77,27,23,18,16,9,14,229,74,42,46,187,62,20793
15000US060855123143,775,126,139,81,49,45,90,72,636,119,102,54,534,120,20794
15000US060855123144,470,92,43,40,0,12,43,40,427,87,35,39,392,82,20795
15000US060855124011,957,98,81,69,25,40,56,55,876,101,223,74,653,127,20796
15000US060855124012,463,88,11,19,0,12,11,19,452,86,137,51,315,90,20797
15000US060855124021,889,99,37,45,14,23,23,37,852,102,206,79,646,109,20798
15000US060855124022,238,67,24,33,0,12,24,33,214,68,35,29,179,66,20799
15000US060855124023,319,61,20,31,0,12,20,31,299,59,66,42,233,61,20800
15000US060855125031,1684,152,0,17,0,17,0,17,1684,152,222,117,1462,173,20801
15000US060855125032,1047,138,18,27,0,12,18,27,1029,139,114,67,915,142,20802
15000US060855125051,1262,138,26,29,16,25,10,16,1236,137,233,122,1003,144,20803
15000US060855125052,924,146,130,74,9,18,121,74,794,147,70,65,724,149,20804
15000US060855125061,733,100,195,83,61,54,134,68,538,105,69,47,469,105,20805
15000US060855125062,504,94,155,87,49,51,106,70,349,89,52,32,297,86,20806
15000US060855125063,669,85,124,50,30,39,94,56,545,84,133,48,412,90,20807
15000US060855125081,674,132,37,31,21,17,16,25,637,134,181,96,456,145,20808
15000US060855125082,887,161,205,120,25,36,180,122,682,160,222,141,460,141,20809
15000US060855125083,540,126,61,78,15,24,46,74,479,113,82,54,397,109,20810
15000US060855125084,529,144,76,67,44,57,32,36,453,155,127,86,326,151,20811
15000US060855125091,831,89,73,47,32,39,41,40,758,86,192,71,566,112,20812
15000US060855125092,396,76,0,12,0,12,0,12,396,76,64,36,332,75,20813
15000US060855125101,871,132,13,20,0,12,13,20,858,137,267,104,591,126,20814
15000US060855125102,346,89,33,36,19,28,14,23,313,86,36,37,277,85,20815
15000US060855125103,1041,182,55,68,41,63,14,21,986,179,123,77,863,181,20816
15000US060855126021,355,72,48,36,7,13,41,33,307,75,68,33,239,64,20817
15000US060855126022,447,55,40,34,19,24,21,24,407,56,108,39,299,53,20818
15000US060855126031,320,50,65,34,26,19,39,30,255,57,68,28,187,55,20819
15000US060855126032,215,43,45,31,17,18,28,25,170,43,29,23,141,41,20820
15000US060855126033,566,69,196,58,67,39,129,49,370,67,93,45,277,68,20821
15000US060855126041,475,69,112,53,0,12,112,53,363,78,125,48,238,79,20822
15000US060855126042,494,67,196,63,43,34,153,62,298,76,46,38,252,74,20823
15000US060855126043,205,48,63,54,26,39,37,37,142,43,44,33,98,37,20824
15000US060855130001,720,132,0,12,0,12,0,12,720,132,33,36,687,130,20825
15000US060855130002,634,104,0,12,0,12,0,12,634,104,14,22,620,103,20826
15000US060855130003,869,119,0,12,0,12,0,12,869,119,0,12,869,119,20827
15000US060855135001,306,51,0,12,0,12,0,12,306,51,42,28,264,53,20828
15000US060871001001,305,50,0,12,0,12,0,12,305,50,88,43,217,47,20829
15000US060871001002,496,45,7,10,0,12,7,10,489,43,103,35,386,52,20830
15000US060871002001,234,87,0,12,0,12,0,12,234,87,62,55,172,98,20831
15000US060871002002,269,97,0,12,0,12,0,12,269,97,23,26,246,100,20832
15000US060871002003,624,132,45,76,0,12,45,76,579,128,193,99,386,121,20833
15000US060871002004,230,87,0,12,0,12,0,12,230,87,18,29,212,96,20834
15000US060871002005,493,130,72,77,15,25,57,74,421,125,43,42,378,124,20835
15000US060871002006,487,103,82,56,30,28,52,49,405,105,108,69,297,101,20836
15000US060871002007,257,131,13,21,13,21,0,12,244,133,44,56,200,140,20837
15000US060871003001,614,89,85,68,0,12,85,68,529,96,124,50,405,101,20838
15000US060871003002,657,87,5,9,5,9,0,12,652,87,144,65,508,88,20839
15000US060871004001,157,39,5,5,0,12,5,5,152,38,13,11,139,40,20840
15000US060871004002,0,12,0,12,0,12,0,12,0,12,0,12,0,12,20841
15000US060871004003,278,66,90,40,31,18,59,37,188,56,15,15,173,53,20842
15000US060871005001,526,126,0,12,0,12,0,12,526,126,75,47,451,126,20843
15000US060871005002,801,130,27,24,12,21,15,25,774,133,77,52,697,138,20844
15000US060871005003,959,161,51,49,0,12,51,49,908,166,131,69,777,168,20845
15000US060871006001,565,93,42,33,10,15,32,29,523,95,76,41,447,102,20846
15000US060871006002,417,72,0,12,0,12,0,12,417,72,58,33,359,71,20847
15000US060871006003,302,66,18,19,9,13,9,14,284,67,52,37,232,72,20848
15000US060871007001,418,69,22,22,9,16,13,16,396,72,91,38,305,71,20849
15000US060871007002,547,75,78,47,29,43,49,35,469,78,177,74,292,84,20850
15000US060871008001,571,114,45,43,18,29,27,32,526,122,54,50,472,128,20851
15000US060871008002,339,121,0,12,0,12,0,12,339,121,69,48,270,123,20852
15000US060871008003,601,132,21,33,0,12,21,33,580,139,54,51,526,153,20853
15000US060871008004,807,218,115,110,0,12,115,110,692,223,56,54,636,222,20854
15000US060871008005,478,86,50,38,0,12,50,38,428,87,68,58,360,101,20855
15000US060871008006,210,73,41,47,0,12,41,47,169,66,12,20,157,67,20856
15000US060871009001,629,110,54,62,16,23,38,56,575,109,105,73,470,110,20857
15000US060871009002,722,151,45,71,0,12,45,71,677,165,236,121,441,152,20858
15000US060871009003,221,85,12,19,0,12,12,19,209,84,37,38,172,76,20859
15000US060871009004,144,69,0,12,0,12,0,12,144,69,32,49,112,66,20860
15000US060871009005,304,106,0,12,0,12,0,12,304,106,16,27,288,103,20861
15000US060871010001,857,190,183,125,94,101,89,89,674,176,105,77,569,182,20862
15000US060871010002,222,110,0,12,0,12,0,12,222,110,16,25,206,110,20863
15000US060871010003,229,102,0,12,0,12,0,12,229,102,0,12,229,102,20864
15000US060871010004,219,97,25,33,0,12,25,33,194,90,113,81,81,58,20865
15000US060871010005,226,98,7,18,0,12,7,18,219,97,39,46,180,95,20866
15000US060871010006,1195,204,170,101,70,59,100,90,1025,213,185,128,840,202,20867
15000US060871010007,770,188,74,52,0,12,74,52,696,191,55,49,641,191,20868
15000US060871011001,399,104,43,53,29,48,14,23,356,103,97,67,259,94,20869
15000US060871011002,451,101,0,12,0,12,0,12,451,101,75,57,376,96,20870
15000US060871011003,271,62,14,22,14,22,0,12,257,70,60,49,197,70,20871
15000US060871011004,576,126,33,39,0,12,33,39,543,130,94,54,449,130,20872
15000US060871011005,410,86,12,21,0,12,12,21,398,89,94,68,304,102,20873
15000US060871012001,302,65,27,25,12,18,15,17,275,66,40,33,235,67,20874
15000US060871012002,403,57,0,12,0,12,0,12,403,57,40,28,363,66,20875
15000US060871012003,545,80,8,12,0,12,8,12,537,83,91,40,446,90,20876
15000US060871101001,494,167,121,116,0,12,121,116,373,154,185,125,188,114,20877
15000US060871101002,346,141,163,121,73,84,90,89,183,107,30,36,153,99,20878
15000US060871101003,523,150,51,56,21,35,30,39,472,144,166,60,306,150,20879
15000US060871101004,1101,191,129,91,69,78,60,70,972,180,326,132,646,156,20880
15000US060871102001,473,117,68,67,54,63,14,23,405,113,128,78,277,104,20881
15000US060871102002,430,108,10,17,0,12,10,17,420,108,123,70,297,114,20882
15000US060871102003,303,109,34,34,23,29,11,17,269,121,34,42,235,117,20883
15000US060871102004,445,113,98,87,0,12,98,87,347,106,187,98,160,101,20884
15000US060871102005,542,123,27,42,0,12,27,42,515,111,139,66,376,120,20885
15000US060871103001,247,77,13,16,13,16,0,12,234,77,20,22,214,75,20886
15000US060871103002,362,90,137,61,31,35,106,53,225,85,105,54,120,67,20887
15000US060871103003,554,95,79,54,0,12,79,54,475,89,61,44,414,97,20888
15000US060871103004,609,95,275,84,86,58,189,81,334,104,66,45,268,98,20889
15000US060871104001,437,94,96,58,26,29,70,53,341,97,44,32,297,97,20890
15000US060871104002,282,90,63,44,0,12,63,44,219,84,73,41,146,86,20891
15000US060871104003,322,85,50,46,8,13,42,43,272,85,80,49,192,76,20892
15000US060871104004,895,109,80,60,15,24,65,54,815,101,125,61,690,113,20893
15000US060871105011,814,167,230,134,64,59,166,115,584,167,135,90,449,144,20894
15000US060871105012,577,158,95,76,34,51,61,48,482,145,111,62,371,142,20895
15000US060871105013,398,82,47,41,32,35,15,23,351,83,48,45,303,78,20896
15000US060871105014,310,121,17,29,17,29,0,12,293,129,53,52,240,127,20897
15000US060871105021,514,111,77,53,27,28,50,46,437,108,133,64,304,86,20898
15000US060871105022,530,107,127,69,13,17,114,71,403,103,84,44,319,103,20899
15000US060871105023,400,72,86,79,28,44,58,70,314,106,136,80,178,75,20900
15000US060871106001,635,172,141,110,40,47,101,100,494,162,150,106,344,156,20901
15000US060871106002,293,121,69,86,16,27,53,81,224,110,19,30,205,113,20902
15000US060871106003,347,106,59,51,17,26,42,46,288,105,93,61,195,91,20903
15000US060871106004,647,150,103,80,35,40,68,73,544,158,163,101,381,152,20904
15000US060871106005,258,88,51,51,27,31,24,39,207,78,22,33,185,74,20905
15000US060871107001,339,72,93,47,29,33,64,44,246,73,54,35,192,69,20906
15000US060871107002,333,71,33,32,25,32,8,11,300,72,80,40,220,65,20907
15000US060871107003,220,57,30,32,5,9,25,30,190,52,49,26,141,49,20908
15000US060871202001,1058,81,64,34,49,32,15,12,994,87,248,69,746,91,20909
15000US060871202002,553,69,5,7,0,12,5,7,548,69,157,43,391,64,20910
15000US060871203011,888,161,48,50,0,12,48,50,840,163,141,80,699,153,20911
15000US060871203012,569,102,0,12,0,12,0,12,569,102,89,62,480,110,20912
15000US060871203013,520,102,6,11,0,12,6,11,514,103,115,79,399,102,20913
15000US060871203021,243,65,14,16,7,12,7,13,229,63,55,38,174,56,20914
15000US060871203022,419,74,0,12,0,12,0,12,419,74,94,59,325,62,20915
15000US060871203023,388,92,39,43,0,12,39,43,349,101,80,53,269,90,20916
15000US060871204001,514,105,0,12,0,12,0,12,514,105,133,67,381,109,20917
15000US060871204002,389,90,32,36,0,12,32,36,357,91,22,26,335,90,20918
15000US060871204003,773,203,40,43,19,29,21,30,733,207,105,79,628,211,20919
15000US060871204004,425,88,80,73,68,70,12,20,345,74,26,29,319,76,20920
15000US060871205001,257,39,0,12,0,12,0,12,257,39,61,29,196,39,20921
15000US060871205002,649,98,0,12,0,12,0,12,649,98,154,63,495,95,20922
15000US060871205003,683,113,27,30,27,30,0,12,656,118,136,85,520,124,20923
15000US060871205004,599,139,13,20,13,20,0,12,586,140,97,52,489,144,20924
15000US060871205005,279,81,44,70,0,12,44,70,235,61,90,53,145,57,20925
15000US060871206001,247,73,0,12,0,12,0,12,247,73,87,51,160,69,20926
15000US060871206002,427,94,39,32,22,26,17,22,388,101,77,53,311,97,20927
15000US060871206003,245,68,14,22,0,12,14,22,231,66,59,38,172,63,20928
15000US060871206004,622,88,59,47,14,18,45,43,563,86,51,35,512,92,20929
15000US060871206005,324,54,8,14,0,12,8,14,316,53,41,31,275,57,20930
15000US060871207001,313,103,42,53,31,50,11,15,271,92,73,58,198,76,20931
15000US060871207002,587,100,32,33,32,33,0,12,555,95,73,44,482,84,20932
15000US060871207003,635,106,15,16,15,16,0,12,620,110,91,46,529,111,20933
15000US060871208001,927,140,0,12,0,12,0,12,927,140,332,113,595,134,20934
15000US060871208002,848,130,0,12,0,12,0,12,848,130,177,79,671,127,20935
15000US060871208003,555,112,0,12,0,12,0,12,555,112,90,46,465,112,20936
15000US060871209001,1037,176,42,43,0,12,42,43,995,183,189,88,806,182,20937
15000US060871209002,502,123,0,12,0,12,0,12,502,123,96,50,406,120,20938
15000US060871209003,893,131,43,44,29,41,14,21,850,127,169,83,681,125,20939
15000US060871209004,703,139,0,12,0,12,0,12,703,139,159,87,544,144,20940
15000US060871210001,623,69,0,12,0,12,0,12,623,69,94,49,529,77,20941
15000US060871210002,381,67,0,12,0,12,0,12,381,67,43,28,338,77,20942
15000US060871210003,372,61,6,7,0,12,6,7,366,62,24,21,342,63,20943
15000US060871211001,293,39,8,8,6,9,2,3,285,39,64,25,221,40,20944
15000US060871211002,901,58,34,28,23,21,11,14,867,59,179,56,688,77,20945
15000US060871212001,411,119,4,8,0,12,4,8,407,119,43,28,364,127,20946
15000US060871212002,503,85,0,12,0,12,0,12,503,85,84,42,419,92,20947
15000US060871212003,655,131,10,16,0,12,10,16,645,130,150,91,495,121,20948
15000US060871212004,354,70,0,12,0,12,0,12,354,70,126,76,228,57,20949
15000US060871212005,369,108,72,95,0,12,72,95,297,98,61,36,236,94,20950
15000US060871213001,905,84,36,25,8,13,28,22,869,88,191,58,678,94,20951
15000US060871213002,178,37,0,12,0,12,0,12,178,37,13,14,165,38,20952
15000US060871213003,405,74,34,39,34,39,0,12,371,70,36,33,335,72,20953
15000US060871213004,263,72,86,68,25,38,61,61,177,83,17,20,160,88,20954
15000US060871214011,364,59,61,34,34,20,27,27,303,67,77,37,226,59,20955
15000US060871214012,562,63,34,30,11,12,23,27,528,67,98,35,430,68,20956
15000US060871214021,617,84,48,39,25,29,23,25,569,87,171,66,398,81,20957
15000US060871214022,741,112,18,20,18,20,0,12,723,113,140,54,583,118,20958
15000US060871214023,241,64,7,12,0,12,7,12,234,65,55,37,179,64,20959
15000US060871214031,801,95,56,38,56,38,0,12,745,104,130,60,615,109,20960
15000US060871214032,371,54,0,12,0,12,0,12,371,54,81,58,290,62,20961
15000US060871214033,162,71,0,12,0,12,0,12,162,71,19,19,143,75,20962
15000US060871215001,258,93,0,12,0,12,0,12,258,93,21,32,237,101,20963
15000US060871215002,513,126,151,100,106,93,45,63,362,111,73,75,289,107,20964
15000US060871215003,714,138,21,33,0,12,21,33,693,138,168,84,525,147,20965
15000US060871215004,431,148,26,31,0,12,26,31,405,148,4,12,401,146,20966
15000US060871215005,455,124,104,100,79,90,25,41,351,121,32,31,319,124,20967
15000US060871216001,393,144,17,27,17,27,0,12,376,144,97,88,279,126,20968
15000US060871216002,395,124,34,53,0,12,34,53,361,115,78,61,283,94,20969
15000US060871216003,856,203,72,107,0,12,72,107,784,188,192,91,592,177,20970
15000US060871216004,715,146,0,12,0,12,0,12,715,146,50,49,665,149,20971
15000US060871216005,503,177,107,88,60,56,47,69,396,154,81,82,315,136,20972
15000US060871217001,1083,147,44,47,0,12,44,47,1039,145,175,96,864,149,20973
15000US060871217002,209,89,0,12,0,12,0,12,209,89,36,38,173,93,20974
15000US060871217003,264,75,16,26,16,26,0,12,248,73,11,18,237,77,20975
15000US060871217004,825,152,68,53,14,23,54,49,757,163,192,86,565,155,20976
15000US060871217005,325,100,0,12,0,12,0,12,325,100,45,45,280,106,20977
15000US060871217006,225,84,60,56,17,26,43,50,165,75,19,30,146,79,20978
15000US060871218001,450,112,23,29,0,12,23,29,427,112,108,59,319,116,20979
15000US060871218002,942,173,0,12,0,12,0,12,942,173,246,129,696,197,20980
15000US060871218003,550,116,30,35,18,28,12,20,520,119,131,71,389,128,20981
15000US060871218004,238,79,0,12,0,12,0,12,238,79,80,63,158,61,20982
15000US060871220011,578,92,36,29,20,23,16,18,542,98,62,36,480,101,20983
15000US060871220012,228,65,0,12,0,12,0,12,228,65,60,39,168,64,20984
15000US060871220013,320,76,104,85,43,68,61,60,216,52,37,22,179,47,20985
15000US060871220014,165,55,0,12,0,12,0,12,165,55,59,53,106,38,20986
15000US060871220015,562,64,0,12,0,12,0,12,562,64,86,34,476,63,20987
15000US060871220021,783,93,40,39,10,15,30,41,743,95,110,49,633,99,20988
15000US060871220022,496,83,10,16,0,12,10,16,486,81,135,66,351,83,20989
15000US060871220031,577,95,58,44,16,25,42,43,519,96,79,54,440,98,20990
15000US060871220032,371,101,0,12,0,12,0,12,371,101,64,49,307,110,20991
15000US060871220033,1113,126,57,41,27,32,30,34,1056,140,378,126,678,149,20992
15000US060871220034,349,124,15,22,0,12,15,22,334,125,48,38,286,123,20993
15000US060871220035,243,109,18,30,18,30,0,12,225,98,0,12,225,98,20994
15000US060871221001,380,82,13,15,0,12,13,15,367,84,84,60,283,72,20995
15000US060871221002,545,79,50,42,30,35,20,24,495,84,127,49,368,81,20996
15000US060871221003,526,85,27,24,27,24,0,12,499,87,134,60,365,88,20997
15000US060871222011,458,113,22,35,0,12,22,35,436,114,97,61,339,105,20998
15000US060871222012,501,163,0,12,0,12,0,12,501,163,144,101,357,156,20999
15000US060871222013,503,101,0,12,0,12,0,12,503,101,145,74,358,106,21000
15000US060871222014,328,102,0,12,0,12,0,12,328,102,0,12,328,102,21001
15000US060871222015,281,91,0,12,0,12,0,12,281,91,48,44,233,92,21002
15000US060871222016,524,114,0,12,0,12,0,12,524,114,31,35,493,115,21003
15000US060871222017,237,85,26,42,0,12,26,42,211,82,66,65,145,80,21004
15000US060871222021,929,55,31,29,21,24,10,15,898,61,181,51,717,74,21005
15000US060871222031,1043,94,39,45,0,12,39,45,1004,87,279,77,725,91,21006
15000US060871222032,590,77,38,21,16,18,22,19,552,78,108,54,444,83,21007
15000US060871223001,328,91,51,39,30,32,21,23,277,87,58,35,219,80,21008
15000US060871223002,282,60,6,9,6,9,0,12,276,60,59,37,217,55,21009
15000US060871223003,792,102,40,32,8,13,32,33,752,99,145,53,607,104,21010
15000US060871224001,770,130,76,61,20,34,56,53,694,130,148,83,546,140,21011
15000US060871224002,369,77,21,30,0,12,21,30,348,82,33,45,315,91,21012
15000US060871224003,553,135,35,40,0,12,35,40,518,130,147,92,371,115,21013
15000US060871224004,353,70,0,12,0,12,0,12,353,70,63,55,290,71,21014
15000US060871224005,189,67,0,12,0,12,0,12,189,67,58,58,131,73,21015
15000US060871224006,335,112,29,47,29,47,0,12,306,110,95,75,211,106,21016
15000US060871225001,394,90,28,27,19,21,9,15,366,96,77,44,289,102,21017
15000US060871225002,483,119,48,63,0,12,48,63,435,109,182,103,253,97,21018
15000US060871225003,319,91,39,46,26,40,13,20,280,84,100,51,180,76,21019
15000US060871225004,376,103,42,34,31,38,11,19,334,113,81,44,253,121,21020
15000US060871231001,485,57,43,39,27,35,16,14,442,57,155,50,287,63,21021
15000US060871231002,326,54,37,26,20,21,17,19,289,58,65,33,224,60,21022
15000US060871233001,474,33,28,30,10,11,18,27,446,42,51,29,395,48,21023
15000US060879901000,0,12,0,12,0,12,0,12,0,12,0,12,0,12,21024
15000US060890101001,354,80,24,22,6,9,18,24,330,77,133,50,197,71,21025
15000US060890101002,338,74,67,57,38,40,29,39,271,67,134,52,137,43,21026
15000US060890102001,1021,91,75,44,28,24,47,35,946,91,323,72,623,86,21027
15000US060890103001,653,100,75,40,27,34,48,33,578,100,204,69,374,105,21028
15000US060890103002,880,111,115,58,14,17,101,55,765,126,235,88,530,117,21029
15000US060890104001,462,92,18,20,18,20,0,12,444,93,182,77,262,71,21030
15000US060890104002,398,67,37,37,23,37,14,16,361,62,82,38,279,58,21031
15000US060890104003,252,60,25,20,16,18,9,17,227,63,97,50,130,60,21032
15000US060890104004,479,74,14,16,0,12,14,16,465,73,121,52,344,76,21033
15000US060890105001,704,171,125,90,76,62,49,57,579,178,239,136,340,149,21034
15000US060890105002,621,179,19,26,0,12,19,26,602,180,151,70,451,165,21035
15000US060890105003,753,168,73,76,15,23,58,70,680,180,172,75,508,188,21036
15000US060890106011,504,66,32,23,14,16,18,17,472,63,114,44,358,76,21037
15000US060890106012,467,54,0,12,0,12,0,12,467,54,114,33,353,56,21038
15000US060890106021,530,114,36,45,0,12,36,45,494,121,140,99,354,139,21039
15000US060890106022,317,110,0,12,0,12,0,12,317,110,30,35,287,112,21040
15000US060890106023,613,134,67,82,33,61,34,54,546,128,198,98,348,115,21041
15000US060890106024,798,155,15,26,15,26,0,12,783,154,276,163,507,166,21042
15000US060890106031,266,48,80,50,15,18,65,48,186,56,77,48,109,50,21043
15000US060890106032,349,45,0,12,0,12,0,12,349,45,79,37,270,46,21044
15000US060890107021,832,94,172,75,103,63,69,59,660,107,200,83,460,82,21045
15000US060890107022,775,88,24,38,24,38,0,12,751,92,185,74,566,87,21046
15000US060890107031,520,102,80,60,17,21,63,57,440,97,65,39,375,101,21047
15000US060890107032,1063,124,140,56,78,57,62,43,923,136,209,79,714,137,21048
15000US060890107041,560,120,64,39,54,37,10,13,496,120,200,74,296,102,21049
15000US060890107042,521,127,82,70,64,64,18,22,439,112,222,97,217,74,21050
15000US060890107043,833,120,138,73,68,56,70,51,695,117,264,97,431,115,21051
15000US060890108031,736,136,47,43,37,40,10,16,689,140,167,90,522,140,21052
15000US060890108032,492,136,87,64,61,62,26,30,405,137,49,66,356,126,21053
15000US060890108033,1014,151,162,112,33,44,129,104,852,147,246,84,606,154,21054
15000US060890108041,349,47,17,14,5,8,12,12,332,51,111,38,221,54,21055
15000US060890108042,554,46,0,12,0,12,0,12,554,46,211,51,343,53,21056
15000US060890108051,437,101,56,63,45,60,11,19,381,89,162,76,219,88,21057
15000US060890108052,1402,106,67,55,26,25,41,49,1335,116,379,91,956,144,21058
15000US060890108061,855,90,81,49,56,44,25,23,774,97,331,93,443,93,21059
15000US060890108062,567,87,73,47,34,28,39,37,494,98,189,73,305,96,21060
15000US060890108071,823,93,21,18,21,18,0,12,802,93,276,85,526,85,21061
15000US060890108072,804,92,26,25,7,13,19,21,778,96,224,74,554,95,21062
15000US060890109001,959,119,133,69,83,50,50,40,826,126,262,76,564,111,21063
15000US060890109002,726,108,39,26,26,25,13,15,687,111,168,69,519,119,21064
15000US060890110011,275,38,31,23,15,12,16,18,244,37,77,20,167,37,21065
15000US060890110012,340,45,4,7,4,7,0,12,336,45,79,35,257,44,21066
15000US060890110021,522,84,5,7,0,12,5,7,517,84,140,63,377,88,21067
15000US060890110022,429,99,75,78,43,70,32,35,354,77,104,71,250,78,21068
15000US060890110023,542,128,188,95,8,15,180,89,354,127,109,77,245,117,21069
15000US060890110024,629,142,109,80,74,76,35,42,520,138,152,74,368,138,21070
15000US060890111001,666,99,19,21,9,14,10,15,647,100,217,77,430,101,21071
15000US060890111002,493,88,0,12,0,12,0,12,493,88,103,57,390,87,21072
15000US060890112091,602,136,54,70,9,15,45,66,548,135,38,37,510,136,21073
15000US060890112092,525,126,179,110,74,73,105,72,346,117,131,83,215,103,21074
15000US060890112093,450,126,30,42,5,12,25,39,420,125,192,92,228,103,21075
15000US060890112094,470,146,249,137,175,125,74,75,221,110,67,70,154,92,21076
15000US060890113001,472,121,67,46,44,40,23,21,405,122,104,75,301,108,21077
15000US060890113002,422,115,66,39,24,26,42,30,356,113,161,85,195,67,21078
15000US060890113003,419,81,71,44,33,42,38,31,348,86,94,47,254,81,21079
15000US060890113004,495,95,77,55,47,50,30,32,418,88,94,75,324,99,21080
15000US060890114011,574,85,40,31,19,22,21,21,534,88,147,55,387,99,21081
15000US060890114012,463,77,36,31,20,23,16,21,427,83,90,41,337,81,21082
15000US060890114013,404,64,19,24,15,23,4,7,385,64,135,51,250,74,21083
15000US060890114021,494,67,7,11,0,12,7,11,487,67,106,49,381,69,21084
15000US060890114022,624,75,66,56,12,18,54,51,558,91,126,57,432,97,21085
15000US060890114031,520,87,0,12,0,12,0,12,520,87,159,61,361,81,21086
15000US060890114032,477,66,17,21,10,17,7,11,460,64,123,44,337,62,21087
15000US060890115001,288,123,0,12,0,12,0,12,288,123,157,114,131,77,21088
15000US060890115002,594,174,0,12,0,12,0,12,594,174,217,135,377,146,21089
15000US060890115003,870,196,89,66,73,62,16,24,781,186,231,105,550,178,21090
15000US060890115004,418,139,0,12,0,12,0,12,418,139,123,66,295,135,21091
15000US060890116001,337,70,0,12,0,12,0,12,337,70,127,56,210,70,21092
15000US060890116002,686,86,55,39,35,33,20,22,631,92,232,73,399,85,21093
15000US060890116003,458,92,115,58,21,22,94,54,343,86,108,46,235,80,21094
15000US060890117011,200,40,8,9,0,12,8,9,192,40,80,35,112,33,21095
15000US060890117012,635,73,78,47,14,20,64,42,557,77,148,53,409,74,21096
15000US060890117021,452,89,200,74,89,48,111,68,252,85,115,60,137,66,21097
15000US060890117022,460,84,54,34,26,24,28,27,406,89,115,49,291,88,21098
15000US060890117023,369,69,119,70,65,62,54,47,250,61,106,48,144,49,21099
15000US060890117031,353,72,12,14,12,14,0,12,341,76,102,54,239,78,21100
15000US060890117032,348,86,79,58,35,34,44,47,269,73,131,57,138,73,21101
15000US060890117033,496,82,35,30,8,13,27,31,461,89,145,55,316,103,21102
15000US060890118011,477,61,17,14,3,4,14,13,460,63,148,47,312,52,21103
15000US060890118012,419,49,25,15,5,7,20,13,394,50,139,45,255,52,21104
15000US060890118021,365,51,29,21,20,16,9,13,336,51,79,35,257,50,21105
15000US060890118022,573,69,43,26,22,18,21,22,530,67,144,48,386,64,21106
15000US060890118031,348,71,10,14,10,14,0,12,338,72,100,44,238,70,21107
15000US060890118032,323,77,21,23,9,14,12,19,302,77,116,41,186,71,21108
15000US060890118033,376,108,68,51,26,41,42,42,308,107,105,68,203,90,21109
15000US060890119001,499,89,16,18,7,11,9,14,483,89,126,66,357,88,21110
15000US060890119002,431,68,28,22,3,6,25,22,403,68,75,31,328,78,21111
15000US060890119003,375,66,3,5,3,5,0,12,372,67,129,53,243,54,21112
15000US060890119004,408,72,25,20,9,13,16,17,383,75,77,39,306,69,21113
15000US060890120001,279,78,23,20,8,11,15,17,256,78,54,41,202,83,21114
15000US060890120002,455,74,52,33,41,30,11,16,403,71,112,49,291,71,21115
15000US060890120003,394,104,203,76,91,58,112,58,191,91,46,40,145,88,21116
15000US060890120004,715,117,77,53,43,41,34,37,638,118,312,108,326,97,21117
15000US060890121011,438,91,51,36,19,21,32,33,387,87,171,69,216,93,21118
15000US060890121012,586,93,88,47,44,36,44,42,498,97,159,56,339,97,21119
15000US060890121013,728,104,60,40,52,39,8,13,668,112,233,80,435,102,21120
15000US060890121021,373,46,26,28,23,27,3,7,347,42,94,33,253,44,21121
15000US060890121022,511,84,83,40,40,28,43,29,428,83,214,55,214,68,21122
15000US060890122001,635,170,6,11,6,11,0,12,629,169,201,116,428,151,21123
15000US060890122002,350,109,0,12,0,12,0,12,350,109,77,53,273,113,21124
15000US060890122003,500,116,79,77,11,18,68,75,421,126,144,85,277,128,21125
15000US060890122004,661,153,97,82,17,29,80,84,564,147,223,120,341,147,21126
15000US060890123011,579,108,92,52,50,37,42,39,487,116,121,49,366,116,21127
15000US060890123012,540,87,159,61,62,34,97,54,381,95,207,81,174,79,21128
15000US060890123021,422,97,17,29,0,12,17,29,405,97,139,91,266,104,21129
15000US060890123022,151,67,28,43,28,43,0,12,123,68,68,62,55,46,21130
15000US060890123023,635,117,22,33,22,33,0,12,613,125,218,78,395,127,21131
15000US060890123024,848,145,13,22,13,22,0,12,835,147,220,107,615,158,21132
15000US060890123031,726,80,11,17,11,17,0,12,715,80,253,86,462,90,21133
15000US060890123032,758,88,78,50,56,44,22,26,680,91,208,74,472,97,21134
15000US060890124001,476,67,49,31,35,27,14,14,427,66,162,47,265,64,21135
15000US060890124002,364,61,40,27,19,12,21,25,324,63,101,49,223,65,21136
15000US060890124003,730,97,45,36,3,5,42,36,685,91,147,46,538,91,21137
15000US060890125001,269,55,10,10,10,10,0,12,259,55,113,35,146,43,21138
15000US060890125002,397,75,55,36,41,34,14,12,342,70,110,43,232,69,21139
15000US060890126011,680,100,70,48,15,21,55,42,610,106,207,99,403,87,21140
15000US060890126012,508,69,18,15,8,10,10,11,490,70,190,48,300,57,21141
15000US060890126013,748,103,25,15,7,6,18,14,723,103,274,67,449,90,21142
15000US060890126031,357,96,9,15,0,12,9,15,348,97,104,40,244,91,21143
15000US060890126032,556,100,10,17,10,17,0,12,546,99,302,80,244,92,21144
15000US060890126033,416,101,32,28,32,28,0,12,384,102,257,95,127,62,21145
15000US060890126034,377,63,26,23,7,11,19,20,351,63,158,60,193,54,21146
15000US060890126041,351,51,5,9,5,9,0,12,346,51,125,49,221,44,21147
15000US060890126042,560,64,30,21,19,19,11,8,530,67,160,43,370,57,21148
15000US060890127011,739,127,75,64,50,50,25,26,664,130,177,85,487,109,21149
15000US060890127012,330,102,46,50,22,34,24,38,284,97,173,92,111,47,21150
15000US060890127013,529,101,77,48,42,33,35,45,452,97,121,55,331,93,21151
15000US060890127014,274,78,8,12,8,12,0,12,266,79,82,55,184,73,21152
15000US060890127021,247,74,22,25,22,25,0,12,225,70,123,67,102,54,21153
15000US060890127022,527,113,65,40,65,40,0,12,462,119,100,56,362,117,21154
15000US060890127023,548,115,25,40,0,12,25,40,523,117,273,105,250,98,21155
15000US060910100001,250,80,10,13,2,3,8,12,240,78,53,30,187,77,21156
15000US060910100002,284,82,38,25,15,14,23,21,246,76,105,66,141,53,21157
15000US060910100003,192,91,5,11,5,11,0,12,187,89,71,57,116,69,21158
15000US060910100004,375,96,0,12,0,12,0,12,375,96,13,22,362,96,21159
15000US060910100005,174,65,0,12,0,12,0,12,174,65,54,39,120,61,21160
15000US060930001001,486,51,65,28,14,12,51,25,421,55,161,42,260,43,21161
15000US060930002001,709,65,64,32,11,8,53,29,645,63,218,53,427,56,21162
15000US060930003001,669,69,96,33,44,25,52,26,573,66,207,50,366,52,21163
15000US060930003002,513,62,72,42,64,41,8,8,441,58,188,47,253,55,21164
15000US060930003003,507,62,55,21,21,11,34,19,452,62,195,40,257,54,21165
15000US060930004001,270,36,43,21,20,13,23,16,227,37,83,25,144,33,21166
15000US060930005001,409,53,52,26,39,22,13,11,357,53,141,37,216,39,21167
15000US060930005002,277,46,30,26,5,8,25,25,247,48,100,31,147,44,21168
15000US060930005003,199,41,14,9,9,8,5,8,185,40,39,19,146,35,21169
15000US060930006001,746,69,49,22,24,18,25,20,697,70,229,60,468,64,21170
15000US060930007011,293,43,28,19,11,12,17,15,265,41,95,34,170,42,21171
15000US060930007012,527,98,57,38,23,20,34,31,470,97,189,67,281,95,21172
15000US060930007013,485,82,61,32,38,23,23,22,424,80,102,36,322,82,21173
15000US060930007014,317,63,29,22,18,13,11,17,288,65,122,45,166,55,21174
15000US060930007021,909,113,231,85,138,78,93,52,678,132,302,80,376,124,21175
15000US060930007022,1100,135,286,96,139,79,147,68,814,124,395,84,419,99,21176
15000US060930007031,290,64,55,52,34,44,21,33,235,49,113,55,122,54,21177
15000US060930007032,538,99,127,66,67,63,60,42,411,88,168,66,243,71,21178
15000US060930007033,567,87,88,44,46,38,42,48,479,98,108,45,371,92,21179
15000US060930008001,842,115,130,72,71,55,59,43,712,106,190,73,522,106,21180
15000US060930008002,214,53,36,21,28,22,8,10,178,45,83,33,95,37,21181
15000US060930008003,377,76,60,38,41,35,19,15,317,69,50,21,267,68,21182
15000US060930009001,253,67,79,50,45,26,34,44,174,50,96,42,78,34,21183
15000US060930009002,556,122,94,48,44,36,50,39,462,132,150,114,312,98,21184
15000US060930009003,265,57,100,41,8,8,92,42,165,53,97,45,68,33,21185
15000US060930009004,1351,109,97,44,65,39,32,23,1254,107,336,58,918,100,21186
15000US060930009005,327,63,52,33,35,28,17,20,275,63,117,45,158,53,21187
15000US060930009006,212,54,15,19,1,3,14,19,197,53,45,27,152,51,21188
15000US060930010001,218,89,37,40,0,12,37,40,181,101,85,58,96,88,21189
15000US060930010002,494,94,39,44,0,12,39,44,455,95,117,63,338,105,21190
15000US060930010003,989,161,34,40,20,32,14,22,955,169,237,128,718,168,21191
15000US060930010004,871,138,81,58,13,22,68,53,790,134,174,76,616,127,21192
15000US060930010005,720,138,0,12,0,12,0,12,720,138,224,103,496,163,21193
15000US060930011001,191,44,28,20,10,13,18,15,163,44,25,16,138,45,21194
15000US060930011002,318,49,31,19,17,13,14,14,287,47,74,29,213,47,21195
15000US060930011003,423,56,68,30,31,16,37,25,355,48,144,32,211,44,21196
15000US060930012001,613,68,42,27,7,8,35,27,571,69,191,47,380,66,21197
15000US060952501031,455,97,67,57,25,34,42,46,388,78,113,58,275,71,21198
15000US060952501032,705,115,111,66,37,28,74,60,594,120,116,53,478,124,21199
15000US060952501033,387,100,15,17,0,12,15,17,372,101,106,56,266,83,21200
15000US060952501041,336,58,19,15,10,10,9,11,317,63,45,27,272,64,21201
15000US060952501042,478,64,58,37,47,35,11,11,420,72,153,49,267,63,21202
15000US060952501051,709,164,39,48,19,32,20,34,670,171,149,97,521,179,21203
15000US060952501052,725,187,18,22,7,14,11,17,707,192,268,140,439,180,21204
15000US060952501053,773,208,29,47,29,47,0,12,744,200,224,171,520,138,21205
15000US060952501061,608,84,0,12,0,12,0,12,608,84,132,48,476,76,21206
15000US060952501062,788,90,7,12,7,12,0,12,781,90,147,64,634,100,21207
15000US060952502001,609,111,94,51,16,20,78,48,515,117,130,55,385,115,21208
15000US060952502002,302,88,8,14,0,12,8,14,294,87,61,40,233,91,21209
15000US060952502003,561,117,41,32,37,29,4,9,520,119,220,102,300,110,21210
15000US060952503001,445,81,70,60,41,46,29,37,375,79,142,63,233,67,21211
15000US060952503002,402,107,120,67,35,34,85,64,282,103,122,77,160,67,21212
15000US060952503003,267,92,3,14,3,14,0,12,264,88,67,42,197,87,21213
15000US060952504001,313,70,38,30,17,20,21,21,275,76,90,39,185,73,21214
15000US060952504002,435,82,10,16,0,12,10,16,425,82,104,45,321,81,21215
15000US060952504003,286,67,53,41,42,38,11,16,233,60,90,44,143,66,21216
15000US060952505011,381,55,44,37,8,13,36,34,337,61,78,35,259,60,21217
15000US060952505012,395,58,23,24,18,22,5,8,372,54,83,39,289,61,21218
15000US060952505021,472,96,27,23,8,12,19,21,445,97,132,77,313,76,21219
15000US060952505022,528,94,33,31,33,31,0,12,495,94,144,60,351,74,21220
15000US060952506011,626,95,93,67,80,65,13,20,533,116,136,57,397,92,21221
15000US060952506012,705,105,84,54,10,15,74,51,621,103,297,112,324,84,21222
15000US060952506013,229,74,47,50,38,48,9,14,182,61,41,30,141,65,21223
15000US060952506041,621,108,22,25,12,21,10,14,599,111,97,57,502,111,21224
15000US060952506042,369,64,0,12,0,12,0,12,369,64,58,34,311,69,21225
15000US060952506043,394,83,29,47,0,12,29,47,365,67,61,39,304,65,21226
15000US060952506051,355,85,7,13,0,12,7,13,348,84,60,42,288,89,21227
15000US060952506052,441,76,12,18,0,12,12,18,429,76,61,44,368,75,21228
15000US060952506053,781,99,53,46,8,14,45,44,728,105,90,48,638,112,21229
15000US060952507011,615,113,136,70,41,33,95,62,479,124,157,78,322,117,21230
15000US060952507012,517,99,53,49,26,30,27,42,464,105,146,71,318,115,21231
15000US060952508011,580,58,10,14,10,14,0,12,570,60,173,64,397,74,21232
15000US060952508012,404,73,75,52,49,36,26,42,329,76,143,53,186,68,21233
15000US060952508013,452,102,86,61,14,21,72,59,366,100,68,52,298,94,21234
15000US060952509001,407,126,201,105,47,58,154,101,206,83,117,65,89,55,21235
15000US060952509002,800,129,301,84,80,55,221,78,499,102,128,62,371,101,21236
15000US060952510001,424,89,154,65,43,56,111,52,270,83,42,32,228,80,21237
15000US060952510002,310,82,51,49,7,11,44,47,259,76,75,49,184,70,21238
15000US060952510003,324,99,25,24,7,11,18,21,299,103,28,23,271,105,21239
15000US060952511001,727,103,72,56,7,11,65,55,655,103,161,68,494,93,21240
15000US060952511002,378,99,90,55,54,41,36,36,288,96,74,67,214,97,21241
15000US060952512001,490,86,62,49,36,47,26,22,428,91,96,59,332,89,21242
15000US060952512002,440,89,78,61,46,51,32,33,362,97,56,38,306,99,21243
15000US060952512003,352,83,38,31,18,21,20,23,314,82,55,42,259,89,21244
15000US060952513001,368,74,0,12,0,12,0,12,368,74,59,30,309,76,21245
15000US060952513002,353,57,27,28,27,28,0,12,326,58,117,48,209,58,21246
15000US060952513003,458,82,20,21,20,21,0,12,438,85,132,46,306,88,21247
15000US060952514001,784,178,112,100,29,33,83,94,672,166,138,90,534,165,21248
15000US060952514002,562,131,33,37,0,12,33,37,529,131,144,65,385,141,21249
15000US060952514003,780,167,169,124,32,39,137,124,611,135,132,62,479,139,21250
15000US060952515001,310,95,65,52,9,15,56,60,245,81,66,49,179,81,21251
15000US060952515002,464,120,151,114,49,67,102,98,313,92,81,59,232,84,21252
15000US060952515003,690,100,277,92,104,76,173,76,413,86,100,50,313,88,21253
15000US060952516001,299,85,51,42,0,12,51,42,248,83,23,22,225,79,21254
15000US060952516002,770,101,111,66,56,54,55,40,659,103,133,67,526,106,21255
15000US060952517011,599,83,175,89,43,49,132,78,424,87,166,59,258,77,21256
15000US060952517012,769,101,123,63,45,37,78,53,646,102,166,58,480,92,21257
15000US060952517021,370,61,23,16,18,14,5,7,347,62,89,39,258,62,21258
15000US060952517022,567,86,74,45,23,25,51,39,493,93,67,28,426,92,21259
15000US060952518021,1213,107,359,110,121,64,238,96,854,121,384,99,470,114,21260
15000US060952518031,257,68,33,50,0,12,33,50,224,61,35,29,189,52,21261
15000US060952518032,292,84,18,26,6,12,12,25,274,85,45,35,229,77,21262
15000US060952518033,366,87,24,34,24,34,0,12,342,85,84,56,258,89,21263
15000US060952518034,469,109,6,22,6,22,0,12,463,108,64,50,399,103,21264
15000US060952518041,322,66,74,55,16,27,58,51,248,59,92,31,156,59,21265
15000US060952518042,329,57,18,19,6,11,12,15,311,60,75,31,236,61,21266
15000US060952518043,321,67,12,14,5,7,7,12,309,68,72,38,237,63,21267
15000US060952519011,769,120,145,88,34,28,111,87,624,115,171,65,453,108,21268
15000US060952519012,365,82,31,46,31,46,0,12,334,72,175,54,159,60,21269
15000US060952519013,695,115,100,51,74,43,26,29,595,114,198,80,397,117,21270
15000US060952519021,365,83,0,12,0,12,0,12,365,83,181,67,184,83,21271
15000US060952519022,560,122,81,65,72,64,9,13,479,102,153,70,326,93,21272
15000US060952519023,286,92,61,72,0,12,61,72,225,81,28,26,197,80,21273
15000US060952519024,562,112,161,99,38,56,123,79,401,100,123,47,278,100,21274
15000US060952519031,377,78,30,29,8,14,22,24,347,74,81,49,266,73,21275
15000US060952519032,643,100,49,39,6,10,43,39,594,104,143,65,451,112,21276
15000US060952519033,633,94,68,37,43,31,25,38,565,91,75,37,490,98,21277
15000US060952520001,744,137,45,70,0,12,45,70,699,127,230,83,469,141,21278
15000US060952520002,410,109,13,21,13,21,0,12,397,106,45,36,352,106,21279
15000US060952520003,512,132,26,42,0,12,26,42,486,135,187,123,299,134,21280
15000US060952520004,482,117,0,12,0,12,0,12,482,117,49,52,433,117,21281
15000US060952521021,777,115,76,71,16,20,60,66,701,115,217,79,484,116,21282
15000US060952521022,696,107,83,64,45,50,38,42,613,105,108,78,505,98,21283
15000US060952521031,477,100,23,37,23,37,0,12,454,104,25,21,429,104,21284
15000US060952521032,730,97,0,12,0,12,0,12,730,97,211,74,519,118,21285
15000US060952521033,773,131,34,28,9,14,25,24,739,132,140,82,599,145,21286
15000US060952521041,825,80,91,39,0,12,91,39,734,80,145,53,589,83,21287
15000US060952521042,521,75,0,12,0,12,0,12,521,75,80,41,441,80,21288
15000US060952521043,466,71,0,12,0,12,0,12,466,71,84,46,382,76,21289
15000US060952521051,645,71,0,12,0,12,0,12,645,71,172,61,473,71,21290
15000US060952521052,605,88,39,47,0,12,39,47,566,88,95,56,471,79,21291
15000US060952521061,614,79,0,12,0,12,0,12,614,79,185,67,429,95,21292
15000US060952521062,448,73,0,12,0,12,0,12,448,73,66,38,382,77,21293
15000US060952521063,655,99,42,37,8,12,34,41,613,105,123,60,490,108,21294
15000US060952521071,914,76,8,13,0,12,8,13,906,73,181,71,725,95,21295
15000US060952521072,490,62,0,12,0,12,0,12,490,62,127,49,363,70,21296
15000US060952521081,542,66,11,17,0,12,11,17,531,71,75,40,456,77,21297
15000US060952521082,803,76,23,25,0,12,23,25,780,79,133,55,647,89,21298
15000US060952522011,1344,158,58,59,0,12,58,59,1286,175,184,104,1102,187,21299
15000US060952522012,257,72,0,12,0,12,0,12,257,72,45,41,212,77,21300
15000US060952522013,254,58,0,12,0,12,0,12,254,58,79,46,175,64,21301
15000US060952522014,1175,132,48,45,34,39,14,23,1127,138,151,81,976,154,21302
15000US060952522021,490,118,47,74,47,74,0,12,443,108,21,24,422,111,21303
15000US060952522022,721,143,13,20,13,20,0,12,708,147,119,103,589,155,21304
15000US060952522023,618,106,0,12,0,12,0,12,618,106,133,69,485,115,21305
15000US060952522024,1362,168,23,36,0,12,23,36,1339,171,207,93,1132,185,21306
15000US060952523051,782,107,15,22,0,12,15,22,767,104,109,57,658,102,21307
15000US060952523052,238,62,0,12,0,12,0,12,238,62,67,34,171,58,21308
15000US060952523053,660,94,31,44,0,12,31,44,629,102,186,69,443,92,21309
15000US060952523061,444,63,11,15,11,15,0,12,433,65,148,56,285,68,21310
15000US060952523062,797,77,11,17,0,12,11,17,786,81,152,66,634,92,21311
15000US060952523101,947,78,0,12,0,12,0,12,947,78,344,92,603,107,21312
15000US060952523102,314,72,14,22,0,12,14,22,300,71,93,43,207,62,21313
15000US060952523111,430,63,0,12,0,12,0,12,430,63,163,60,267,50,21314
15000US060952523112,734,87,20,23,0,12,20,23,714,90,136,61,578,90,21315
15000US060952523113,285,51,0,12,0,12,0,12,285,51,70,43,215,52,21316
15000US060952523121,551,66,8,13,8,13,0,12,543,64,122,41,421,68,21317
15000US060952523122,791,97,121,62,42,47,79,45,670,101,128,63,542,106,21318
15000US060952523131,517,137,142,127,0,12,142,127,375,120,33,26,342,128,21319
15000US060952523132,647,153,28,51,28,51,0,12,619,170,293,114,326,134,21320
15000US060952523133,1029,146,0,12,0,12,0,12,1029,146,343,121,686,146,21321
15000US060952523141,392,88,53,54,37,52,16,22,339,88,100,52,239,87,21322
15000US060952523142,352,86,0,12,0,12,0,12,352,86,117,59,235,84,21323
15000US060952523143,617,105,77,45,44,35,33,29,540,96,100,52,440,100,21324
15000US060952523151,442,68,30,39,23,37,7,12,412,74,146,59,266,70,21325
15000US060952523152,438,85,16,21,0,12,16,21,422,83,96,60,326,81,21326
15000US060952523153,556,68,11,14,11,14,0,12,545,72,142,71,403,79,21327
15000US060952523161,594,86,0,12,0,12,0,12,594,86,138,59,456,86,21328
15000US060952523162,544,67,96,68,41,44,55,51,448,70,160,66,288,78,21329
15000US060952523171,685,134,0,12,0,12,0,12,685,134,141,100,544,137,21330
15000US060952523172,1468,148,0,17,0,17,0,17,1468,148,281,104,1187,155,21331
15000US060952524011,298,73,15,17,10,15,5,9,283,74,90,50,193,69,21332
15000US060952524012,286,75,7,11,7,11,0,12,279,76,100,54,179,64,21333
15000US060952524013,313,55,52,41,52,41,0,12,261,58,92,41,169,51,21334
15000US060952524014,416,79,64,48,0,12,64,48,352,84,56,43,296,84,21335
15000US060952524021,413,110,23,33,0,12,23,33,390,114,115,60,275,114,21336
15000US060952524022,622,104,34,34,8,14,26,33,588,102,224,59,364,102,21337
15000US060952524023,714,110,250,98,50,35,200,102,464,112,90,47,374,105,21338
15000US060952525011,173,44,45,31,35,30,10,11,128,43,9,11,119,42,21339
15000US060952525012,740,61,151,60,70,48,81,45,589,73,272,77,317,71,21340
15000US060952525021,319,46,78,40,42,32,36,29,241,52,77,40,164,44,21341
15000US060952525022,335,53,56,44,6,8,50,43,279,61,37,21,242,64,21342
15000US060952526041,160,56,39,38,18,29,21,25,121,43,31,24,90,44,21343
15000US060952526042,535,101,151,89,32,38,119,85,384,100,60,36,324,98,21344
15000US060952526043,343,107,78,57,28,37,50,49,265,97,66,50,199,92,21345
15000US060952526051,1105,126,320,112,146,80,174,93,785,147,221,102,564,136,21346
15000US060952526052,470,88,65,49,20,33,45,34,405,96,102,34,303,97,21347
15000US060952526053,320,84,118,67,60,56,58,39,202,75,105,67,97,48,21348
15000US060952526061,752,107,122,80,63,45,59,63,630,104,306,82,324,100,21349
15000US060952526062,393,102,80,60,23,33,57,53,313,97,66,47,247,95,21350
15000US060952526063,487,96,107,81,51,53,56,54,380,98,65,48,315,89,21351
15000US060952526071,320,79,46,35,9,10,37,34,274,78,80,34,194,76,21352
15000US060952526072,830,92,148,79,61,60,87,59,682,94,90,60,592,97,21353
15000US060952526081,343,84,69,63,9,13,60,62,274,70,75,49,199,58,21354
15000US060952526082,945,93,248,92,151,84,97,60,697,101,287,101,410,98,21355
15000US060952526101,573,81,139,85,102,87,37,37,434,85,138,54,296,82,21356
15000US060952526102,455,67,35,31,15,18,20,29,420,74,109,55,311,78,21357
15000US060952526111,411,86,99,62,28,24,71,56,312,80,160,74,152,75,21358
15000US060952526112,282,83,5,8,5,8,0,12,277,84,80,64,197,66,21359
15000US060952526113,381,87,157,86,0,12,157,86,224,87,74,61,150,90,21360
15000US060952527021,581,149,51,61,36,56,15,23,530,144,114,84,416,130,21361
15000US060952527022,283,118,68,81,15,24,53,75,215,104,60,60,155,90,21362
15000US060952527023,236,89,100,87,0,12,100,87,136,62,0,12,136,62,21363
15000US060952527024,442,126,20,24,9,16,11,18,422,127,70,59,352,118,21364
15000US060952527025,343,90,0,12,0,12,0,12,343,90,16,18,327,89,21365
15000US060952527026,354,99,39,59,39,59,0,12,315,97,76,59,239,94,21366
15000US060952527031,279,69,28,30,14,21,14,21,251,63,9,15,242,61,21367
15000US060952527032,497,99,8,15,8,15,0,12,489,99,92,48,397,96,21368
15000US060952527033,442,96,31,39,0,12,31,39,411,99,125,80,286,96,21369
15000US060952527041,415,95,76,60,32,35,44,62,339,85,123,65,216,72,21370
15000US060952527042,225,82,20,22,11,17,9,14,205,85,43,28,162,86,21371
15000US060952527043,271,70,16,24,0,12,16,24,255,72,76,51,179,76,21372
15000US060952527044,154,53,0,12,0,12,0,12,154,53,24,22,130,53,21373
15000US060952527045,590,93,57,58,6,9,51,57,533,99,245,79,288,89,21374
15000US060952527051,402,109,12,17,0,12,12,17,390,108,36,27,354,107,21375
15000US060952527052,249,77,8,13,0,12,8,13,241,78,159,72,82,47,21376
15000US060952527053,220,54,0,12,0,12,0,12,220,54,49,31,171,62,21377
15000US060952527054,547,103,51,44,0,12,51,44,496,105,142,71,354,105,21378
15000US060952527055,369,78,19,23,5,8,14,22,350,77,64,33,286,80,21379
15000US060952527061,1193,50,18,19,7,11,11,15,1175,53,313,82,862,95,21380
15000US060952527071,798,87,219,86,122,69,97,62,579,88,216,79,363,111,21381
15000US060952527072,676,102,93,70,47,35,46,60,583,97,223,67,360,87,21382
15000US060952527073,203,63,5,12,5,12,0,12,198,64,68,35,130,61,21383
15000US060952528011,18,21,0,12,0,12,0,12,18,21,0,12,18,21,21384
15000US060952528012,0,12,0,12,0,12,0,12,0,12,0,12,0,12,21385
15000US060952528013,303,51,0,12,0,12,0,12,303,51,29,29,274,56,21386
15000US060952528014,357,59,0,12,0,12,0,12,357,59,49,32,308,60,21387
15000US060952528015,162,58,0,12,0,12,0,12,162,58,38,39,124,41,21388
15000US060952528021,280,71,0,12,0,12,0,12,280,71,13,15,267,71,21389
15000US060952528022,0,12,0,12,0,12,0,12,0,12,0,12,0,12,21390
15000US060952529031,408,79,46,38,10,16,36,35,362,72,85,49,277,83,21391
15000US060952529032,359,65,9,15,9,15,0,12,350,66,78,40,272,59,21392
15000US060952529033,555,80,0,12,0,12,0,12,555,80,130,48,425,79,21393
15000US060952529034,343,77,44,50,16,18,28,46,299,71,78,38,221,75,21394
15000US060952529041,640,100,8,13,8,13,0,12,632,100,217,80,415,113,21395
15000US060952529042,1182,134,44,36,27,29,17,22,1138,136,122,63,1016,149,21396
15000US060952529043,432,97,11,18,11,18,0,12,421,99,90,61,331,92,21397
15000US060952529081,333,79,13,14,13,14,0,12,320,80,53,34,267,85,21398
15000US060952529082,671,90,114,83,58,42,56,64,557,93,74,44,483,94,21399
15000US060952529083,279,77,0,12,0,12,0,12,279,77,105,59,174,66,21400
15000US060952529091,516,77,32,28,21,23,11,18,484,77,106,46,378,82,21401
15000US060952529092,534,71,8,14,0,12,8,14,526,73,137,41,389,82,21402
15000US060952529101,428,87,15,19,8,15,7,12,413,89,112,70,301,73,21403
15000US060952529102,450,70,33,30,18,19,15,24,417,68,135,65,282,65,21404
15000US060952529103,718,109,10,12,3,6,7,11,708,109,197,82,511,104,21405
15000US060952529104,413,79,26,41,0,12,26,41,387,78,39,33,348,80,21406
15000US060952529111,950,145,100,76,12,19,88,77,850,142,291,113,559,151,21407
15000US060952529112,660,125,14,23,14,23,0,12,646,125,204,80,442,137,21408
15000US060952529113,239,75,0,12,0,12,0,12,239,75,46,41,193,85,21409
15000US060952529114,879,114,19,25,6,13,13,21,860,118,445,112,415,106,21410
15000US060952529121,442,77,21,33,21,33,0,12,421,73,115,54,306,73,21411
15000US060952529122,265,74,0,12,0,12,0,12,265,74,58,34,207,78,21412
15000US060952529123,359,87,0,12,0,12,0,12,359,87,56,40,303,90,21413
15000US060952529124,401,67,9,16,0,12,9,16,392,68,102,57,290,71,21414
15000US060952529125,369,63,0,12,0,12,0,12,369,63,84,38,285,72,21415
15000US060952529131,393,87,34,52,34,52,0,12,359,91,122,46,237,86,21416
15000US060952529132,416,83,16,21,16,21,0,12,400,85,97,52,303,95,21417
15000US060952529133,363,73,8,14,0,12,8,14,355,72,47,28,308,77,21418
15000US060952529134,456,88,9,13,9,13,0,12,447,91,50,31,397,91,21419
15000US060952529141,914,86,45,48,38,46,7,11,869,93,244,100,625,121,21420
15000US060952529142,486,114,19,28,19,28,0,12,467,114,95,54,372,99,21421
15000US060952529143,401,62,30,24,5,11,25,22,371,66,80,53,291,65,21422
15000US060952529151,433,82,23,19,13,20,10,16,410,83,81,44,329,80,21423
15000US060952529152,854,90,12,21,0,12,12,21,842,93,122,65,720,100,21424
15000US060952530001,0,17,0,17,0,17,0,17,0,17,0,17,0,17,21425
15000US060952531011,211,78,68,53,29,29,39,45,143,62,55,39,88,49,21426
15000US060952531012,229,71,64,50,0,12,64,50,165,59,86,52,79,34,21427
15000US060952531013,422,88,24,36,0,12,24,36,398,86,115,67,283,85,21428
15000US060952531014,291,69,8,11,0,12,8,11,283,69,106,54,177,71,21429
15000US060952531015,445,90,36,39,0,12,36,39,409,85,65,36,344,90,21430
15000US060952531016,449,64,68,52,54,51,14,16,381,73,143,57,238,74,21431
15000US060952531051,493,107,63,50,37,39,26,31,430,112,110,67,320,115,21432
15000US060952531052,878,169,16,26,0,12,16,26,862,172,217,103,645,168,21433
15000US060952531053,411,101,47,73,0,12,47,73,364,101,57,53,307,94,21434
15000US060952531054,295,88,66,73,0,12,66,73,229,103,67,64,162,89,21435
15000US060952531055,331,123,11,19,0,12,11,19,320,125,12,20,308,126,21436
15000US060952531061,350,86,0,12,0,12,0,12,350,86,77,60,273,82,21437
15000US060952531062,269,58,34,44,0,12,34,44,235,62,47,31,188,68,21438
15000US060952531063,640,93,27,24,14,12,13,21,613,90,75,34,538,93,21439
15000US060952531071,348,104,0,12,0,12,0,12,348,104,132,61,216,99,21440
15000US060952531072,833,165,16,24,0,12,16,24,817,163,105,88,712,174,21441
15000US060952531073,827,176,48,59,0,12,48,59,779,165,274,131,505,164,21442
15000US060952531074,317,118,60,48,49,44,11,20,257,113,62,49,195,112,21443
15000US060952531081,732,99,49,54,47,52,2,7,683,107,194,75,489,118,21444
15000US060952531082,450,97,33,26,7,12,26,23,417,98,91,52,326,94,21445
15000US060952531083,430,92,42,55,42,55,0,12,388,83,75,47,313,78,21446
15000US060952532011,470,59,20,22,0,12,20,22,450,62,115,52,335,63,21447
15000US060952532012,333,62,14,19,0,12,14,19,319,60,49,32,270,69,21448
15000US060952532013,486,81,9,14,9,14,0,12,477,81,141,64,336,82,21449
15000US060952532014,530,64,6,10,6,10,0,12,524,66,144,69,380,76,21450
15000US060952532031,489,84,74,52,17,21,57,53,415,75,61,43,354,82,21451
15000US060952532032,602,97,33,35,13,15,20,31,569,102,101,45,468,106,21452
15000US060952532033,338,71,11,19,0,12,11,19,327,72,79,38,248,71,21453
15000US060952532041,528,123,85,97,24,28,61,95,443,97,44,34,399,89,21454
15000US060952532042,305,83,0,12,0,12,0,12,305,83,73,72,232,81,21455
15000US060952532043,518,111,21,28,6,13,15,25,497,110,48,44,449,110,21456
15000US060952532044,384,129,70,57,34,38,36,42,314,134,57,55,257,134,21457
15000US060952532045,616,147,181,78,75,73,106,81,435,156,129,71,306,133,21458
15000US060952532051,414,76,0,12,0,12,0,12,414,76,55,33,359,76,21459
15000US060952532052,213,47,0,12,0,12,0,12,213,47,74,44,139,48,21460
15000US060952532053,363,89,146,75,17,25,129,73,217,69,49,31,168,73,21461
15000US060952532061,503,77,32,26,16,18,16,17,471,81,69,40,402,88,21462
15000US060952532062,502,73,23,22,15,18,8,12,479,73,40,24,439,78,21463
15000US060952533001,562,80,40,32,26,24,14,21,522,84,137,56,385,86,21464
15000US060952533002,351,64,7,10,1,3,6,10,344,64,55,41,289,66,21465
15000US060952534021,396,93,43,45,0,12,43,45,353,94,79,51,274,92,21466
15000US060952534022,222,105,15,23,0,12,15,23,207,109,144,98,63,44,21467
15000US060952534023,287,104,32,38,15,27,17,28,255,100,45,39,210,94,21468
15000US060952534024,806,149,118,99,47,74,71,64,688,160,195,97,493,157,21469
15000US060952534025,493,122,16,28,0,12,16,28,477,128,65,54,412,138,21470
15000US060952534031,427,87,12,18,0,12,12,18,415,83,93,40,322,79,21471
15000US060952534032,436,81,24,37,24,37,0,12,412,79,154,61,258,71,21472
15000US060952534033,658,84,8,12,8,12,0,12,650,84,162,62,488,88,21473
15000US060952534041,689,151,119,96,57,75,62,61,570,143,113,81,457,117,21474
15000US060952534042,488,122,193,101,67,66,126,105,295,94,102,61,193,102,21475
15000US060952534043,338,98,0,12,0,12,0,12,338,98,52,41,286,98,21476
15000US060952534044,676,154,103,98,12,22,91,94,573,132,127,79,446,123,21477
15000US060952535001,2552,233,65,51,17,25,48,46,2487,232,948,197,1539,216,21478
15000US060952535002,712,126,34,43,24,39,10,16,678,133,242,122,436,135,21479
15000US060952535003,572,131,63,60,38,45,25,39,509,126,76,63,433,122,21480
15000US060952535004,569,155,80,93,80,93,0,12,489,144,198,119,291,117,21481
15000US060959800001,0,12,0,12,0,12,0,12,0,12,0,12,0,12,21482
15000US060971501001,528,73,0,12,0,12,0,12,528,73,98,37,430,81,21483
15000US060971501002,333,61,7,11,0,12,7,11,326,63,66,35,260,64,21484
15000US060971501003,164,57,0,12,0,12,0,12,164,57,19,17,145,57,21485
15000US060971502021,440,108,0,12,0,12,0,12,440,108,104,75,336,118,21486
15000US060971502022,302,73,0,12,0,12,0,12,302,73,52,37,250,74,21487
15000US060971502023,250,72,0,12,0,12,0,12,250,72,28,34,222,70,21488
15000US060971502024,808,143,12,20,0,12,12,20,796,141,102,68,694,146,21489
15000US060971502025,548,99,0,12,0,12,0,12,548,99,45,47,503,100,21490
15000US060971502031,722,122,40,50,40,50,0,12,682,121,197,109,485,119,21491
15000US060971502032,644,149,0,12,0,12,0,12,644,149,193,87,451,147,21492
15000US060971502033,907,150,55,50,21,34,34,38,852,155,328,120,524,146,21493
15000US060971502041,462,75,14,14,9,14,5,10,448,72,75,48,373,80,21494
15000US060971502042,716,102,67,53,30,27,37,45,649,100,58,38,591,100,21495
15000US060971502043,563,75,0,12,0,12,0,12,563,75,69,40,494,80,21496
15000US060971503031,442,101,0,12,0,12,0,12,442,101,128,85,314,91,21497
15000US060971503032,449,101,0,12,0,12,0,12,449,101,74,62,375,105,21498
15000US060971503033,392,113,0,12,0,12,0,12,392,113,58,53,334,114,21499
15000US060971503034,1009,138,0,12,0,12,0,12,1009,138,317,135,692,147,21500
15000US060971503041,419,108,0,12,0,12,0,12,419,108,111,91,308,120,21501
15000US060971503042,692,141,58,64,35,50,23,38,634,130,93,56,541,132,21502
15000US060971503043,655,141,0,12,0,12,0,12,655,141,99,67,556,151,21503
15000US060971503044,416,105,16,25,0,12,16,25,400,103,95,65,305,97,21504
15000US060971503051,269,95,93,81,0,12,93,81,176,57,47,27,129,52,21505
15000US060971503052,495,116,16,24,16,24,0,12,479,117,97,53,382,116,21506
15000US060971503053,732,144,105,87,10,16,95,86,627,143,213,98,414,134,21507
15000US060971503054,293,101,15,23,0,12,15,23,278,100,80,66,198,87,21508
15000US060971503061,460,95,42,50,0,12,42,50,418,89,133,73,285,90,21509
15000US060971503062,492,101,52,51,5,9,47,50,440,90,107,61,333,81,21510
15000US060971503063,693,107,36,36,10,16,26,34,657,115,102,45,555,112,21511
15000US060971505001,129,125,0,12,0,12,0,12,129,125,0,12,129,125,21512
15000US060971505002,410,188,0,12,0,12,0,12,410,188,25,41,385,188,21513
15000US060971505003,618,157,0,12,0,12,0,12,618,157,133,112,485,120,21514
15000US060971505004,289,82,0,12,0,12,0,12,289,82,94,58,195,86,21515
15000US060971505005,352,112,18,28,0,12,18,28,334,118,47,43,287,120,21516
15000US060971505006,387,129,16,26,0,12,16,26,371,125,57,47,314,134,21517
15000US060971506011,358,63,7,11,0,12,7,11,351,64,58,49,293,68,21518
15000US060971506012,280,75,8,15,0,12,8,15,272,75,72,44,200,73,21519
15000US060971506013,479,77,53,56,0,12,53,56,426,83,39,36,387,83,21520
15000US060971506014,261,70,0,12,0,12,0,12,261,70,61,57,200,62,21521
15000US060971506021,445,73,10,15,0,12,10,15,435,75,88,47,347,82,21522
15000US060971506022,196,41,8,13,8,13,0,12,188,42,7,12,181,45,21523
15000US060971506023,433,57,8,12,0,12,8,12,425,60,103,54,322,66,21524
15000US060971506024,386,61,7,13,0,12,7,13,379,63,28,25,351,66,21525
15000US060971506031,704,126,29,34,0,12,29,34,675,130,180,74,495,123,21526
15000US060971506032,314,93,39,59,39,59,0,12,275,94,42,37,233,94,21527
15000US060971506033,219,86,11,19,11,19,0,12,208,92,22,34,186,86,21528
15000US060971506034,537,86,0,12,0,12,0,12,537,86,185,92,352,81,21529
15000US060971506035,377,87,32,42,23,37,9,16,345,98,46,58,299,94,21530
15000US060971506036,410,71,26,41,0,12,26,41,384,71,104,72,280,74,21531
15000US060971506071,366,71,0,12,0,12,0,12,366,71,51,33,315,80,21532
15000US060971506072,274,79,0,12,0,12,0,12,274,79,54,59,220,74,21533
15000US060971506073,1130,99,10,16,10,16,0,12,1120,99,209,67,911,91,21534
15000US060971506091,642,84,16,19,9,14,7,13,626,87,154,68,472,89,21535
15000US060971506092,523,77,44,33,23,23,21,24,479,76,180,61,299,83,21536
15000US060971506093,422,72,22,35,0,12,22,35,400,70,161,69,239,66,21537
15000US060971506094,361,75,23,32,0,12,23,32,338,77,110,63,228,62,21538
15000US060971506101,434,70,18,20,8,13,10,15,416,74,49,28,367,79,21539
15000US060971506102,670,67,7,11,0,12,7,11,663,69,107,55,556,74,21540
15000US060971506103,255,52,18,20,0,12,18,20,237,52,62,45,175,52,21541
15000US060971506111,1029,82,88,61,49,49,39,46,941,84,187,83,754,111,21542
15000US060971506112,296,62,0,12,0,12,0,12,296,62,41,24,255,60,21543
15000US060971506113,222,45,0,12,0,12,0,12,222,45,57,44,165,46,21544
15000US060971506121,981,82,24,28,13,21,11,18,957,77,148,57,809,77,21545
15000US060971506122,646,101,32,51,32,51,0,12,614,102,198,77,416,89,21546
15000US060971507011,632,89,105,108,87,105,18,27,527,144,115,70,412,135,21547
15000US060971507012,632,143,0,12,0,12,0,12,632,143,120,77,512,136,21548
15000US060971507013,491,106,0,12,0,12,0,12,491,106,49,51,442,110,21549
15000US060971507014,306,83,31,48,0,12,31,48,275,67,30,34,245,73,21550
15000US060971507021,533,82,23,36,0,12,23,36,510,76,64,35,446,76,21551
15000US060971507022,307,59,23,36,0,12,23,36,284,55,17,20,267,57,21552
15000US060971507023,529,68,40,43,8,13,32,41,489,70,51,27,438,78,21553
15000US060971507024,450,86,41,53,0,12,41,53,409,86,73,49,336,88,21554
15000US060971508001,393,61,0,12,0,12,0,12,393,61,37,27,356,66,21555
15000US060971508002,472,87,9,14,0,12,9,14,463,86,104,59,359,76,21556
15000US060971508003,378,56,18,20,9,14,9,14,360,60,36,29,324,57,21557
15000US060971508004,765,78,19,22,0,12,19,22,746,78,198,77,548,93,21558
15000US060971509011,371,107,15,22,0,12,15,22,356,105,60,43,296,107,21559
15000US060971509012,355,105,13,22,13,22,0,12,342,102,75,60,267,113,21560
15000US060971509013,421,101,15,25,0,12,15,25,406,102,51,48,355,99,21561
15000US060971509014,355,95,29,35,0,12,29,35,326,109,47,41,279,111,21562
15000US060971509015,500,133,53,42,39,43,14,23,447,139,148,93,299,126,21563
15000US060971509021,446,69,17,16,7,11,10,12,429,67,111,38,318,74,21564
15000US060971509022,331,57,0,12,0,12,0,12,331,57,68,44,263,53,21565
15000US060971509023,379,61,0,12,0,12,0,12,379,61,66,31,313,66,21566
15000US060971509024,241,52,7,12,7,12,0,12,234,51,27,21,207,52,21567
15000US060971510001,421,66,20,19,0,12,20,19,401,66,104,41,297,65,21568
15000US060971510002,524,75,37,57,37,57,0,12,487,69,123,43,364,75,21569
15000US060971510003,567,81,42,43,11,16,31,39,525,85,99,57,426,93,21570
15000US060971511001,634,74,16,18,0,12,16,18,618,71,186,52,432,58,21571
15000US060971511002,818,74,16,13,5,8,11,11,802,73,109,41,693,78,21572
15000US060971511003,439,55,28,36,0,12,28,36,411,55,93,37,318,55,21573
15000US060971512011,583,149,45,48,27,39,18,29,538,148,160,109,378,143,21574
15000US060971512012,338,80,0,12,0,12,0,12,338,80,126,72,212,78,21575
15000US060971512013,390,146,74,87,16,27,58,83,316,139,83,73,233,119,21576
15000US060971512014,757,139,62,76,0,12,62,76,695,137,144,70,551,136,21577
15000US060971512015,731,132,118,114,27,32,91,109,613,137,190,84,423,137,21578
15000US060971512031,406,86,39,32,9,14,30,36,367,86,68,50,299,83,21579
15000US060971512032,528,68,9,14,9,14,0,12,519,68,106,62,413,71,21580
15000US060971512033,347,63,18,20,0,12,18,20,329,61,98,41,231,64,21581
15000US060971512034,615,80,75,51,37,44,38,30,540,89,168,78,372,76,21582
15000US060971512041,625,101,26,38,0,12,26,38,599,101,84,44,515,101,21583
15000US060971512042,432,87,37,27,20,22,17,20,395,86,48,49,347,80,21584
15000US060971512043,269,70,5,9,5,9,0,12,264,70,49,32,215,77,21585
15000US060971513011,602,92,66,52,11,17,55,51,536,87,70,42,466,96,21586
15000US060971513012,366,65,48,32,32,27,16,18,318,64,76,52,242,62,21587
15000US060971513013,631,90,86,56,35,33,51,46,545,95,88,60,457,98,21588
15000US060971513051,1099,159,116,78,38,37,78,75,983,163,375,143,608,150,21589
15000US060971513052,233,86,28,45,0,12,28,45,205,72,15,23,190,70,21590
15000US060971513053,633,123,66,52,35,37,31,37,567,127,82,69,485,136,21591
15000US060971513054,401,128,77,70,35,47,42,53,324,124,88,80,236,108,21592
15000US060971513061,144,49,9,14,0,12,9,14,135,54,30,22,105,52,21593
15000US060971513062,302,67,0,12,0,12,0,12,302,67,31,22,271,73,21594
15000US060971513063,484,88,28,26,9,16,19,23,456,90,74,40,382,90,21595
15000US060971513064,620,88,83,58,37,33,46,50,537,91,203,74,334,79,21596
15000US060971513071,668,83,72,52,35,29,37,47,596,76,103,51,493,82,21597
15000US060971513072,404,75,8,13,0,12,8,13,396,76,51,34,345,83,21598
15000US060971513073,438,63,11,16,11,16,0,12,427,66,68,32,359,73,21599
15000US060971513074,448,84,50,61,0,12,50,61,398,72,58,38,340,78,21600
15000US060971513081,216,64,37,54,0,12,37,54,179,60,27,31,152,58,21601
15000US060971513082,764,135,90,90,90,90,0,12,674,136,189,85,485,154,21602
15000US060971513083,280,68,0,12,0,12,0,12,280,68,51,46,229,75,21603
15000US060971513084,149,51,0,12,0,12,0,12,149,51,82,46,67,51,21604
15000US060971513085,505,97,43,54,11,22,32,49,462,88,100,60,362,80,21605
15000US060971513091,371,82,0,12,0,12,0,12,371,82,61,33,310,82,21606
15000US060971513092,918,99,70,55,12,18,58,52,848,116,118,65,730,120,21607
15000US060971513093,679,103,46,48,12,19,34,44,633,117,175,81,458,95,21608
15000US060971513101,224,49,6,9,6,9,0,12,218,47,25,18,193,48,21609
15000US060971513102,567,85,8,12,0,12,8,12,559,85,200,81,359,90,21610
15000US060971513103,465,104,70,65,34,50,36,44,395,83,68,40,327,83,21611
15000US060971513104,235,85,0,12,0,12,0,12,235,85,12,16,223,87,21612
15000US060971513111,427,88,0,12,0,12,0,12,427,88,134,72,293,94,21613
15000US060971513112,520,132,29,32,15,25,14,22,491,135,39,45,452,135,21614
15000US060971513113,502,139,23,35,0,12,23,35,479,136,88,64,391,128,21615
15000US060971513114,431,101,0,12,0,12,0,12,431,101,40,44,391,99,21616
15000US060971513115,392,110,0,12,0,12,0,12,392,110,26,32,366,112,21617
15000US060971514011,1647,179,175,94,76,61,99,73,1472,183,202,89,1270,197,21618
15000US060971514012,459,118,105,95,71,88,34,37,354,104,113,70,241,93,21619
15000US060971514013,313,106,17,27,17,27,0,12,296,109,87,81,209,94,21620
15000US060971514021,863,161,90,73,51,41,39,56,773,152,184,83,589,144,21621
15000US060971514022,741,125,101,87,26,32,75,82,640,116,147,86,493,116,21622
15000US060971514023,845,138,102,89,22,28,80,82,743,132,237,122,506,127,21623
15000US060971514024,204,90,47,46,0,12,47,46,157,80,5,13,152,81,21624
15000US060971514025,676,118,75,56,44,56,31,48,601,128,109,84,492,132,21625
15000US060971515021,818,154,34,38,34,38,0,12,784,156,138,75,646,164,21626
15000US060971515022,235,58,0,12,0,12,0,12,235,58,41,31,194,59,21627
15000US060971515023,317,99,0,12,0,12,0,12,317,99,30,25,287,109,21628
15000US060971515024,202,78,0,12,0,12,0,12,202,78,60,44,142,78,21629
15000US060971515025,560,117,77,78,0,12,77,78,483,128,110,93,373,116,21630
15000US060971515026,845,157,60,69,0,12,60,69,785,148,196,86,589,151,21631
15000US060971515031,524,65,0,12,0,12,0,12,524,65,119,55,405,66,21632
15000US060971515032,339,46,10,15,0,12,10,15,329,46,57,36,272,52,21633
15000US060971515033,514,66,0,12,0,12,0,12,514,66,82,37,432,67,21634
15000US060971515041,415,75,14,17,5,9,9,15,401,74,44,29,357,76,21635
15000US060971515042,432,65,22,24,0,12,22,24,410,68,56,33,354,74,21636
15000US060971515043,469,55,11,20,0,12,11,20,458,55,96,46,362,67,21637
15000US060971516011,402,51,6,9,6,9,0,12,396,52,129,44,267,58,21638
15000US060971516012,614,69,31,39,7,12,24,37,583,70,205,61,378,71,21639
15000US060971516013,664,64,7,12,0,12,7,12,657,62,223,56,434,64,21640
15000US060971516021,531,83,6,9,0,12,6,9,525,83,187,72,338,87,21641
15000US060971516022,577,74,0,12,0,12,0,12,577,74,177,68,400,77,21642
15000US060971516023,753,87,14,20,14,20,0,12,739,88,210,62,529,102,21643
15000US060971517001,180,81,0,12,0,12,0,12,180,81,15,26,165,76,21644
15000US060971517002,266,74,0,12,0,12,0,12,266,74,31,38,235,68,21645
15000US060971517003,536,105,83,71,45,57,38,44,453,108,16,26,437,110,21646
15000US060971517004,721,118,72,78,0,12,72,78,649,94,185,70,464,105,21647
15000US060971517005,435,87,50,46,19,29,31,36,385,90,88,60,297,79,21648
15000US060971517006,559,130,86,102,25,39,61,95,473,126,247,100,226,110,21649
15000US060971518001,455,85,32,38,0,12,32,38,423,83,72,51,351,90,21650
15000US060971518002,263,85,25,40,0,12,25,40,238,78,97,79,141,56,21651
15000US060971518003,399,119,0,12,0,12,0,12,399,119,62,73,337,102,21652
15000US060971518004,732,126,92,63,53,51,39,48,640,125,178,113,462,115,21653
15000US060971518005,199,50,0,12,0,12,0,12,199,50,13,23,186,50,21654
15000US060971519001,339,88,0,12,0,12,0,12,339,88,119,83,220,62,21655
15000US060971519002,287,82,37,31,0,12,37,31,250,84,59,52,191,68,21656
15000US060971519003,291,68,65,46,9,11,56,45,226,60,73,40,153,49,21657
15000US060971519004,481,87,76,51,52,47,24,22,405,94,114,46,291,96,21658
15000US060971520001,462,68,30,19,14,15,16,12,432,68,107,37,325,73,21659
15000US060971520002,458,60,20,16,11,11,9,11,438,60,74,42,364,62,21660
15000US060971521001,369,92,69,49,49,49,20,25,300,84,69,41,231,87,21661
15000US060971521002,288,85,10,17,10,17,0,12,278,85,40,24,238,85,21662
15000US060971521003,396,77,18,21,12,18,6,11,378,77,52,45,326,86,21663
15000US060971522011,458,65,32,37,9,13,23,34,426,67,97,42,329,72,21664
15000US060971522012,358,73,20,30,20,30,0,12,338,74,56,30,282,80,21665
15000US060971522013,510,78,85,62,56,40,29,46,425,82,115,56,310,67,21666
15000US060971522014,361,87,83,50,38,38,45,32,278,79,9,13,269,79,21667
15000US060971522021,253,89,0,12,0,12,0,12,253,89,15,24,238,92,21668
15000US060971522022,967,152,28,35,28,35,0,12,939,151,309,145,630,155,21669
15000US060971522023,571,101,13,22,13,22,0,12,558,101,97,82,461,108,21670
15000US060971522024,445,135,12,21,0,12,12,21,433,137,107,81,326,134,21671
15000US060971522025,502,115,0,12,0,12,0,12,502,115,150,72,352,126,21672
15000US060971522031,274,60,8,14,8,14,0,12,266,61,20,19,246,63,21673
15000US060971522032,373,74,13,15,13,15,0,12,360,73,35,29,325,76,21674
15000US060971522033,584,103,43,34,24,29,19,20,541,105,204,76,337,89,21675
15000US060971522034,579,80,115,69,75,54,40,42,464,88,59,40,405,92,21676
15000US060971523001,617,78,10,15,0,12,10,15,607,80,213,77,394,70,21677
15000US060971523002,369,59,7,11,0,12,7,11,362,60,99,52,263,52,21678
15000US060971523003,519,59,33,25,9,13,24,22,486,64,91,41,395,69,21679
15000US060971523004,313,50,10,16,0,12,10,16,303,51,54,30,249,58,21680
15000US060971524001,868,220,0,12,0,12,0,12,868,220,300,183,568,167,21681
15000US060971524002,798,210,0,12,0,12,0,12,798,210,303,174,495,146,21682
15000US060971524003,979,195,0,12,0,12,0,12,979,195,246,125,733,220,21683
15000US060971524004,1005,180,16,23,0,12,16,23,989,180,226,146,763,166,21684
15000US060971524005,637,108,0,12,0,12,0,12,637,108,85,73,552,127,21685
15000US060971525011,768,112,0,12,0,12,0,12,768,112,126,54,642,108,21686
15000US060971525012,518,76,79,46,38,27,41,44,439,81,77,51,362,79,21687
15000US060971525013,385,77,55,44,20,33,35,25,330,80,46,25,284,79,21688
15000US060971525021,542,79,11,17,0,12,11,17,531,79,43,26,488,81,21689
15000US060971525022,617,102,10,15,0,12,10,15,607,102,143,81,464,105,21690
15000US060971525023,354,57,16,18,6,10,10,15,338,58,146,47,192,63,21691
15000US060971526001,613,110,0,12,0,12,0,12,613,110,109,66,504,119,21692
15000US060971526002,854,117,19,23,0,12,19,23,835,120,211,84,624,117,21693
15000US060971526003,475,86,15,24,15,24,0,12,460,91,90,64,370,109,21694
15000US060971526004,450,106,0,12,0,12,0,12,450,106,105,76,345,95,21695
15000US060971526005,540,110,29,34,13,22,16,25,511,111,91,57,420,111,21696
15000US060971526006,244,64,0,12,0,12,0,12,244,64,47,39,197,73,21697
15000US060971527011,423,101,46,70,46,70,0,12,377,87,105,58,272,81,21698
15000US060971527012,366,87,97,70,18,28,79,62,269,89,34,37,235,98,21699
15000US060971527013,375,81,0,12,0,12,0,12,375,81,106,80,269,75,21700
15000US060971527014,418,130,108,85,0,12,108,85,310,121,26,29,284,124,21701
15000US060971527015,578,90,65,52,43,44,22,26,513,95,139,66,374,99,21702
15000US060971527021,127,60,39,51,0,12,39,51,88,51,63,54,25,19,21703
15000US060971527022,471,88,25,26,9,14,16,21,446,90,167,68,279,69,21704
15000US060971527023,389,76,8,12,0,12,8,12,381,77,90,67,291,68,21705
15000US060971527024,864,127,126,66,0,12,126,66,738,108,231,100,507,100,21706
15000US060971527025,240,65,0,12,0,12,0,12,240,65,61,37,179,70,21707
15000US060971528011,538,106,87,68,37,28,50,64,451,98,115,69,336,91,21708
15000US060971528012,403,71,9,14,9,14,0,12,394,73,32,28,362,75,21709
15000US060971528013,443,104,18,28,0,12,18,28,425,97,50,36,375,88,21710
15000US060971528014,249,77,0,12,0,12,0,12,249,77,35,40,214,79,21711
15000US060971528015,316,53,19,20,19,20,0,12,297,56,69,44,228,58,21712
15000US060971528021,479,118,86,70,45,54,41,40,393,109,195,95,198,84,21713
15000US060971528022,822,181,109,100,35,40,74,91,713,187,237,126,476,136,21714
15000US060971528023,424,110,0,12,0,12,0,12,424,110,29,36,395,121,21715
15000US060971528024,593,135,93,83,0,12,93,83,500,121,180,79,320,114,21716
15000US060971528025,457,135,33,55,0,12,33,55,424,129,108,87,316,107,21717
15000US060971529031,276,78,7,12,0,12,7,12,269,78,138,78,131,45,21718
15000US060971529032,624,99,109,58,34,39,75,45,515,101,129,66,386,96,21719
15000US060971529033,308,103,121,83,0,12,121,83,187,86,91,71,96,60,21720
15000US060971529034,282,78,79,61,45,44,34,42,203,69,43,42,160,59,21721
15000US060971529041,832,95,84,64,31,35,53,56,748,102,132,51,616,114,21722
15000US060971529042,281,59,0,12,0,12,0,12,281,59,83,50,198,52,21723
15000US060971529043,464,69,32,38,9,14,23,34,432,74,105,44,327,79,21724
15000US060971529044,399,69,0,12,0,12,0,12,399,69,93,39,306,71,21725
15000US060971529051,490,81,23,25,13,17,10,20,467,78,148,62,319,85,21726
15000US060971529052,644,111,17,19,7,11,10,16,627,112,174,69,453,117,21727
15000US060971529053,447,97,49,49,6,8,43,48,398,111,39,27,359,116,21728
15000US060971529061,1297,118,30,26,17,20,13,17,1267,120,189,62,1078,125,21729
15000US060971529062,780,112,10,16,0,12,10,16,770,113,188,70,582,118,21730
15000US060971530011,765,179,183,135,103,114,80,75,582,148,201,98,381,134,21731
15000US060971530012,537,102,48,51,25,38,23,36,489,98,164,86,325,107,21732
15000US060971530013,1188,160,266,128,103,69,163,98,922,166,204,83,718,176,21733
15000US060971530021,593,127,168,105,41,34,127,103,425,108,83,47,342,112,21734
15000US060971530022,455,113,59,60,0,12,59,60,396,89,121,76,275,76,21735
15000US060971530023,284,87,0,12,0,12,0,12,284,87,33,27,251,88,21736
15000US060971530024,407,126,87,73,67,69,20,24,320,103,62,50,258,98,21737
15000US060971530025,174,57,11,18,11,18,0,12,163,59,21,23,142,66,21738
15000US060971530031,291,81,59,44,12,18,47,41,232,70,74,43,158,60,21739
15000US060971530032,325,99,91,64,50,36,41,51,234,83,64,40,170,81,21740
15000US060971530033,719,126,122,82,42,43,80,70,597,127,89,48,508,118,21741
15000US060971530034,693,111,78,44,19,19,59,42,615,116,116,50,499,118,21742
15000US060971530051,397,107,18,28,18,28,0,12,379,105,67,46,312,97,21743
15000US060971530052,313,99,0,12,0,12,0,12,313,99,88,96,225,92,21744
15000US060971530053,523,91,0,12,0,12,0,12,523,91,163,79,360,95,21745
15000US060971530054,240,77,0,12,0,12,0,12,240,77,37,42,203,84,21746
15000US060971530055,564,111,8,17,8,17,0,12,556,111,147,87,409,117,21747
15000US060971530056,433,124,0,12,0,12,0,12,433,124,48,41,385,129,21748
15000US060971530061,276,60,16,25,0,12,16,25,260,64,93,47,167,62,21749
15000US060971530062,251,70,32,40,32,40,0,12,219,73,33,37,186,70,21750
15000US060971530063,423,106,47,47,20,33,27,34,376,102,17,28,359,103,21751
15000US060971530064,928,145,143,101,28,42,115,91,785,125,239,111,546,113,21752
15000US060971530065,351,122,75,83,0,12,75,83,276,139,52,38,224,138,21753
15000US060971530066,601,116,40,47,18,29,22,35,561,115,220,142,341,106,21754
15000US060971531021,363,74,83,59,49,45,34,41,280,67,67,52,213,72,21755
15000US060971531022,493,123,93,75,10,17,83,73,400,126,124,73,276,112,21756
15000US060971531023,310,76,41,39,36,37,5,14,269,68,21,20,248,69,21757
15000US060971531024,287,82,30,30,22,25,8,15,257,86,75,53,182,78,21758
15000US060971531031,694,94,143,63,60,45,83,44,551,91,80,38,471,93,21759
15000US060971531032,456,77,50,34,16,16,34,30,406,83,69,53,337,73,21760
15000US060971531033,259,83,129,77,38,40,91,70,130,39,54,31,76,38,21761
15000US060971531041,615,86,164,66,76,56,88,66,451,84,75,49,376,88,21762
15000US060971531042,104,46,11,17,11,17,0,12,93,49,10,15,83,48,21763
15000US060971531043,457,86,160,85,68,62,92,68,297,88,112,60,185,83,21764
15000US060971532001,398,146,64,74,52,74,12,20,334,150,111,71,223,125,21765
15000US060971532002,382,139,43,48,13,23,30,44,339,141,84,61,255,164,21766
15000US060971532003,535,160,108,92,23,28,85,89,427,155,118,76,309,153,21767
15000US060971532004,1208,163,185,111,123,86,62,68,1023,175,293,124,730,177,21768
15000US060971533001,1138,176,63,80,18,31,45,73,1075,174,263,131,812,159,21769
15000US060971533002,263,95,43,36,27,34,16,26,220,90,101,77,119,64,21770
15000US060971533003,566,129,16,24,16,24,0,12,550,131,224,110,326,136,21771
15000US060971533004,1716,192,271,155,61,41,210,155,1445,206,282,120,1163,223,21772
15000US060971534011,259,95,9,16,9,16,0,12,250,99,67,52,183,86,21773
15000US060971534012,634,132,36,40,21,33,15,25,598,136,90,51,508,139,21774
15000US060971534013,440,101,11,17,0,12,11,17,429,102,160,72,269,93,21775
15000US060971534014,590,114,0,12,0,12,0,12,590,114,111,66,479,126,21776
15000US060971534015,430,113,13,20,0,12,13,20,417,113,66,50,351,113,21777
15000US060971534016,525,119,49,63,35,56,14,23,476,111,101,69,375,100,21778
15000US060971534031,569,93,40,37,4,7,36,37,529,92,128,49,401,97,21779
15000US060971534032,403,73,17,13,8,13,9,14,386,71,123,62,263,64,21780
15000US060971534033,286,53,19,28,19,28,0,12,267,61,26,20,241,64,21781
15000US060971534034,298,67,0,12,0,12,0,12,298,67,41,26,257,63,21782
15000US060971534041,383,62,11,17,0,12,11,17,372,62,73,38,299,71,21783
15000US060971534042,610,72,87,45,57,39,30,28,523,77,185,81,338,66,21784
15000US060971534043,325,78,0,12,0,12,0,12,325,78,62,38,263,86,21785
15000US060971534044,526,75,12,18,12,18,0,12,514,75,89,40,425,80,21786
15000US060971535011,471,93,12,17,0,12,12,17,459,95,118,72,341,86,21787
15000US060971535012,469,80,37,31,8,15,29,27,432,77,113,49,319,80,21788
15000US060971535013,445,76,0,12,0,12,0,12,445,76,82,41,363,76,21789
15000US060971535014,567,75,16,18,16,18,0,12,551,76,157,66,394,72,21790
15000US060971535021,378,64,0,12,0,12,0,12,378,64,41,30,337,65,21791
15000US060971535022,301,61,11,20,11,20,0,12,290,59,56,35,234,64,21792
15000US060971535023,392,82,0,12,0,12,0,12,392,82,61,40,331,78,21793
15000US060971535024,622,96,0,12,0,12,0,12,622,96,179,78,443,113,21794
15000US060971536001,315,83,18,29,0,12,18,29,297,83,98,52,199,79,21795
15000US060971536002,457,116,0,12,0,12,0,12,457,116,141,91,316,115,21796
15000US060971536003,408,119,18,17,9,15,9,17,390,120,98,82,292,108,21797
15000US060971536004,352,74,53,52,53,52,0,12,299,65,120,61,179,67,21798
15000US060971536005,818,159,43,40,14,22,29,33,775,164,152,96,623,164,21799
15000US060971537031,498,90,73,53,31,34,42,41,425,69,78,45,347,67,21800
15000US060971537032,324,88,23,27,10,16,13,22,301,86,112,57,189,62,21801
15000US060971537033,279,63,30,25,21,20,9,13,249,65,73,35,176,65,21802
15000US060971537034,202,68,24,27,0,12,24,27,178,67,11,15,167,69,21803
15000US060971537035,347,81,0,12,0,12,0,12,347,81,110,60,237,81,21804
15000US060971537041,290,83,36,43,11,18,25,40,254,79,121,60,133,54,21805
15000US060971537042,324,96,78,60,25,24,53,55,246,92,105,46,141,93,21806
15000US060971537043,333,88,46,29,16,18,30,27,287,85,72,48,215,73,21807
15000US060971537044,740,138,149,93,66,68,83,65,591,126,193,88,398,110,21808
15000US060971537051,333,86,113,72,24,25,89,70,220,73,26,23,194,70,21809
15000US060971537052,338,55,8,13,8,13,0,12,330,56,122,50,208,49,21810
15000US060971537053,609,102,69,61,41,52,28,27,540,109,168,87,372,93,21811
15000US060971537054,465,70,12,18,12,18,0,12,453,72,131,56,322,78,21812
15000US060971537061,379,87,31,28,9,14,22,24,348,91,94,61,254,82,21813
15000US060971537062,536,83,44,56,0,12,44,56,492,68,109,46,383,68,21814
15000US060971537063,679,111,39,33,21,24,18,22,640,110,154,65,486,98,21815
15000US060971537064,334,75,18,21,18,21,0,12,316,75,84,39,232,73,21816
15000US060971538011,471,108,56,95,56,95,0,12,415,108,174,118,241,85,21817
15000US060971538012,1695,151,39,32,19,27,20,33,1656,147,251,115,1405,178,21818
15000US060971538013,361,104,0,12,0,12,0,12,361,104,173,97,188,93,21819
15000US060971538014,605,102,102,90,58,68,44,67,503,112,123,70,380,101,21820
15000US060971538041,675,71,0,12,0,12,0,12,675,71,209,58,466,94,21821
15000US060971538042,510,74,15,17,8,14,7,11,495,76,113,52,382,78,21822
15000US060971538061,286,58,9,14,9,14,0,12,277,60,52,32,225,63,21823
15000US060971538062,425,55,11,17,0,12,11,17,414,54,92,55,322,68,21824
15000US060971538063,587,67,17,27,0,12,17,27,570,70,117,51,453,82,21825
15000US060971538071,394,58,0,12,0,12,0,12,394,58,67,56,327,64,21826
15000US060971538072,984,73,29,26,19,20,10,15,955,72,126,56,829,89,21827
15000US060971538081,613,117,51,53,36,50,15,17,562,108,160,72,402,89,21828
15000US060971538082,395,95,85,62,57,57,28,26,310,101,78,67,232,84,21829
15000US060971538083,474,85,66,46,30,23,36,42,408,84,81,48,327,80,21830
15000US060971538091,533,80,0,12,0,12,0,12,533,80,66,42,467,81,21831
15000US060971538092,653,77,68,53,11,18,57,49,585,80,104,53,481,82,21832
15000US060971538093,391,59,0,12,0,12,0,12,391,59,102,50,289,66,21833
15000US060971539011,450,114,0,12,0,12,0,12,450,114,29,33,421,115,21834
15000US060971539012,546,90,17,25,17,25,0,12,529,90,196,87,333,101,21835
15000US060971539013,790,99,51,49,0,12,51,49,739,102,238,109,501,127,21836
15000US060971539014,342,92,0,12,0,12,0,12,342,92,64,45,278,105,21837
15000US060971539021,652,93,90,57,47,42,43,50,562,105,72,37,490,107,21838
15000US060971539022,273,73,35,34,3,9,32,33,238,68,90,56,148,57,21839
15000US060971539023,393,81,0,12,0,12,0,12,393,81,92,50,301,85,21840
15000US060971539024,399,81,33,41,27,39,6,11,366,90,52,44,314,86,21841
15000US060971539031,366,68,0,12,0,12,0,12,366,68,97,45,269,63,21842
15000US060971539032,467,91,3,7,0,12,3,7,464,90,64,45,400,107,21843
15000US060971539033,275,59,4,7,4,7,0,12,271,59,43,30,228,60,21844
15000US060971539034,582,89,0,12,0,12,0,12,582,89,145,62,437,87,21845
15000US060971540001,227,45,16,19,14,19,2,4,211,42,50,24,161,40,21846
15000US060971540002,302,64,12,18,3,6,9,16,290,60,105,49,185,41,21847
15000US060971540003,518,83,0,12,0,12,0,12,518,83,136,62,382,84,21848
15000US060971541001,254,62,14,19,0,12,14,19,240,62,102,57,138,47,21849
15000US060971541002,459,80,13,12,0,12,13,12,446,79,84,42,362,68,21850
15000US060971541003,345,84,37,45,28,43,9,13,308,75,92,45,216,65,21851
15000US060971541004,324,84,3,4,0,12,3,4,321,84,89,50,232,77,21852
15000US060971542011,471,92,66,42,46,33,20,24,405,86,150,77,255,62,21853
15000US060971542012,259,67,22,24,22,24,0,12,237,65,66,43,171,65,21854
15000US060971542013,220,77,67,59,23,36,44,53,153,65,22,23,131,67,21855
15000US060971542014,399,98,88,55,67,53,21,24,311,86,105,64,206,79,21856
15000US060971542021,1656,155,43,38,26,29,17,27,1613,150,382,133,1231,182,21857
15000US060971542022,385,77,14,22,14,22,0,12,371,82,147,78,224,75,21858
15000US060971542023,223,61,11,18,11,18,0,12,212,62,83,44,129,59,21859
15000US060971543021,391,111,0,12,0,12,0,12,391,111,47,50,344,115,21860
15000US060971543022,464,110,20,22,0,12,20,22,444,111,109,60,335,103,21861
15000US060971543023,417,104,0,12,0,12,0,12,417,104,73,55,344,106,21862
15000US060971543024,335,133,19,22,9,15,10,16,316,131,10,15,306,130,21863
15000US060971543031,296,81,15,22,0,12,15,22,281,78,47,21,234,74,21864
15000US060971543032,462,105,0,12,0,12,0,12,462,105,133,62,329,94,21865
15000US060971543041,332,71,20,16,2,3,18,16,312,67,38,18,274,64,21866
15000US060971543042,264,54,11,14,0,12,11,14,253,52,76,31,177,46,21867
15000US060971543043,362,78,20,23,14,21,6,9,342,75,46,38,296,73,21868
15000US060979901000,0,12,0,12,0,12,0,12,0,12,0,12,0,12,21869
15000US060990001011,527,77,35,25,8,12,27,22,492,77,122,41,370,80,21870
15000US060990001012,367,54,7,7,2,3,5,6,360,54,91,40,269,55,21871
15000US060990001013,471,66,13,10,0,12,13,10,458,67,122,52,336,66,21872
15000US060990001014,397,88,18,19,10,14,8,12,379,88,137,67,242,64,21873
15000US060990001021,194,62,0,12,0,12,0,12,194,62,64,47,130,58,21874
15000US060990001022,764,111,5,9,0,12,5,9,759,111,168,61,591,92,21875
15000US060990001023,426,92,99,85,33,44,66,63,327,87,108,65,219,79,21876
15000US060990002011,685,104,38,58,0,12,38,58,647,106,131,68,516,115,21877
15000US060990002012,548,89,20,32,20,32,0,12,528,99,64,57,464,106,21878
15000US060990002013,324,73,47,45,11,19,36,41,277,83,95,65,182,82,21879
15000US060990002014,265,78,162,70,103,70,59,70,103,64,19,32,84,64,21880
15000US060990002015,421,119,10,16,10,16,0,12,411,120,63,60,348,109,21881
15000US060990002021,565,182,151,141,132,135,19,31,414,133,63,63,351,125,21882
15000US060990002022,1491,191,68,75,68,75,0,17,1423,199,225,77,1198,184,21883
15000US060990002023,332,139,75,93,13,19,62,91,257,126,41,39,216,119,21884
15000US060990002031,855,156,129,104,26,28,103,101,726,146,236,115,490,125,21885
15000US060990002032,329,123,100,76,41,50,59,49,229,101,60,59,169,83,21886
15000US060990002033,431,118,102,78,35,55,67,66,329,113,57,71,272,100,21887
15000US060990002034,1132,195,114,111,0,12,114,111,1018,179,301,122,717,165,21888
15000US060990002035,695,122,8,14,8,14,0,12,687,123,115,59,572,134,21889
15000US060990003011,420,56,77,37,29,26,48,30,343,55,45,26,298,55,21890
15000US060990003012,279,44,100,34,26,23,74,29,179,42,76,27,103,47,21891
15000US060990003021,240,49,63,41,18,19,45,37,177,47,32,25,145,49,21892
15000US060990003022,263,51,42,25,0,12,42,25,221,53,68,46,153,37,21893
15000US060990003023,311,52,36,28,3,6,33,29,275,42,26,19,249,45,21894
15000US060990003031,706,120,79,48,70,49,9,14,627,125,110,49,517,132,21895
15000US060990003032,428,74,55,37,35,31,20,23,373,71,84,50,289,78,21896
15000US060990003033,668,108,25,28,11,16,14,22,643,111,211,75,432,101,21897
15000US060990003041,263,66,49,35,0,12,49,35,214,70,42,30,172,69,21898
15000US060990003042,518,76,35,29,17,21,18,19,483,80,137,61,346,84,21899
15000US060990003043,683,103,88,55,29,36,59,41,595,115,133,72,462,101,21900
15000US060990004021,488,130,38,39,21,25,17,27,450,130,62,50,388,137,21901
15000US060990004022,269,127,0,12,0,12,0,12,269,127,174,133,95,49,21902
15000US060990004023,2225,154,115,61,29,34,86,57,2110,150,322,134,1788,179,21903
15000US060990004024,187,44,0,12,0,12,0,12,187,44,73,46,114,51,21904
15000US060990004025,212,94,0,12,0,12,0,12,212,94,49,33,163,96,21905
15000US060990004031,1057,91,59,37,32,31,27,22,998,99,275,70,723,102,21906
15000US060990004032,460,84,22,24,22,24,0,12,438,93,173,66,265,86,21907
15000US060990004041,603,167,155,127,28,31,127,123,448,147,266,141,182,96,21908
15000US060990004042,952,124,138,111,39,58,99,98,814,121,195,98,619,124,21909
15000US060990004043,523,116,15,24,15,24,0,12,508,118,93,57,415,121,21910
15000US060990005011,497,109,0,12,0,12,0,12,497,109,171,99,326,101,21911
15000US060990005012,585,143,79,91,47,79,32,41,506,148,76,64,430,151,21912
15000US060990005013,652,167,0,12,0,12,0,12,652,167,204,131,448,152,21913
15000US060990005014,680,177,39,48,24,41,15,27,641,180,125,84,516,178,21914
15000US060990005031,685,100,145,63,59,36,86,53,540,98,89,66,451,95,21915
15000US060990005032,613,78,18,19,0,12,18,19,595,80,154,63,441,91,21916
15000US060990005033,505,97,127,62,17,18,110,61,378,80,105,49,273,73,21917
15000US060990005041,1856,178,75,51,14,24,61,45,1781,187,301,149,1480,209,21918
15000US060990005042,624,122,0,12,0,12,0,12,624,122,214,98,410,126,21919
15000US060990005043,529,115,0,12,0,12,0,12,529,115,238,115,291,106,21920
15000US060990005051,1021,111,176,71,60,40,116,62,845,113,268,73,577,114,21921
15000US060990005052,597,101,21,20,0,12,21,20,576,99,79,39,497,103,21922
15000US060990005061,495,98,132,85,55,51,77,64,363,88,136,65,227,78,21923
15000US060990005062,611,115,45,36,21,25,24,25,566,115,84,49,482,129,21924
15000US060990005063,367,84,47,30,5,9,42,31,320,85,67,44,253,89,21925
15000US060990005064,302,50,0,12,0,12,0,12,302,50,107,45,195,54,21926
15000US060990005101,661,167,40,60,40,60,0,12,621,160,80,52,541,155,21927
15000US060990005102,863,157,87,74,42,47,45,60,776,180,364,167,412,169,21928
15000US060990005103,605,115,38,43,22,36,16,25,567,120,158,79,409,124,21929
15000US060990005104,406,167,176,124,100,101,76,80,230,124,45,54,185,111,21930
15000US060990006011,302,74,34,41,0,12,34,41,268,71,37,34,231,72,21931
15000US060990006012,599,92,31,29,13,20,18,21,568,89,100,51,468,101,21932
15000US060990006013,525,102,62,42,0,12,62,42,463,101,143,69,320,99,21933
15000US060990006021,345,48,30,20,24,17,6,9,315,50,89,40,226,50,21934
15000US060990006022,533,59,64,40,22,27,42,32,469,73,162,52,307,81,21935
15000US060990008011,533,108,72,71,54,67,18,30,461,98,133,74,328,108,21936
15000US060990008012,732,118,58,46,40,36,18,28,674,121,353,126,321,104,21937
15000US060990008013,284,83,49,70,49,70,0,12,235,66,61,44,174,62,21938
15000US060990008014,557,129,35,27,0,12,35,27,522,133,107,60,415,136,21939
15000US060990008015,461,91,8,14,0,12,8,14,453,92,138,74,315,86,21940
15000US060990008031,241,74,72,48,53,46,19,22,169,63,37,26,132,64,21941
15000US060990008032,509,114,268,111,107,74,161,89,241,76,71,49,170,69,21942
15000US060990008033,761,104,205,71,36,28,169,63,556,101,242,74,314,91,21943
15000US060990008051,682,139,156,101,74,56,82,91,526,115,219,106,307,105,21944
15000US060990008052,495,96,108,66,50,37,58,52,387,91,198,68,189,88,21945
15000US060990008053,293,84,44,50,13,15,31,46,249,80,89,59,160,61,21946
15000US060990008054,613,113,80,50,48,48,32,30,533,118,188,84,345,122,21947
15000US060990008061,811,114,83,63,30,31,53,55,728,122,231,86,497,122,21948
15000US060990008062,779,108,145,61,62,44,83,41,634,114,318,98,316,116,21949
15000US060990008071,538,86,0,12,0,12,0,12,538,86,157,70,381,100,21950
15000US060990008072,1029,97,204,87,100,72,104,63,825,114,169,70,656,117,21951
15000US060990009051,755,163,67,55,16,27,51,46,688,168,203,130,485,159,21952
15000US060990009052,722,122,45,41,45,41,0,12,677,132,303,119,374,103,21953
15000US060990009053,592,109,4,20,4,20,0,12,588,112,109,80,479,119,21954
15000US060990009061,624,122,113,77,80,67,33,34,511,132,194,106,317,117,21955
15000US060990009062,1050,172,41,45,19,30,22,34,1009,174,243,111,766,172,21956
15000US060990009063,583,92,59,59,0,12,59,59,524,89,131,63,393,94,21957
15000US060990009071,442,82,0,12,0,12,0,12,442,82,120,71,322,70,21958
15000US060990009072,444,77,9,14,9,14,0,12,435,77,134,47,301,76,21959
15000US060990009073,412,82,0,12,0,12,0,12,412,82,152,62,260,84,21960
15000US060990009081,448,85,10,15,0,12,10,15,438,83,93,35,345,78,21961
15000US060990009082,781,119,125,63,80,57,45,41,656,123,103,48,553,119,21962
15000US060990009083,704,100,125,56,44,44,81,58,579,91,136,53,443,81,21963
15000US060990009091,820,89,153,67,99,58,54,43,667,94,208,65,459,118,21964
15000US060990009092,551,111,124,65,27,25,97,59,427,95,95,38,332,89,21965
15000US060990009093,357,84,20,30,20,30,0,12,337,82,158,59,179,70,21966
15000US060990009101,619,135,147,82,53,43,94,83,472,131,227,119,245,105,21967
15000US060990009102,771,158,225,119,40,50,185,110,546,182,200,114,346,136,21968
15000US060990009103,201,94,0,12,0,12,0,12,201,94,102,83,99,64,21969
15000US060990009104,511,117,99,61,14,23,85,54,412,116,124,65,288,133,21970
15000US060990009111,502,81,6,10,0,12,6,10,496,81,106,65,390,89,21971
15000US060990009112,769,111,83,49,11,16,72,49,686,119,197,75,489,105,21972
15000US060990009113,526,90,81,60,59,54,22,27,445,99,89,52,356,99,21973
15000US060990009121,188,71,0,12,0,12,0,12,188,71,46,43,142,73,21974
15000US060990009122,344,126,0,12,0,12,0,12,344,126,19,32,325,131,21975
15000US060990009123,5254,194,152,113,122,101,30,48,5102,208,930,284,4172,359,21976
15000US060990010011,447,121,86,80,0,12,86,80,361,106,143,98,218,76,21977
15000US060990010012,684,124,53,54,53,54,0,12,631,131,150,90,481,128,21978
15000US060990010013,464,106,93,90,81,89,12,22,371,105,152,82,219,108,21979
15000US060990010014,334,65,25,32,12,20,13,23,309,69,88,50,221,68,21980
15000US060990010015,492,123,145,108,99,93,46,45,347,94,138,62,209,93,21981
15000US060990010021,343,72,44,52,5,8,39,52,299,74,77,54,222,59,21982
15000US060990010022,592,92,62,43,28,33,34,28,530,95,235,88,295,95,21983
15000US060990010023,424,77,64,59,5,9,59,59,360,76,183,65,177,68,21984
15000US060990011001,384,61,49,42,17,19,32,38,335,56,120,41,215,62,21985
15000US060990011002,417,96,212,88,68,60,144,89,205,83,46,31,159,78,21986
15000US060990011003,452,101,86,68,60,57,26,37,366,101,212,90,154,50,21987
15000US060990011004,291,81,47,36,19,22,28,28,244,78,105,46,139,74,21988
15000US060990012001,210,62,29,34,20,33,9,14,181,58,49,34,132,51,21989
15000US060990012002,545,92,119,60,18,21,101,56,426,96,121,69,305,86,21990
15000US060990012003,754,96,223,75,79,47,144,66,531,90,53,35,478,90,21991
15000US060990013001,378,99,127,93,57,76,70,60,251,83,139,81,112,56,21992
15000US060990013002,389,109,111,102,65,80,46,72,278,90,81,81,197,85,21993
15000US060990013003,525,104,26,41,26,41,0,12,499,110,135,107,364,106,21994
15000US060990013004,554,95,30,41,0,12,30,41,524,88,162,81,362,120,21995
15000US060990013005,377,83,30,43,0,12,30,43,347,89,59,40,288,100,21996
15000US060990013006,314,95,0,12,0,12,0,12,314,95,145,77,169,85,21997
15000US060990014001,679,167,182,132,113,110,69,75,497,151,103,91,394,130,21998
15000US060990014002,407,134,180,78,142,85,38,47,227,133,94,106,133,73,21999
15000US060990014003,344,138,200,139,34,50,166,133,144,104,18,29,126,102,22000
15000US060990014004,694,145,82,80,68,76,14,23,612,144,234,128,378,128,22001
15000US060990014005,199,95,83,70,37,56,46,46,116,79,45,64,71,48,22002
15000US060990015001,653,136,195,93,131,67,64,65,458,146,110,83,348,127,22003
15000US060990015002,448,125,76,56,60,51,16,26,372,132,134,75,238,125,22004
15000US060990015003,669,145,193,109,123,87,70,67,476,148,101,70,375,140,22005
15000US060990015004,290,64,56,47,23,33,33,35,234,67,71,39,163,63,22006
15000US060990016011,308,82,106,54,34,30,72,51,202,73,73,48,129,64,22007
15000US060990016012,534,82,160,67,49,44,111,59,374,86,121,65,253,79,22008
15000US060990016013,425,92,189,83,0,12,189,83,236,75,70,50,166,71,22009
15000US060990016031,350,88,220,84,146,71,74,54,130,61,70,46,60,43,22010
15000US060990016032,400,96,140,81,84,72,56,52,260,74,93,51,167,62,22011
15000US060990016033,239,77,61,41,29,23,32,37,178,74,59,40,119,65,22012
15000US060990016034,506,104,197,95,56,51,141,89,309,97,78,57,231,86,22013
15000US060990016041,339,62,145,54,100,49,45,31,194,64,36,25,158,60,22014
15000US060990016042,466,68,253,71,73,47,180,57,213,60,116,48,97,46,22015
15000US060990016043,246,55,88,46,43,28,45,36,158,56,44,23,114,52,22016
15000US060990017001,522,66,207,68,85,42,122,60,315,71,101,49,214,64,22017
15000US060990017002,226,61,74,39,59,38,15,10,152,58,49,33,103,48,22018
15000US060990018001,295,61,22,22,5,9,17,21,273,61,82,39,191,52,22019
15000US060990018002,591,74,163,45,62,31,101,40,428,69,227,59,201,48,22020
15000US060990018003,0,12,0,12,0,12,0,12,0,12,0,12,0,12,22021
15000US060990019001,826,133,75,73,75,73,0,12,751,137,275,152,476,111,22022
15000US060990019002,198,75,35,39,0,12,35,39,163,64,42,38,121,63,22023
15000US060990019003,445,111,35,40,16,25,19,31,410,107,94,57,316,119,22024
15000US060990019004,287,109,0,12,0,12,0,12,287,109,51,38,236,108,22025
15000US060990019005,293,100,81,73,16,26,65,80,212,83,62,60,150,65,22026
15000US060990020021,684,102,119,64,17,17,102,61,565,95,135,58,430,95,22027
15000US060990020022,429,97,76,62,18,28,58,55,353,100,126,71,227,87,22028
15000US060990020023,281,95,108,67,41,44,67,62,173,80,68,57,105,63,22029
15000US060990020041,484,83,136,76,45,39,91,68,348,90,92,40,256,95,22030
15000US060990020042,244,59,64,56,15,17,49,52,180,53,96,40,84,43,22031
15000US060990020043,668,117,220,73,98,48,122,63,448,105,210,83,238,97,22032
15000US060990020044,623,123,212,92,122,66,90,56,411,120,205,98,206,97,22033
15000US060990020051,723,85,241,87,112,88,129,72,482,95,146,69,336,94,22034
15000US060990020052,432,84,27,27,18,21,9,14,405,86,130,57,275,91,22035
15000US060990020061,676,107,47,54,27,43,20,33,629,108,153,77,476,118,22036
15000US060990020062,627,109,81,45,40,32,41,36,546,108,146,77,400,120,22037
15000US060990021001,549,91,227,75,121,67,106,66,322,88,173,67,149,72,22038
15000US060990021002,519,92,131,73,51,45,80,56,388,104,126,65,262,95,22039
15000US060990022001,534,82,125,66,35,26,90,66,409,81,124,56,285,84,22040
15000US060990022002,747,93,332,80,136,61,196,75,415,82,151,67,264,85,22041
15000US060990022003,147,52,59,40,22,28,37,28,88,45,19,21,69,42,22042
15000US060990022004,401,89,164,82,74,61,90,55,237,70,78,55,159,64,22043
15000US060990023011,484,122,91,62,45,45,46,42,393,108,98,60,295,93,22044
15000US060990023012,842,119,218,88,58,49,160,81,624,141,94,70,530,142,22045
15000US060990023013,273,94,178,82,103,80,75,53,95,69,46,43,49,56,22046
15000US060990023014,474,108,93,61,57,47,36,40,381,103,162,71,219,96,22047
15000US060990023021,655,99,134,71,71,55,63,50,521,106,160,70,361,103,22048
15000US060990023022,463,99,132,62,73,44,59,47,331,96,81,66,250,90,22049
15000US060990024011,393,70,78,39,29,19,49,37,315,76,88,52,227,70,22050
15000US060990024012,540,73,133,56,32,31,101,53,407,77,88,46,319,75,22051
15000US060990024021,695,110,334,103,100,63,234,83,361,107,151,88,210,96,22052
15000US060990024022,34,27,19,30,0,12,19,30,15,24,0,12,15,24,22053
15000US060990024023,690,120,254,107,56,45,198,99,436,118,178,82,258,107,22054
15000US060990025011,406,83,132,56,22,20,110,57,274,79,105,62,169,71,22055
15000US060990025012,0,12,0,12,0,12,0,12,0,12,0,12,0,12,22056
15000US060990025013,1203,94,136,78,39,38,97,65,1067,110,309,101,758,124,22057
15000US060990025031,385,87,86,58,62,53,24,24,299,85,78,46,221,79,22058
15000US060990025032,342,113,95,73,10,16,85,71,247,101,53,39,194,100,22059
15000US060990025033,475,116,143,82,32,41,111,81,332,107,132,75,200,90,22060
15000US060990025041,536,94,87,50,45,34,42,38,449,97,125,56,324,84,22061
15000US060990025042,678,82,114,59,45,32,69,58,564,94,198,79,366,106,22062
15000US060990026021,331,75,74,44,40,41,34,22,257,78,136,59,121,65,22063
15000US060990026022,716,116,263,87,165,74,98,67,453,110,181,81,272,97,22064
15000US060990026023,524,114,94,54,73,49,21,22,430,105,88,56,342,111,22065
15000US060990026031,211,56,24,21,9,14,15,17,187,57,67,30,120,50,22066
15000US060990026032,644,57,49,31,40,29,9,10,595,64,179,56,416,65,22067
15000US060990026041,386,85,91,66,18,19,73,65,295,94,97,44,198,89,22068
15000US060990026042,326,76,110,58,53,39,57,48,216,78,83,43,133,72,22069
15000US060990026043,586,126,226,98,52,40,174,88,360,116,125,71,235,93,22070
15000US060990026051,568,82,68,54,17,19,51,49,500,82,180,80,320,80,22071
15000US060990026052,703,100,246,106,131,100,115,81,457,101,175,73,282,93,22072
15000US060990027011,524,91,106,73,51,46,55,58,418,104,111,59,307,95,22073
15000US060990027012,619,84,123,58,60,42,63,49,496,97,157,68,339,97,22074
15000US060990027021,538,99,161,80,18,19,143,75,377,106,50,52,327,96,22075
15000US060990027022,504,99,209,83,88,51,121,76,295,98,106,56,189,84,22076
15000US060990027023,365,82,59,38,8,13,51,35,306,83,74,54,232,74,22077
15000US060990027024,299,70,51,41,12,14,39,37,248,64,71,43,177,57,22078
15000US060990027025,308,84,39,39,6,9,33,37,269,73,139,53,130,60,22079
15000US060990028011,777,105,88,46,56,38,32,29,689,113,148,72,541,111,22080
15000US060990028012,533,104,37,24,14,17,23,23,496,104,200,83,296,86,22081
15000US060990028013,322,68,0,12,0,12,0,12,322,68,53,35,269,80,22082
15000US060990028021,306,80,21,27,0,12,21,27,285,75,118,81,167,68,22083
15000US060990028022,815,99,267,108,148,90,119,77,548,132,141,76,407,122,22084
15000US060990028023,358,80,0,12,0,12,0,12,358,80,208,72,150,67,22085
15000US060990028024,417,113,61,58,35,44,26,42,356,103,77,53,279,106,22086
15000US060990028031,691,85,75,49,30,30,45,45,616,102,181,97,435,112,22087
15000US060990028032,489,84,20,21,6,9,14,19,469,86,172,67,297,87,22088
15000US060990029011,339,45,40,20,29,16,11,10,299,43,110,33,189,37,22089
15000US060990029012,281,46,4,5,2,3,2,3,277,46,100,44,177,41,22090
15000US060990029013,277,52,24,14,10,11,14,10,253,48,41,17,212,50,22091
15000US060990029014,217,42,39,37,8,11,31,36,178,46,65,25,113,45,22092
15000US060990029015,481,75,52,39,52,39,0,12,429,76,139,53,290,74,22093
15000US060990029021,688,135,9,16,0,12,9,16,679,135,188,109,491,111,22094
15000US060990029022,1267,198,100,76,63,68,37,33,1167,194,422,152,745,182,22095
15000US060990029023,373,110,181,112,58,60,123,99,192,89,139,87,53,43,22096
15000US060990029024,274,86,19,30,19,30,0,12,255,86,69,58,186,81,22097
15000US060990030011,1879,154,53,46,33,34,20,31,1826,157,454,149,1372,188,22098
15000US060990030012,279,85,9,19,9,19,0,12,270,88,115,74,155,85,22099
15000US060990030013,314,95,89,63,17,26,72,62,225,76,81,59,144,61,22100
15000US060990030021,368,120,73,81,28,41,45,70,295,89,190,83,105,50,22101
15000US060990030022,402,92,72,52,47,45,25,38,330,91,158,60,172,77,22102
15000US060990030023,879,131,427,135,221,99,206,94,452,118,167,77,285,106,22103
15000US060990030024,387,93,77,42,52,42,25,26,310,90,71,50,239,79,22104
15000US060990031001,255,70,33,34,24,33,9,15,222,73,69,52,153,66,22105
15000US060990031002,297,86,131,86,14,17,117,83,166,73,101,72,65,42,22106
15000US060990031003,677,117,150,85,9,13,141,87,527,115,163,67,364,108,22107
15000US060990032011,370,71,60,49,0,12,60,49,310,83,148,64,162,66,22108
15000US060990032012,459,81,192,78,43,27,149,71,267,76,54,39,213,71,22109
15000US060990032013,319,69,50,38,17,28,33,30,269,69,133,64,136,49,22110
15000US060990032014,200,48,35,25,11,19,24,17,165,52,22,20,143,51,22111
15000US060990032021,419,157,86,84,31,40,55,89,333,141,63,80,270,125,22112
15000US060990032022,1421,279,215,151,60,95,155,123,1206,280,86,70,1120,284,22113
15000US060990032023,2326,293,343,153,165,127,178,119,1983,331,231,131,1752,332,22114
15000US060990032024,349,145,176,118,20,33,156,116,173,118,12,22,161,116,22115
15000US060990033001,379,96,53,35,29,27,24,22,326,96,102,58,224,82,22116
15000US060990033002,594,99,75,60,21,32,54,50,519,103,95,50,424,104,22117
15000US060990033003,232,46,28,32,8,13,20,31,204,48,64,33,140,50,22118
15000US060990033004,342,69,88,55,23,26,65,48,254,71,45,40,209,65,22119
15000US060990034001,304,57,43,34,12,18,31,29,261,56,96,45,165,57,22120
15000US060990034002,250,64,35,22,14,20,21,15,215,62,62,37,153,56,22121
15000US060990035001,1572,193,328,141,120,81,208,132,1244,206,354,125,890,188,22122
15000US060990035002,315,84,12,20,0,12,12,20,303,91,125,86,178,92,22123
15000US060990035003,620,163,94,97,47,56,47,70,526,163,136,82,390,158,22124
15000US060990035004,854,193,134,100,101,90,33,42,720,175,322,133,398,165,22125
15000US060990036031,196,64,14,20,0,12,14,20,182,65,14,15,168,66,22126
15000US060990036032,199,77,0,12,0,12,0,12,199,77,18,25,181,75,22127
15000US060990036033,329,83,53,47,26,36,27,30,276,79,81,43,195,83,22128
15000US060990036034,491,94,37,45,21,35,16,26,454,98,95,53,359,106,22129
15000US060990036041,286,73,0,12,0,12,0,12,286,73,108,57,178,83,22130
15000US060990036042,203,81,112,74,0,12,112,74,91,47,18,21,73,42,22131
15000US060990036043,857,140,93,67,43,52,50,44,764,147,152,76,612,147,22132
15000US060990036044,350,105,48,56,14,23,34,52,302,99,11,17,291,104,22133
15000US060990036045,1085,130,26,34,21,33,5,9,1059,135,159,64,900,152,22134
15000US060990036051,1219,152,81,59,17,27,64,61,1138,155,348,106,790,157,22135
15000US060990036052,1587,184,121,97,0,12,121,97,1466,208,471,175,995,171,22136
15000US060990036053,0,12,0,12,0,12,0,12,0,12,0,12,0,12,22137
15000US060990036061,2518,202,44,41,0,17,44,41,2474,202,674,176,1800,209,22138
15000US060990036062,1063,176,35,32,0,12,35,32,1028,178,241,104,787,174,22139
15000US060990037001,764,92,156,84,49,48,107,67,608,87,203,67,405,110,22140
15000US060990037002,232,64,20,18,9,14,11,13,212,63,69,48,143,51,22141
15000US060990037003,345,65,38,42,21,29,17,30,307,61,121,47,186,65,22142
15000US060990038021,266,67,80,49,21,25,59,46,186,70,98,57,88,45,22143
15000US060990038022,317,79,115,57,35,36,80,46,202,63,101,61,101,55,22144
15000US060990038023,556,110,145,75,64,53,81,53,411,100,73,55,338,99,22145
15000US060990038024,470,97,191,82,94,58,97,65,279,89,107,67,172,72,22146
15000US060990038031,426,70,89,46,33,29,56,35,337,65,108,41,229,67,22147
15000US060990038032,400,65,114,50,72,43,42,35,286,58,128,48,158,58,22148
15000US060990038041,419,120,68,60,38,44,30,38,351,106,102,70,249,103,22149
15000US060990038042,401,137,58,52,26,30,32,41,343,138,88,46,255,136,22150
15000US060990038043,1029,159,30,34,15,24,15,23,999,163,352,140,647,163,22151
15000US060990038044,479,170,183,125,0,12,183,125,296,126,66,63,230,118,22152
15000US060990038051,924,69,54,32,13,14,41,25,870,77,233,60,637,79,22153
15000US060990039041,483,85,29,26,18,20,11,17,454,85,119,50,335,83,22154
15000US060990039042,292,69,76,62,64,61,12,19,216,60,63,39,153,54,22155
15000US060990039043,554,93,40,35,10,17,30,31,514,99,271,75,243,96,22156
15000US060990039044,461,97,83,77,33,52,50,60,378,101,195,81,183,96,22157
15000US060990039051,346,58,0,12,0,12,0,12,346,58,118,68,228,55,22158
15000US060990039052,469,62,21,23,21,23,0,12,448,66,72,41,376,72,22159
15000US060990039053,502,66,23,26,0,12,23,26,479,68,86,45,393,76,22160
15000US060990039054,203,47,20,19,12,16,8,13,183,47,39,30,144,49,22161
15000US060990039061,385,92,100,81,79,76,21,24,285,80,97,55,188,66,22162
15000US060990039062,965,125,320,111,83,44,237,104,645,120,203,96,442,102,22163
15000US060990039063,603,115,115,60,24,31,91,53,488,117,180,95,308,84,22164
15000US060990039071,698,119,31,33,18,27,13,20,667,124,174,107,493,122,22165
15000US060990039072,882,164,26,34,0,12,26,34,856,164,319,143,537,148,22166
15000US060990039073,431,115,40,40,0,12,40,40,391,112,196,90,195,76,22167
15000US060990039074,882,138,26,28,13,19,13,20,856,136,191,94,665,161,22168
15000US060990039081,516,77,132,51,18,17,114,50,384,73,184,53,200,68,22169
15000US060990039082,384,74,107,50,10,13,97,52,277,74,51,33,226,68,22170
15000US060990039091,621,164,155,121,89,119,66,51,466,137,106,64,360,137,22171
15000US060990039092,566,131,78,71,46,55,32,45,488,130,263,122,225,102,22172
15000US060990039093,566,130,76,68,15,25,61,68,490,123,74,59,416,120,22173
15000US060990039094,450,161,82,58,29,33,53,49,368,165,158,117,210,143,22174
15000US060990040001,342,75,10,12,3,5,7,11,332,73,109,49,223,65,22175
15000US060990040002,364,73,0,12,0,12,0,12,364,73,59,31,305,74,22176
15000US060990040003,528,70,34,19,19,15,15,12,494,68,148,49,346,58,22177
15000US061010501011,903,129,54,42,8,14,46,38,849,129,312,94,537,127,22178
15000US061010501012,613,136,65,56,0,12,65,56,548,136,74,73,474,134,22179
15000US061010501013,487,138,200,91,0,12,200,91,287,126,64,56,223,115,22180
15000US061010501014,395,107,46,30,9,15,37,35,349,107,242,105,107,69,22181
15000US061010501021,582,111,38,31,18,21,20,23,544,108,230,82,314,102,22182
15000US061010501022,577,93,140,89,16,18,124,87,437,95,123,57,314,88,22183
15000US061010501023,643,110,163,80,96,63,67,54,480,98,207,65,273,81,22184
15000US061010502011,625,88,108,59,33,38,75,55,517,91,136,65,381,90,22185
15000US061010502012,539,83,75,47,32,33,43,36,464,92,37,27,427,94,22186
15000US061010502021,282,89,108,73,20,21,88,71,174,64,63,36,111,62,22187
15000US061010502022,333,72,66,48,22,25,44,41,267,66,84,39,183,67,22188
15000US061010502023,246,90,52,48,14,23,38,40,194,84,138,76,56,45,22189
15000US061010502024,533,88,191,87,23,23,168,82,342,96,114,50,228,88,22190
15000US061010503011,392,64,26,22,5,7,21,22,366,66,89,31,277,72,22191
15000US061010503012,587,72,49,41,36,39,13,13,538,70,127,41,411,75,22192
15000US061010503021,435,110,22,26,22,26,0,12,413,113,100,50,313,112,22193
15000US061010503022,651,133,153,95,19,18,134,90,498,132,99,84,399,123,22194
15000US061010503023,319,108,125,76,88,67,37,37,194,88,43,38,151,85,22195
15000US061010503024,470,101,39,50,6,10,33,50,431,97,122,62,309,98,22196
15000US061010504011,409,95,48,40,7,12,41,40,361,90,137,83,224,80,22197
15000US061010504012,403,87,11,16,0,12,11,16,392,87,60,39,332,84,22198
15000US061010504013,441,90,70,62,70,62,0,12,371,90,113,57,258,83,22199
15000US061010504014,387,92,21,28,21,28,0,12,366,92,128,66,238,104,22200
15000US061010504021,455,71,13,16,0,12,13,16,442,72,126,49,316,78,22201
15000US061010504022,861,92,69,56,12,14,57,55,792,102,245,78,547,84,22202
15000US061010504031,985,83,112,52,77,47,35,31,873,93,225,89,648,96,22203
15000US061010505011,342,62,19,17,17,16,2,6,323,66,113,39,210,65,22204
15000US061010505012,195,47,0,12,0,12,0,12,195,47,45,31,150,44,22205
15000US061010505013,703,105,75,54,10,14,65,52,628,107,86,56,542,114,22206
15000US061010505014,706,119,200,102,91,78,109,70,506,109,135,53,371,98,22207
15000US061010505031,224,68,38,37,20,33,18,21,186,63,79,46,107,47,22208
15000US061010505032,486,139,24,28,13,22,11,18,462,144,190,124,272,129,22209
15000US061010505033,599,150,28,35,16,25,12,24,571,149,173,102,398,145,22210
15000US061010505034,250,88,0,12,0,12,0,12,250,88,25,27,225,86,22211
15000US061010505035,526,113,63,63,18,29,45,53,463,112,198,99,265,97,22212
15000US061010505041,465,96,3,6,0,12,3,6,462,96,125,69,337,88,22213
15000US061010505042,248,106,26,39,0,12,26,39,222,101,80,74,142,90,22214
15000US061010505043,1120,157,37,48,0,12,37,48,1083,156,260,116,823,184,22215
15000US061010505044,346,89,0,12,0,12,0,12,346,89,100,74,246,73,22216
15000US061010506011,401,90,1,3,1,3,0,12,400,89,95,56,305,87,22217
15000US061010506012,557,111,54,61,9,14,45,60,503,98,116,55,387,101,22218
15000US061010506013,990,150,110,73,8,14,102,71,880,137,299,108,581,117,22219
15000US061010506031,339,63,17,19,9,14,8,13,322,63,185,61,137,53,22220
15000US061010506032,431,69,49,48,19,24,30,42,382,72,49,35,333,72,22221
15000US061010506033,537,91,9,16,0,12,9,16,528,91,104,54,424,97,22222
15000US061010506034,610,77,13,19,0,12,13,19,597,79,228,79,369,90,22223
15000US061010506041,558,100,39,27,27,21,12,18,519,101,116,56,403,98,22224
15000US061010506042,1032,120,26,28,12,20,14,17,1006,125,231,84,775,129,22225
15000US061010507011,781,98,158,70,87,70,71,43,623,108,224,69,399,113,22226
15000US061010507012,583,92,132,61,73,46,59,37,451,82,144,62,307,78,22227
15000US061010507021,826,111,180,85,46,30,134,72,646,110,245,79,401,87,22228
15000US061010507022,577,91,90,42,41,27,49,32,487,96,171,58,316,94,22229
15000US061010507023,317,57,15,14,15,14,0,12,302,57,144,60,158,51,22230
15000US061010508001,776,113,40,35,30,31,10,17,736,112,197,87,539,102,22231
15000US061010508002,483,88,7,11,0,12,7,11,476,89,141,72,335,101,22232
15000US061010509001,293,41,40,26,11,16,29,21,253,44,71,25,182,39,22233
15000US061010509002,326,56,52,37,21,19,31,33,274,60,90,48,184,54,22234
15000US061010510001,305,67,27,19,13,13,14,14,278,65,32,17,246,69,22235
15000US061010510002,540,88,69,54,49,51,20,22,471,88,107,50,364,93,22236
15000US061010511001,256,35,17,15,10,11,7,10,239,33,74,26,165,28,22237
15000US061010511002,320,49,15,9,11,8,4,4,305,48,91,29,214,39,22238
15000US061010511003,427,58,25,18,21,18,4,5,402,59,113,35,289,48,22239
15000US061030001001,407,79,52,38,29,32,23,22,355,71,97,31,258,59,22240
15000US061030001002,678,83,77,44,40,24,37,37,601,83,250,58,351,65,22241
15000US061030001003,359,67,28,24,23,22,5,8,331,65,97,38,234,59,22242
15000US061030001004,295,66,9,12,9,12,0,12,286,66,99,39,187,62,22243
15000US061030002001,608,154,89,81,64,73,25,40,519,159,225,127,294,117,22244
15000US061030002002,1235,179,73,75,44,59,29,42,1162,169,347,116,815,188,22245
15000US061030002003,1192,143,52,45,31,34,21,27,1140,150,411,161,729,156,22246
15000US061030003001,773,101,48,40,17,19,31,40,725,104,313,83,412,79,22247
15000US061030003002,988,122,189,80,134,63,55,44,799,119,382,116,417,125,22248
15000US061030004001,712,94,14,12,13,12,1,3,698,95,223,88,475,107,22249
15000US061030004002,590,99,55,38,50,35,5,11,535,104,227,96,308,72,22250
15000US061030004003,849,128,90,69,29,33,61,58,759,136,252,126,507,148,22251
15000US061030005001,839,161,70,63,39,42,31,47,769,145,213,105,556,154,22252
15000US061030005002,239,109,22,34,22,34,0,12,217,111,12,18,205,112,22253
15000US061030005003,364,102,114,74,44,41,70,61,250,93,65,54,185,87,22254
15000US061030005004,483,116,75,57,35,32,40,46,408,128,273,129,135,64,22255
15000US061030005005,270,103,45,43,12,18,33,39,225,111,93,69,132,87,22256
15000US061030006001,837,177,268,180,102,112,166,164,569,146,242,114,327,117,22257
15000US061030006002,578,125,87,103,87,103,0,12,491,106,223,90,268,106,22258
15000US061030006003,503,110,216,125,53,62,163,109,287,91,76,52,211,84,22259
15000US061030007001,576,140,247,128,77,48,170,125,329,105,85,57,244,98,22260
15000US061030007002,731,193,59,49,22,25,37,43,672,196,377,167,295,139,22261
15000US061030007003,327,113,0,12,0,12,0,12,327,113,189,105,138,82,22262
15000US061030007004,682,176,203,136,69,72,134,127,479,141,216,89,263,119,22263
15000US061030007005,591,149,89,66,33,31,56,54,502,128,221,101,281,116,22264
15000US061030008001,328,85,44,49,26,44,18,21,284,81,113,56,171,71,22265
15000US061030008002,195,73,24,24,7,11,17,22,171,70,48,37,123,65,22266
15000US061030008003,373,106,73,85,65,84,8,13,300,89,71,60,229,73,22267
15000US061030008004,474,113,65,50,0,12,65,50,409,112,200,96,209,85,22268
15000US061030009001,352,81,56,49,5,7,51,49,296,72,99,34,197,72,22269
15000US061030009002,558,87,85,53,69,51,16,16,473,90,189,76,284,80,22270
15000US061030009003,474,94,27,26,6,10,21,24,447,92,155,73,292,81,22271
15000US061030010001,219,44,15,11,10,10,5,6,204,44,61,26,143,39,22272
15000US061030010002,1073,154,133,115,130,115,3,7,940,187,319,125,621,171,22273
15000US061030010003,442,146,105,73,49,59,56,66,337,147,76,82,261,130,22274
15000US061030010004,413,91,15,23,0,12,15,23,398,95,155,73,243,84,22275
15000US061030010005,245,51,16,11,3,4,13,11,229,50,75,34,154,43,22276
15000US061030011001,351,103,14,19,11,18,3,4,337,105,51,40,286,105,22277
15000US061030011002,399,115,251,138,92,92,159,111,148,103,35,33,113,100,22278
15000US061030011003,361,161,6,9,1,2,5,8,355,161,101,104,254,124,22279
15000US061030011004,796,171,156,108,46,69,110,84,640,166,203,104,437,150,22280
15000US061030011005,199,77,19,32,19,32,0,12,180,70,13,20,167,73,22281
15000US061030011006,615,156,116,107,56,73,60,80,499,141,66,45,433,145,22282
15000US061050001011,189,52,11,12,6,9,5,9,178,48,89,40,89,34,22283
15000US061050001012,594,91,69,43,45,34,24,23,525,85,273,72,252,61,22284
15000US061050001013,278,65,15,18,13,18,2,3,263,62,82,39,181,57,22285
15000US061050001021,465,133,34,37,28,36,6,11,431,134,120,57,311,115,22286
15000US061050001022,794,152,148,98,27,40,121,87,646,138,325,131,321,127,22287
15000US061050001023,537,144,0,12,0,12,0,12,537,144,166,110,371,137,22288
15000US061050002001,471,69,46,21,14,11,32,21,425,65,169,41,256,55,22289
15000US061050002002,411,80,29,22,21,18,8,12,382,78,144,53,238,69,22290
15000US061050003001,488,169,130,104,29,44,101,93,358,117,169,95,189,87,22291
15000US061050003002,594,134,30,47,0,12,30,47,564,141,317,129,247,103,22292
15000US061050003003,303,101,27,42,27,42,0,12,276,92,166,72,110,70,22293
15000US061050004001,223,58,0,12,0,12,0,12,223,58,119,45,104,45,22294
15000US061050004002,121,31,0,12,0,12,0,12,121,31,47,22,74,26,22295
15000US061070001001,67,32,3,4,3,4,0,12,64,32,12,12,52,31,22296
15000US061070001002,203,66,8,9,3,5,5,8,195,66,110,67,85,45,22297
15000US061070001003,484,101,26,35,0,12,26,35,458,99,185,86,273,65,22298
15000US061070001004,477,78,19,15,8,9,11,10,458,71,103,37,355,65,22299
15000US061070001005,592,109,52,34,20,24,32,27,540,106,192,68,348,85,22300
15000US061070002011,487,150,256,157,103,109,153,150,231,99,98,69,133,72,22301
15000US061070002012,444,131,78,66,49,54,29,33,366,113,61,46,305,113,22302
15000US061070002013,309,131,105,79,14,24,91,75,204,110,26,43,178,104,22303
15000US061070002014,438,133,155,73,63,49,92,74,283,134,120,103,163,95,22304
15000US061070002015,528,167,173,127,85,94,88,84,355,176,99,103,256,131,22305
15000US061070002021,210,61,96,43,25,20,71,45,114,62,43,33,71,51,22306
15000US061070002022,239,60,30,27,16,15,14,22,209,56,55,40,154,48,22307
15000US061070002023,210,64,79,44,26,23,53,36,131,52,39,31,92,46,22308
15000US061070003011,575,115,105,95,44,67,61,68,470,110,126,91,344,94,22309
15000US061070003012,434,101,135,59,34,31,101,53,299,90,69,39,230,74,22310
15000US061070003013,388,89,40,37,8,10,32,36,348,92,129,52,219,77,22311
15000US061070003014,138,39,47,25,27,20,20,18,91,35,39,28,52,32,22312
15000US061070003015,148,84,38,44,13,20,25,40,110,78,49,76,61,47,22313
15000US061070003016,300,105,50,41,31,32,19,24,250,112,114,84,136,102,22314
15000US061070003021,153,30,41,21,12,10,29,20,112,25,34,19,78,21,22315
15000US061070003022,491,42,238,49,88,37,150,42,253,49,85,27,168,46,22316
15000US061070003023,217,34,77,26,26,14,51,21,140,28,45,22,95,27,22317
15000US061070004011,305,82,65,46,8,14,57,43,240,80,39,34,201,79,22318
15000US061070004012,620,104,158,58,71,47,87,57,462,99,141,65,321,94,22319
15000US061070004013,714,100,230,92,27,32,203,88,484,98,145,66,339,95,22320
15000US061070004021,284,84,56,72,0,12,56,72,228,61,36,27,192,63,22321
15000US061070004022,1207,176,340,141,84,68,256,129,867,165,382,118,485,157,22322
15000US061070004023,619,155,299,152,82,95,217,135,320,120,96,88,224,123,22323
15000US061070005011,607,93,197,76,57,42,140,65,410,92,162,60,248,80,22324
15000US061070005012,314,74,118,50,13,20,105,46,196,64,86,39,110,59,22325
15000US061070005013,416,85,175,60,31,29,144,59,241,79,86,54,155,63,22326
15000US061070005014,397,69,131,58,30,23,101,54,266,73,85,42,181,68,22327
15000US061070005021,934,76,217,80,52,40,165,74,717,106,186,70,531,98,22328
15000US061070006001,508,106,133,78,37,50,96,60,375,95,91,52,284,100,22329
15000US061070006002,358,107,213,88,64,59,149,77,145,80,64,54,81,64,22330
15000US061070006003,201,93,130,81,22,36,108,73,71,47,27,21,44,47,22331
15000US061070006004,479,108,125,85,12,11,113,84,354,90,118,48,236,80,22332
15000US061070007011,392,54,96,57,19,16,77,55,296,65,33,20,263,64,22333
15000US061070007012,387,70,41,32,18,17,23,28,346,72,94,51,252,64,22334
15000US061070007021,527,92,187,80,27,36,160,66,340,102,69,47,271,97,22335
15000US061070007022,267,69,21,20,15,18,6,9,246,66,94,52,152,59,22336
15000US061070007023,559,105,85,45,4,8,81,43,474,101,112,51,362,98,22337
15000US061070007024,247,91,77,60,18,22,59,55,170,76,73,51,97,64,22338
15000US061070008001,210,66,106,60,59,57,47,27,104,42,44,28,60,33,22339
15000US061070008002,421,152,50,52,50,52,0,12,371,149,0,12,371,149,22340
15000US061070008003,396,131,13,21,13,21,0,12,383,135,35,31,348,130,22341
15000US061070008004,206,109,15,24,0,12,15,24,191,111,134,101,57,45,22342
15000US061070008005,410,102,228,98,54,47,174,99,182,107,59,68,123,82,22343
15000US061070008006,598,145,154,98,49,45,105,85,444,141,127,81,317,129,22344
15000US061070009001,163,54,31,22,0,12,31,22,132,52,70,44,62,42,22345
15000US061070009002,625,118,107,78,34,53,73,58,518,116,117,62,401,110,22346
15000US061070009003,235,88,51,49,15,17,36,45,184,81,39,34,145,75,22347
15000US061070009004,719,115,315,98,84,61,231,86,404,95,66,45,338,100,22348
15000US061070009005,241,82,73,52,30,34,43,43,168,81,106,68,62,60,22349
15000US061070010031,2472,414,0,17,0,17,0,17,2472,414,226,161,2246,416,22350
15000US061070010032,865,280,58,97,58,97,0,12,807,273,22,44,785,273,22351
15000US061070010033,1354,365,178,152,178,152,0,12,1176,374,427,267,749,314,22352
15000US061070010034,1401,424,397,370,204,233,193,284,1004,249,363,189,641,243,22353
15000US061070010035,466,198,161,141,88,108,73,95,305,188,31,51,274,179,22354
15000US061070010041,564,100,181,89,26,23,155,87,383,100,88,52,295,90,22355
15000US061070010042,488,112,126,66,55,34,71,53,362,98,184,86,178,67,22356
15000US061070010043,660,129,276,110,139,88,137,77,384,103,178,64,206,89,22357
15000US061070010044,274,87,130,71,38,36,92,65,144,65,43,36,101,59,22358
15000US061070010051,1036,83,114,71,102,69,12,20,922,108,223,88,699,106,22359
15000US061070010061,279,63,0,12,0,12,0,12,279,63,73,54,206,75,22360
15000US061070010062,440,125,46,51,19,29,27,43,394,133,54,50,340,123,22361
15000US061070010063,828,154,88,102,21,33,67,96,740,167,109,62,631,159,22362
15000US061070010064,393,89,14,23,0,12,14,23,379,93,71,52,308,96,22363
15000US061070010065,278,87,0,12,0,12,0,12,278,87,110,96,168,75,22364
15000US061070011001,483,108,276,89,71,58,205,81,207,90,105,65,102,73,22365
15000US061070011002,274,101,120,57,58,41,62,46,154,93,72,66,82,62,22366
15000US061070011003,719,120,373,102,198,82,175,76,346,97,136,56,210,82,22367
15000US061070011004,484,109,207,89,25,24,182,83,277,93,159,81,118,65,22368
15000US061070012001,521,60,134,52,91,40,43,27,387,66,152,47,235,61,22369
15000US061070013011,822,161,81,86,0,12,81,86,741,159,243,145,498,159,22370
15000US061070013012,883,198,183,129,58,52,125,124,700,179,142,94,558,170,22371
15000US061070013013,921,148,265,119,129,109,136,100,656,162,158,109,498,134,22372
15000US061070013021,130,92,12,20,0,12,12,20,118,89,101,84,17,28,22373
15000US061070013022,652,159,123,71,67,70,56,52,529,170,194,116,335,147,22374
15000US061070013023,791,183,173,123,0,12,173,123,618,172,175,103,443,157,22375
15000US061070013024,872,159,175,99,91,68,84,80,697,176,91,76,606,171,22376
15000US061070014001,810,90,160,76,24,27,136,69,650,101,133,65,517,119,22377
15000US061070014002,274,64,0,12,0,12,0,12,274,64,94,46,180,59,22378
15000US061070014003,257,50,9,13,0,12,9,13,248,48,66,33,182,49,22379
15000US061070014004,270,90,30,43,0,12,30,43,240,79,107,62,133,62,22380
15000US061070014005,242,48,42,26,16,18,26,20,200,47,53,24,147,38,22381
15000US061070015011,866,129,133,64,10,16,123,64,733,136,214,92,519,125,22382
15000US061070015012,1011,124,171,76,77,50,94,60,840,129,226,66,614,125,22383
15000US061070015021,626,103,98,59,24,28,74,61,528,99,142,45,386,96,22384
15000US061070015022,274,79,88,64,11,17,77,62,186,73,6,9,180,75,22385
15000US061070015023,617,115,227,86,64,54,163,63,390,110,66,39,324,104,22386
15000US061070015024,264,80,66,42,19,21,47,41,198,76,98,52,100,62,22387
15000US061070016011,317,76,83,55,34,27,49,48,234,68,99,51,135,64,22388
15000US061070016012,320,99,152,78,89,61,63,49,168,80,70,50,98,69,22389
15000US061070016013,311,89,135,70,20,22,115,65,176,81,62,49,114,68,22390
15000US061070016014,350,77,139,63,62,41,77,49,211,75,105,46,106,65,22391
15000US061070016021,211,93,123,82,58,45,65,69,88,64,55,52,33,40,22392
15000US061070016022,478,92,77,52,26,22,51,47,401,87,94,48,307,96,22393
15000US061070016023,544,99,106,66,43,37,63,55,438,108,174,71,264,98,22394
15000US061070016024,273,61,71,54,21,20,50,50,202,55,63,28,139,48,22395
15000US061070017011,445,109,215,113,114,80,101,93,230,110,91,71,139,105,22396
15000US061070017012,358,128,129,89,0,12,129,89,229,106,97,77,132,103,22397
15000US061070017013,527,119,195,107,125,85,70,77,332,132,167,107,165,92,22398
15000US061070017014,451,104,159,90,90,69,69,58,292,112,12,24,280,113,22399
15000US061070017015,423,111,57,44,0,12,57,44,366,115,170,84,196,89,22400
15000US061070017031,707,173,87,100,13,20,74,98,620,189,119,85,501,184,22401
15000US061070017032,651,169,16,28,0,12,16,28,635,165,275,155,360,119,22402
15000US061070017033,1177,175,58,54,16,24,42,49,1119,175,227,84,892,178,22403
15000US061070017041,2446,178,455,196,152,114,303,172,1991,242,467,171,1524,223,22404
15000US061070018001,280,80,35,44,8,12,27,43,245,71,77,55,168,58,22405
15000US061070018002,667,98,121,68,72,63,49,33,546,82,163,58,383,85,22406
15000US061070018003,330,70,10,15,0,12,10,15,320,70,133,66,187,72,22407
15000US061070018004,468,97,135,64,63,44,72,54,333,82,111,54,222,84,22408
15000US061070019011,320,96,13,16,7,11,6,11,307,96,79,37,228,89,22409
15000US061070019012,634,117,49,46,19,23,30,39,585,109,252,93,333,126,22410
15000US061070019013,269,85,15,25,0,12,15,25,254,84,40,28,214,88,22411
15000US061070019021,257,81,47,36,20,26,27,25,210,84,40,32,170,80,22412
15000US061070019022,392,87,88,61,17,27,71,54,304,86,48,44,256,83,22413
15000US061070019023,461,70,54,48,12,18,42,43,407,68,98,52,309,67,22414
15000US061070019024,298,77,27,26,12,19,15,19,271,73,72,37,199,73,22415
15000US061070020021,264,60,37,35,16,18,21,32,227,60,78,47,149,54,22416
15000US061070020022,541,107,209,75,141,68,68,58,332,91,107,45,225,92,22417
15000US061070020023,377,79,44,28,38,26,6,11,333,80,86,48,247,72,22418
15000US061070020024,397,75,34,22,25,21,9,14,363,76,100,45,263,74,22419
15000US061070020031,444,141,141,100,43,54,98,85,303,106,77,54,226,104,22420
15000US061070020032,278,92,56,55,14,25,42,50,222,86,93,63,129,81,22421
15000US061070020033,175,80,11,19,11,19,0,12,164,82,29,42,135,75,22422
15000US061070020034,625,157,115,69,45,45,70,65,510,163,38,46,472,165,22423
15000US061070020035,566,167,194,115,102,84,92,82,372,135,128,88,244,111,22424
15000US061070020041,365,90,48,41,48,41,0,12,317,88,130,74,187,64,22425
15000US061070020042,946,118,95,62,14,17,81,59,851,121,312,89,539,112,22426
15000US061070020043,418,79,42,42,34,40,8,14,376,78,75,42,301,72,22427
15000US061070020061,477,77,18,20,0,12,18,20,459,78,178,60,281,73,22428
15000US061070020062,1056,90,105,66,8,12,97,64,951,94,147,76,804,97,22429
15000US061070020071,1303,152,60,50,36,38,24,31,1243,157,365,116,878,159,22430
15000US061070020072,1104,161,76,55,60,49,16,23,1028,157,322,132,706,170,22431
15000US061070020073,561,146,212,139,21,34,191,132,349,131,125,101,224,117,22432
15000US061070020081,792,94,282,81,106,64,176,84,510,110,198,91,312,95,22433
15000US061070020082,328,80,21,21,7,11,14,18,307,81,150,68,157,68,22434
15000US061070020091,506,101,52,35,28,25,24,22,454,100,133,65,321,96,22435
15000US061070020092,714,97,115,71,55,59,60,42,599,119,134,66,465,108,22436
15000US061070020093,302,81,50,41,6,10,44,41,252,81,66,40,186,75,22437
15000US061070021001,305,39,69,24,16,12,53,20,236,42,65,28,171,39,22438
15000US061070021002,380,41,82,29,32,19,50,23,298,44,89,31,209,44,22439
15000US061070022021,555,91,302,91,122,69,180,73,253,83,93,48,160,78,22440
15000US061070022022,202,67,48,26,25,22,23,25,154,69,25,24,129,66,22441
15000US061070022023,921,102,331,92,164,76,167,71,590,116,154,59,436,118,22442
15000US061070022031,810,101,282,100,117,70,165,84,528,104,147,71,381,107,22443
15000US061070022032,360,84,46,39,7,11,39,38,314,78,52,36,262,82,22444
15000US061070022041,1057,128,407,112,78,62,329,99,650,103,207,76,443,103,22445
15000US061070022042,473,109,125,75,60,47,65,63,348,92,188,81,160,76,22446
15000US061070022043,243,80,70,43,61,41,9,15,173,83,40,29,133,85,22447
15000US061070023021,437,88,32,29,10,15,22,25,405,92,238,102,167,55,22448
15000US061070023022,762,113,86,51,27,26,59,42,676,101,237,73,439,88,22449
15000US061070023023,386,78,93,46,25,31,68,46,293,80,95,55,198,73,22450
15000US061070023031,326,99,16,24,16,24,0,12,310,99,93,78,217,95,22451
15000US061070023032,833,165,13,18,0,12,13,18,820,164,155,70,665,172,22452
15000US061070023033,421,130,0,12,0,12,0,12,421,130,140,71,281,125,22453
15000US061070023034,569,124,72,68,13,24,59,61,497,122,224,107,273,120,22454
15000US061070023035,273,87,23,36,23,36,0,12,250,79,34,53,216,73,22455
15000US061070023041,380,63,119,52,53,36,66,43,261,62,138,61,123,42,22456
15000US061070023042,345,56,63,39,6,9,57,39,282,60,89,42,193,61,22457
15000US061070024001,1597,171,98,48,31,30,67,37,1499,171,375,117,1124,185,22458
15000US061070024002,322,100,63,70,46,66,17,26,259,74,45,37,214,75,22459
15000US061070024003,501,132,39,44,24,41,15,16,462,135,148,83,314,127,22460
15000US061070024004,425,105,46,34,14,13,32,32,379,104,99,46,280,104,22461
15000US061070024005,840,127,8,12,8,12,0,12,832,127,276,92,556,131,22462
15000US061070025001,170,67,8,13,8,13,0,12,162,65,51,29,111,66,22463
15000US061070025002,335,83,30,39,0,12,30,39,305,77,126,47,179,69,22464
15000US061070025003,287,73,72,57,58,57,14,16,215,82,28,26,187,84,22465
15000US061070025004,362,79,106,52,6,9,100,51,256,82,60,53,196,81,22466
15000US061070026011,414,120,160,89,52,50,108,80,254,107,102,65,152,93,22467
15000US061070026012,223,102,67,53,12,20,55,60,156,102,8,14,148,101,22468
15000US061070026013,648,124,98,64,22,24,76,58,550,133,104,56,446,130,22469
15000US061070026021,258,81,50,33,24,23,26,26,208,81,73,50,135,66,22470
15000US061070026022,417,92,85,67,30,27,55,63,332,84,150,76,182,96,22471
15000US061070026023,316,87,21,23,10,15,11,17,295,92,66,42,229,90,22472
15000US061070026024,360,95,145,70,34,56,111,73,215,98,46,43,169,95,22473
15000US061070026025,184,72,74,69,33,52,41,45,110,69,21,25,89,69,22474
15000US061070027001,221,94,0,12,0,12,0,12,221,94,38,36,183,106,22475
15000US061070027002,525,124,44,68,0,12,44,68,481,122,118,58,363,128,22476
15000US061070027003,311,110,105,88,88,83,17,24,206,112,161,105,45,40,22477
15000US061070027004,1058,142,74,35,15,12,59,30,984,142,347,116,637,129,22478
15000US061070027005,292,83,33,25,1,3,32,24,259,80,134,83,125,42,22479
15000US061070028001,581,107,300,87,57,37,243,78,281,64,103,37,178,60,22480
15000US061070028002,420,82,133,58,33,34,100,48,287,73,57,35,230,67,22481
15000US061070029011,627,86,156,69,62,41,94,55,471,93,164,57,307,97,22482
15000US061070029012,384,68,100,51,11,18,89,45,284,69,117,52,167,65,22483
15000US061070029013,114,52,56,45,56,45,0,12,58,55,32,39,26,40,22484
15000US061070029031,687,98,106,76,43,64,63,50,581,95,114,49,467,96,22485
15000US061070029032,381,105,77,58,40,49,37,32,304,108,79,46,225,100,22486
15000US061070029033,259,95,45,45,11,16,34,42,214,88,97,47,117,82,22487
15000US061070029034,295,68,74,63,74,63,0,12,221,52,67,40,154,47,22488
15000US061070029041,978,106,217,87,130,69,87,57,761,113,257,82,504,107,22489
15000US061070029042,608,103,144,69,50,36,94,62,464,91,164,76,300,81,22490
15000US061070030011,328,93,129,68,91,61,38,29,199,75,107,61,92,49,22491
15000US061070030012,483,111,299,104,123,68,176,85,184,82,28,25,156,79,22492
15000US061070030013,429,93,213,97,28,34,185,97,216,74,97,53,119,52,22493
15000US061070030021,430,88,80,51,14,16,66,50,350,86,123,51,227,78,22494
15000US061070030022,507,77,151,71,51,43,100,57,356,86,122,57,234,69,22495
15000US061070031001,213,45,12,10,2,3,10,9,201,43,35,16,166,41,22496
15000US061070031002,571,62,212,55,72,36,140,47,359,54,116,34,243,52,22497
15000US061070031003,227,42,50,28,7,11,43,27,177,40,46,22,131,38,22498
15000US061070032001,706,78,342,86,89,42,253,75,364,75,106,51,258,69,22499
15000US061070032002,131,43,25,26,8,13,17,24,106,36,14,15,92,35,22500
15000US061070032003,188,48,21,19,0,12,21,19,167,46,53,33,114,39,22501
15000US061070032004,423,60,139,49,28,21,111,47,284,63,116,46,168,53,22502
15000US061070032005,261,51,131,42,36,28,95,40,130,38,7,9,123,38,22503
15000US061070033001,435,140,29,32,29,32,0,12,406,142,44,30,362,136,22504
15000US061070033002,335,68,120,44,36,25,84,42,215,52,56,30,159,50,22505
15000US061070033003,179,40,12,17,1,4,11,16,167,39,31,19,136,40,22506
15000US061070033004,256,110,129,80,30,33,99,82,127,110,0,12,127,110,22507
15000US061070033005,385,104,58,39,30,31,28,23,327,101,110,48,217,102,22508
15000US061070033006,551,161,225,152,96,100,129,112,326,140,60,40,266,133,22509
15000US061070034001,709,109,265,81,41,31,224,78,444,97,94,48,350,86,22510
15000US061070034002,291,59,73,34,39,26,34,23,218,50,72,27,146,44,22511
15000US061070034003,250,86,38,34,15,20,23,28,212,81,49,25,163,72,22512
15000US061070034004,605,158,57,30,12,14,45,31,548,156,133,79,415,151,22513
15000US061070034005,176,54,32,31,0,12,32,31,144,49,50,26,94,46,22514
15000US061070035011,944,59,129,59,18,15,111,59,815,75,258,63,557,80,22515
15000US061070035021,263,114,0,12,0,12,0,12,263,114,109,92,154,91,22516
15000US061070035022,614,149,166,94,33,54,133,104,448,141,172,83,276,120,22517
15000US061070035023,587,177,158,125,23,35,135,123,429,162,100,80,329,151,22518
15000US061070035024,1621,223,69,86,17,26,52,82,1552,230,394,140,1158,218,22519
15000US061070036011,580,147,180,119,30,31,150,121,400,117,115,74,285,108,22520
15000US061070036012,460,92,147,90,43,48,104,81,313,85,96,72,217,96,22521
15000US061070036013,307,96,6,13,6,13,0,12,301,97,113,62,188,90,22522
15000US061070036014,663,134,350,144,172,114,178,120,313,134,42,43,271,132,22523
15000US061070036021,639,146,305,116,79,69,226,93,334,143,57,65,277,118,22524
15000US061070036022,407,116,91,77,49,61,42,49,316,103,121,76,195,103,22525
15000US061070036023,1091,160,132,86,11,18,121,85,959,147,107,80,852,144,22526
15000US061070037001,458,102,102,67,10,17,92,65,356,97,36,37,320,97,22527
15000US061070037002,360,83,93,62,20,27,73,56,267,66,93,66,174,67,22528
15000US061070037003,649,115,134,83,49,32,85,80,515,112,104,46,411,114,22529
15000US061070037004,391,104,100,57,51,34,49,52,291,97,60,39,231,86,22530
15000US061070038011,424,92,68,61,0,12,68,61,356,100,87,55,269,90,22531
15000US061070038012,582,88,214,93,28,38,186,88,368,96,139,66,229,86,22532
15000US061070038021,579,96,187,77,52,43,135,66,392,90,189,65,203,85,22533
15000US061070038022,369,93,201,89,59,52,142,76,168,82,54,54,114,69,22534
15000US061070038023,511,99,133,77,13,16,120,76,378,83,104,46,274,83,22535
15000US061070039011,231,86,26,22,17,18,9,13,205,85,26,20,179,88,22536
15000US061070039012,215,90,130,84,8,12,122,82,85,51,23,26,62,54,22537
15000US061070039013,229,82,66,46,47,49,19,20,163,67,37,27,126,70,22538
15000US061070039014,561,143,180,106,27,43,153,101,381,107,88,61,293,95,22539
15000US061070039015,581,135,196,105,67,52,129,85,385,121,167,78,218,104,22540
15000US061070039021,731,109,133,74,68,52,65,50,598,95,112,46,486,97,22541
15000US061070039022,449,70,127,44,32,16,95,39,322,65,73,44,249,71,22542
15000US061070039023,333,74,149,48,29,19,120,47,184,56,81,33,103,47,22543
15000US061070040001,0,12,0,12,0,12,0,12,0,12,0,12,0,12,22544
15000US061070041011,848,180,263,130,36,43,227,128,585,190,114,70,471,183,22545
15000US061070041012,623,155,273,121,51,44,222,119,350,170,95,63,255,162,22546
15000US061070041013,545,161,243,132,59,78,184,127,302,121,236,130,66,65,22547
15000US061070041014,546,191,177,107,75,82,102,71,369,184,103,109,266,139,22548
15000US061070041021,600,44,157,60,41,28,116,56,443,71,126,51,317,67,22549
15000US061070042001,291,76,136,69,27,36,109,64,155,66,44,40,111,59,22550
15000US061070042002,243,94,91,68,29,43,62,55,152,84,47,55,105,57,22551
15000US061070042003,799,139,337,125,138,79,199,99,462,126,204,89,258,90,22552
15000US061070042004,275,76,59,46,9,13,50,43,216,72,32,21,184,73,22553
15000US061070043001,458,53,161,33,35,19,126,32,297,47,82,28,215,43,22554
15000US061070043002,434,88,178,61,66,40,112,51,256,90,87,50,169,80,22555
15000US061070043003,222,49,33,24,9,12,24,20,189,46,56,29,133,40,22556
15000US061070043004,670,71,257,56,65,30,192,56,413,58,146,42,267,52,22557
15000US061070044001,871,110,415,115,120,64,295,103,456,115,165,80,291,95,22558
15000US061070044002,345,88,158,79,41,39,117,70,187,79,48,41,139,65,22559
15000US061070044003,199,71,84,55,0,12,84,55,115,64,0,12,115,64,22560
15000US061070044004,326,85,82,60,0,12,82,60,244,77,97,59,147,65,22561
15000US061070045001,828,100,235,70,70,45,165,57,593,111,129,53,464,104,22562
15000US061070045002,186,74,94,58,26,30,68,51,92,51,42,33,50,43,22563
15000US061070045003,293,84,108,66,39,43,69,52,185,68,85,52,100,58,22564
15000US061070045004,352,63,34,28,20,19,14,19,318,67,74,41,244,64,22565
15000US061090011001,433,81,30,33,0,12,30,33,403,85,91,50,312,86,22566
15000US061090011002,354,87,35,28,0,12,35,28,319,86,97,55,222,82,22567
15000US061090011003,628,105,43,43,22,34,21,26,585,104,152,75,433,95,22568
15000US061090011004,224,60,41,32,18,20,23,24,183,64,57,49,126,53,22569
15000US061090012001,523,132,151,99,134,100,17,20,372,113,129,61,243,106,22570
15000US061090012002,579,119,105,81,12,21,93,77,474,116,131,60,343,99,22571
15000US061090012003,618,116,160,84,57,37,103,79,458,103,186,62,272,91,22572
15000US061090012004,177,64,46,58,46,58,0,12,131,54,14,14,117,53,22573
15000US061090021001,320,74,26,20,7,8,19,18,294,70,102,50,192,49,22574
15000US061090021002,282,109,7,10,0,12,7,10,275,107,93,62,182,90,22575
15000US061090021003,337,113,33,38,0,12,33,38,304,105,75,58,229,105,22576
15000US061090021004,196,66,48,27,20,21,28,23,148,59,83,54,65,42,22577
15000US061090021005,554,121,87,60,38,28,49,54,467,120,221,80,246,110,22578
15000US061090021006,423,70,44,56,44,56,0,12,379,88,119,61,260,84,22579
15000US061090022001,372,88,68,59,36,37,32,49,304,96,51,43,253,86,22580
15000US061090022002,186,44,4,5,4,5,0,12,182,45,56,29,126,39,22581
15000US061090022003,344,102,19,23,13,20,6,10,325,97,124,85,201,79,22582
15000US061090022004,524,113,35,40,0,12,35,40,489,110,153,64,336,111,22583
15000US061090022005,802,140,7,14,0,12,7,14,795,144,294,116,501,142,22584
15000US061090022006,383,134,98,97,14,24,84,92,285,99,106,77,179,86,22585
15000US061090022007,453,105,0,12,0,12,0,12,453,105,152,104,301,90,22586
15000US061090031001,564,154,64,76,47,71,17,29,500,145,107,83,393,127,22587
15000US061090031002,580,162,46,63,37,60,9,17,534,154,197,104,337,129,22588
15000US061090031003,580,179,67,92,12,19,55,90,513,151,264,124,249,106,22589
15000US061090031004,902,255,159,106,125,102,34,51,743,232,257,147,486,190,22590
15000US061090031005,182,116,0,12,0,12,0,12,182,116,86,88,96,81,22591
15000US061090032001,657,131,31,37,20,33,11,19,626,136,147,83,479,123,22592
15000US061090032002,213,110,0,12,0,12,0,12,213,110,40,52,173,90,22593
15000US061090032003,353,106,0,12,0,12,0,12,353,106,172,86,181,83,22594
15000US061090032004,279,114,0,12,0,12,0,12,279,114,107,70,172,110,22595
15000US061090032005,523,170,130,119,130,119,0,12,393,158,167,111,226,134,22596
15000US061090032006,267,108,25,44,25,44,0,12,242,109,218,114,24,31,22597
15000US061090041001,690,156,0,12,0,12,0,12,690,156,238,110,452,140,22598
15000US061090041002,648,146,26,30,26,30,0,12,622,149,221,153,401,144,22599
15000US061090041003,712,112,63,54,47,46,16,26,649,116,217,98,432,124,22600
15000US061090041004,417,104,28,46,28,46,0,12,389,99,82,59,307,94,22601
15000US061090042001,95,42,9,14,9,14,0,12,86,40,18,20,68,34,22602
15000US061090042002,1216,151,60,55,31,49,29,25,1156,144,414,94,742,140,22603
15000US061090042003,194,76,98,71,47,53,51,45,96,52,68,53,28,23,22604
15000US061090051001,631,138,92,96,46,71,46,64,539,113,144,75,395,112,22605
15000US061090051002,544,138,67,63,48,55,19,29,477,127,216,104,261,82,22606
15000US061090051003,800,167,74,59,61,58,13,20,726,172,286,115,440,141,22607
15000US061090051004,631,140,73,71,18,27,55,65,558,130,175,67,383,126,22608
15000US061090051005,403,129,9,19,9,19,0,12,394,128,216,112,178,97,22609
15000US061090051006,542,171,119,115,119,115,0,12,423,141,167,84,256,125,22610
15000US061090052011,221,60,23,36,23,36,0,12,198,54,81,39,117,49,22611
15000US061090052012,527,57,60,32,37,28,23,20,467,54,129,43,338,56,22612
15000US061099852021,0,12,0,12,0,12,0,12,0,12,0,12,0,12,22613
15000US061110001001,301,49,26,19,3,5,23,19,275,49,75,39,200,45,22614
15000US061110002001,306,50,47,24,8,11,39,20,259,48,104,42,155,49,22615
15000US061110002002,446,48,59,33,27,26,32,25,387,51,144,54,243,56,22616
15000US061110003021,693,125,26,30,14,23,12,19,667,126,217,102,450,159,22617
15000US061110003022,868,160,65,63,0,12,65,63,803,160,287,115,516,156,22618
15000US061110003023,779,166,278,147,170,123,108,83,501,147,121,72,380,130,22619
15000US061110003031,349,82,11,17,0,12,11,17,338,82,150,58,188,66,22620
15000US061110003032,537,95,5,11,0,12,5,11,532,95,102,64,430,92,22621
15000US061110003033,496,97,53,44,31,31,22,32,443,97,86,53,357,96,22622
15000US061110003041,233,65,13,19,1,3,12,19,220,62,51,36,169,59,22623
15000US061110003042,690,111,185,96,26,29,159,90,505,129,111,55,394,125,22624
15000US061110003043,250,84,33,36,12,20,21,29,217,72,57,58,160,60,22625
15000US061110004001,189,70,26,20,11,14,15,15,163,67,42,37,121,67,22626
15000US061110004002,299,68,1,3,1,3,0,12,298,69,87,34,211,65,22627
15000US061110004003,775,115,86,48,50,33,36,33,689,118,191,69,498,117,22628
15000US061110004004,520,119,75,75,44,65,31,44,445,114,76,44,369,118,22629
15000US061110005001,572,65,53,34,7,11,46,34,519,65,187,47,332,60,22630
15000US061110006001,306,85,50,30,35,28,15,16,256,85,71,46,185,68,22631
15000US061110006002,464,88,156,62,78,57,78,39,308,91,137,68,171,71,22632
15000US061110006003,742,95,273,76,39,38,234,73,469,95,109,51,360,103,22633
15000US061110006004,421,103,140,75,53,47,87,59,281,87,50,40,231,87,22634
15000US061110007011,700,114,105,68,67,54,38,31,595,121,157,82,438,102,22635
15000US061110007012,723,102,90,57,41,47,49,37,633,102,135,64,498,110,22636
15000US061110007013,440,98,149,80,92,67,57,45,291,80,74,52,217,74,22637
15000US061110007021,494,64,24,25,20,24,4,7,470,65,143,48,327,68,22638
15000US061110007022,431,65,43,32,0,12,43,32,388,64,131,41,257,58,22639
15000US061110008001,267,114,67,82,0,12,67,82,200,85,59,72,141,50,22640
15000US061110008002,1271,136,131,92,74,58,57,70,1140,152,423,133,717,176,22641
15000US061110008003,675,107,48,32,27,26,21,18,627,104,178,69,449,89,22642
15000US061110008004,376,64,17,20,0,12,17,20,359,67,50,32,309,75,22643
15000US061110009011,782,93,0,12,0,12,0,12,782,93,194,60,588,85,22644
15000US061110009012,280,60,0,12,0,12,0,12,280,60,73,40,207,61,22645
15000US061110009021,233,56,0,12,0,12,0,12,233,56,40,29,193,53,22646
15000US061110009022,572,79,14,13,4,6,10,12,558,79,176,52,382,69,22647
15000US061110009031,955,150,82,75,22,39,60,62,873,146,174,81,699,143,22648
15000US061110009032,302,93,0,12,0,12,0,12,302,93,69,48,233,92,22649
15000US061110009033,236,75,26,33,14,23,12,22,210,94,89,83,121,59,22650
15000US061110009034,492,86,8,15,8,15,0,12,484,92,125,84,359,82,22651
15000US061110010011,220,57,7,12,0,12,7,12,213,57,45,34,168,60,22652
15000US061110010012,585,77,29,28,0,12,29,28,556,77,122,58,434,91,22653
15000US061110010013,222,64,37,41,15,22,22,33,185,61,53,30,132,67,22654
15000US061110010021,692,118,70,88,0,12,70,88,622,116,141,67,481,128,22655
15000US061110010022,399,88,24,29,16,25,8,15,375,88,158,64,217,81,22656
15000US061110010023,951,188,39,60,39,60,0,12,912,187,262,129,650,195,22657
15000US061110010024,431,99,89,73,73,81,16,28,342,91,43,40,299,95,22658
15000US061110011011,1214,104,48,39,25,23,23,34,1166,106,275,96,891,112,22659
15000US061110011012,544,77,85,51,18,20,67,46,459,88,89,43,370,93,22660
15000US061110011021,728,90,69,64,28,33,41,52,659,85,203,68,456,92,22661
15000US061110011022,643,96,56,53,5,9,51,56,587,84,224,86,363,91,22662
15000US061110012011,1068,82,109,60,46,32,63,53,959,93,296,83,663,96,22663
15000US061110012012,722,77,123,59,42,28,81,55,599,86,194,75,405,74,22664
15000US061110012021,638,125,0,12,0,12,0,12,638,125,99,68,539,138,22665
15000US061110012022,822,115,56,47,11,19,45,42,766,115,150,76,616,120,22666
15000US061110012023,942,116,0,12,0,12,0,12,942,116,206,97,736,131,22667
15000US061110012041,813,52,110,46,71,41,39,19,703,69,188,61,515,81,22668
15000US061110012061,341,57,7,10,0,12,7,10,334,56,74,40,260,57,22669
15000US061110013011,494,126,0,12,0,12,0,12,494,126,106,99,388,123,22670
15000US061110013012,470,152,115,132,15,23,100,128,355,127,96,57,259,125,22671
15000US061110013013,998,161,5,13,5,13,0,12,993,163,233,93,760,171,22672
15000US061110013014,741,154,51,56,21,34,30,47,690,157,121,85,569,159,22673
15000US061110013021,775,38,115,56,56,40,59,42,660,57,263,59,397,62,22674
15000US061110014011,574,64,9,14,0,12,9,14,565,64,90,47,475,70,22675
15000US061110014012,824,82,24,20,10,16,14,16,800,82,189,69,611,96,22676
15000US061110014021,667,105,27,42,27,42,0,12,640,104,98,56,542,93,22677
15000US061110014022,940,117,73,52,60,47,13,22,867,132,173,91,694,144,22678
15000US061110014023,445,84,15,25,15,25,0,12,430,86,85,45,345,93,22679
15000US061110015021,1210,189,75,58,13,21,62,60,1135,193,251,132,884,187,22680
15000US061110015022,692,145,88,79,21,33,67,72,604,167,115,72,489,159,22681
15000US061110015023,889,168,126,97,90,95,36,57,763,159,153,73,610,151,22682
15000US061110015024,902,144,92,62,17,26,75,56,810,149,111,71,699,139,22683
15000US061110015031,1059,123,77,56,45,41,32,39,982,130,173,54,809,136,22684
15000US061110015032,535,99,100,62,54,52,46,32,435,109,92,55,343,105,22685
15000US061110015033,199,90,7,11,7,11,0,12,192,88,30,31,162,86,22686
15000US061110015061,853,99,59,48,0,12,59,48,794,99,236,73,558,118,22687
15000US061110015062,346,56,20,23,11,18,9,14,326,57,110,50,216,57,22688
15000US061110015063,551,82,16,18,16,18,0,12,535,79,95,56,440,71,22689
15000US061110015071,288,72,32,41,24,38,8,14,256,67,29,27,227,73,22690
15000US061110015072,638,94,0,12,0,12,0,12,638,94,84,45,554,100,22691
15000US061110015073,552,98,132,67,65,47,67,49,420,100,21,24,399,102,22692
15000US061110016011,518,23,28,22,6,9,22,20,490,31,55,26,435,39,22693
15000US061110016021,626,45,51,34,21,20,30,28,575,48,207,40,368,52,22694
15000US061110016022,297,40,5,7,5,7,0,12,292,41,57,27,235,42,22695
15000US061110017001,957,85,7,11,7,11,0,12,950,84,244,71,706,107,22696
15000US061110017002,297,58,9,14,9,14,0,12,288,59,55,34,233,65,22697
15000US061110018001,252,56,6,10,0,12,6,10,246,57,81,55,165,54,22698
15000US061110018002,692,81,5,9,5,9,0,12,687,82,200,62,487,87,22699
15000US061110018003,286,49,9,15,0,12,9,15,277,49,61,28,216,54,22700
15000US061110018004,300,48,0,12,0,12,0,12,300,48,67,35,233,55,22701
15000US061110019001,282,62,40,39,34,37,6,11,242,55,45,31,197,58,22702
15000US061110019002,587,75,23,25,0,12,23,25,564,79,114,53,450,79,22703
15000US061110019003,180,60,0,12,0,12,0,12,180,60,48,28,132,62,22704
15000US061110019004,367,63,0,12,0,12,0,12,367,63,95,54,272,67,22705
15000US061110019005,258,68,0,12,0,12,0,12,258,68,79,39,179,78,22706
15000US061110020001,357,65,0,12,0,12,0,12,357,65,27,25,330,67,22707
15000US061110020002,356,56,9,13,9,13,0,12,347,58,46,28,301,61,22708
15000US061110020003,376,58,7,13,0,12,7,13,369,59,45,27,324,64,22709
15000US061110021021,991,78,66,45,66,45,0,12,925,93,135,61,790,99,22710
15000US061110022001,863,150,206,122,116,104,90,80,657,159,201,114,456,164,22711
15000US061110022002,366,138,73,65,0,12,73,65,293,125,106,94,187,86,22712
15000US061110022003,848,144,48,58,48,58,0,12,800,141,155,94,645,146,22713
15000US061110023001,850,174,45,64,45,64,0,12,805,172,289,115,516,180,22714
15000US061110023002,415,125,103,103,32,50,71,90,312,103,43,41,269,107,22715
15000US061110023003,447,119,24,27,13,23,11,17,423,119,168,117,255,122,22716
15000US061110023004,378,129,38,34,14,21,24,27,340,130,73,68,267,112,22717
15000US061110024001,567,103,55,48,30,24,25,40,512,110,254,87,258,83,22718
15000US061110024002,790,91,63,40,14,16,49,32,727,103,115,52,612,100,22719
15000US061110025001,605,158,16,26,0,12,16,26,589,157,10,18,579,155,22720
15000US061110025002,551,111,0,12,0,12,0,12,551,111,163,66,388,111,22721
15000US061110025003,232,80,0,12,0,12,0,12,232,80,41,39,191,78,22722
15000US061110025004,773,147,0,12,0,12,0,12,773,147,206,91,567,156,22723
15000US061110026001,368,83,50,52,10,16,40,49,318,75,42,29,276,72,22724
15000US061110026002,741,91,16,20,0,12,16,20,725,94,115,48,610,97,22725
15000US061110026003,255,66,15,17,15,17,0,12,240,69,13,18,227,69,22726
15000US061110027001,522,81,57,38,33,29,24,26,465,86,129,56,336,81,22727
15000US061110027002,1105,94,16,18,7,12,9,15,1089,94,480,112,609,106,22728
15000US061110028001,943,154,169,109,42,40,127,103,774,159,152,70,622,153,22729
15000US061110028002,381,83,0,12,0,12,0,12,381,83,70,46,311,88,22730
15000US061110028003,400,100,0,12,0,12,0,12,400,100,111,58,289,95,22731
15000US061110028004,602,109,52,66,52,66,0,12,550,108,22,27,528,106,22732
15000US061110028005,180,87,57,57,0,12,57,57,123,82,14,22,109,82,22733
15000US061110029011,1248,92,77,59,37,44,40,39,1171,99,288,92,883,106,22734
15000US061110029012,526,84,72,60,33,46,39,35,454,73,180,72,274,70,22735
15000US061110029051,786,98,62,59,10,16,52,57,724,98,211,71,513,85,22736
15000US061110029052,829,100,55,34,25,23,30,26,774,100,203,69,571,123,22737
15000US061110030101,982,50,94,45,31,25,63,37,888,70,210,54,678,83,22738
15000US061110030111,906,100,92,54,56,50,36,44,814,109,242,84,572,125,22739
15000US061110030112,674,105,197,88,33,32,164,85,477,97,174,72,303,92,22740
15000US061110030121,148,95,40,64,40,64,0,12,108,77,10,17,98,75,22741
15000US061110030131,481,94,8,13,8,13,0,12,473,93,87,50,386,89,22742
15000US061110030132,1117,94,94,66,20,22,74,62,1023,104,319,133,704,131,22743
15000US061110031001,1264,170,85,82,34,54,51,66,1179,177,465,146,714,167,22744
15000US061110031002,2187,191,133,92,52,56,81,75,2054,197,308,127,1746,214,22745
15000US061110032011,363,59,147,49,32,32,115,48,216,55,29,22,187,56,22746
15000US061110032012,395,58,97,46,36,34,61,37,298,57,70,28,228,65,22747
15000US061110033001,465,122,0,12,0,12,0,12,465,122,68,50,397,128,22748
15000US061110033002,547,117,13,21,0,12,13,21,534,116,83,57,451,124,22749
15000US061110033003,483,113,178,97,82,58,96,81,305,102,81,47,224,89,22750
15000US061110033004,336,111,9,19,0,12,9,19,327,113,71,46,256,112,22751
15000US061110033005,388,97,61,56,30,35,31,46,327,106,68,41,259,112,22752
15000US061110036051,1034,146,15,31,6,22,9,18,1019,149,264,98,755,167,22753
15000US061110036052,1236,180,101,96,71,89,30,35,1135,196,255,111,880,177,22754
15000US061110036053,560,125,73,52,48,45,25,28,487,129,218,97,269,107,22755
15000US061110036081,1007,41,58,34,13,14,45,32,949,50,271,53,678,70,22756
15000US061110036091,1473,181,49,73,49,73,0,12,1424,180,242,129,1182,205,22757
15000US061110036092,689,134,0,12,0,12,0,12,689,134,234,83,455,127,22758
15000US061110036093,847,155,40,65,40,65,0,12,807,147,129,70,678,143,22759
15000US061110036121,0,12,0,12,0,12,0,12,0,12,0,12,0,12,22760
15000US061110036122,982,202,0,12,0,12,0,12,982,202,236,114,746,190,22761
15000US061110036123,977,170,15,23,15,23,0,12,962,171,239,104,723,160,22762
15000US061110037001,564,85,99,48,38,36,61,37,465,94,180,73,285,73,22763
15000US061110037002,639,70,116,67,69,54,47,42,523,81,228,70,295,81,22764
15000US061110038011,328,100,122,87,48,70,74,49,206,78,69,44,137,75,22765
15000US061110038012,808,122,166,100,65,80,101,80,642,132,151,92,491,116,22766
15000US061110038021,556,31,167,51,14,16,153,52,389,56,78,32,311,61,22767
15000US061110039001,631,114,223,102,55,53,168,94,408,100,136,60,272,84,22768
15000US061110039002,829,110,174,73,71,64,103,64,655,109,210,78,445,99,22769
15000US061110040001,308,94,44,49,0,12,44,49,264,80,68,32,196,73,22770
15000US061110040002,403,87,70,44,17,19,53,39,333,86,26,21,307,87,22771
15000US061110040003,284,78,82,53,54,52,28,12,202,86,31,25,171,85,22772
15000US061110040004,414,99,18,22,0,12,18,22,396,100,148,78,248,85,22773
15000US061110041011,531,105,175,84,66,51,109,64,356,100,122,56,234,92,22774
15000US061110041012,393,85,41,37,20,21,21,31,352,82,71,45,281,84,22775
15000US061110041013,416,85,51,46,21,32,30,35,365,87,122,66,243,88,22776
15000US061110042001,467,80,20,16,14,16,6,10,447,79,86,56,361,81,22777
15000US061110042002,434,78,66,56,50,54,16,18,368,86,198,81,170,56,22778
15000US061110042003,320,59,52,36,23,28,29,27,268,67,116,57,152,60,22779
15000US061110043041,309,106,57,49,46,55,11,18,252,99,97,75,155,81,22780
15000US061110043042,843,152,56,65,47,58,9,18,787,161,269,94,518,151,22781
15000US061110043043,777,141,27,32,0,12,27,32,750,146,157,90,593,134,22782
15000US061110043044,504,133,179,110,54,54,125,100,325,97,75,66,250,96,22783
15000US061110043051,400,69,13,16,0,12,13,16,387,71,36,23,351,68,22784
15000US061110044001,608,135,38,40,14,23,24,34,570,138,194,96,376,136,22785
15000US061110044002,521,136,69,52,0,12,69,52,452,146,99,78,353,135,22786
15000US061110044003,341,135,14,22,0,12,14,22,327,136,78,46,249,127,22787
15000US061110044004,1202,209,115,74,39,66,76,63,1087,214,216,100,871,213,22788
15000US061110045031,278,84,38,44,3,6,35,44,240,81,44,41,196,78,22789
15000US061110045032,704,103,92,52,67,49,25,29,612,110,115,56,497,119,22790
15000US061110045041,668,89,153,68,82,57,71,48,515,96,125,59,390,87,22791
15000US061110045042,488,85,45,53,14,20,31,43,443,98,110,42,333,104,22792
15000US061110045051,447,40,36,23,21,20,15,16,411,42,124,48,287,49,22793
15000US061110045061,730,94,221,88,66,61,155,71,509,95,20,19,489,97,22794
15000US061110045062,371,76,159,60,82,48,77,51,212,81,14,22,198,79,22795
15000US061110045063,355,70,128,62,29,34,99,54,227,70,52,39,175,66,22796
15000US061110046001,520,57,17,21,5,9,12,18,503,58,40,25,463,60,22797
15000US061110047041,111,33,4,7,4,7,0,12,107,32,15,20,92,36,22798
15000US061110047042,310,41,47,36,17,16,30,29,263,51,85,25,178,52,22799
15000US061110047101,576,121,106,69,55,53,51,43,470,119,117,61,353,116,22800
15000US061110047102,504,118,108,72,9,14,99,71,396,120,136,60,260,107,22801
15000US061110047103,177,57,0,12,0,12,0,12,177,57,44,42,133,47,22802
15000US061110047111,360,48,82,35,43,33,39,29,278,48,84,43,194,53,22803
15000US061110047112,422,51,20,18,9,12,11,15,402,50,139,45,263,53,22804
15000US061110047151,623,80,120,68,26,34,94,57,503,86,269,78,234,87,22805
15000US061110047152,609,80,112,49,45,31,67,40,497,89,164,69,333,84,22806
15000US061110047161,377,57,27,26,3,5,24,25,350,58,98,34,252,58,22807
15000US061110047162,525,55,72,40,39,27,33,29,453,64,133,47,320,63,22808
15000US061110047171,383,52,34,23,21,17,13,16,349,56,85,41,264,65,22809
15000US061110047172,336,49,53,38,27,28,26,29,283,58,121,53,162,47,22810
15000US061110049011,1773,55,112,56,43,35,69,51,1661,70,271,85,1390,105,22811
15000US061110049021,652,127,115,52,16,19,99,50,537,123,192,73,345,108,22812
15000US061110049022,460,108,101,76,0,12,101,76,359,94,163,66,196,82,22813
15000US061110050021,712,35,171,58,66,39,105,49,541,58,157,53,384,68,22814
15000US061110050031,690,115,86,57,14,17,72,54,604,121,218,84,386,115,22815
15000US061110050032,1191,124,171,81,116,68,55,41,1020,130,357,102,663,119,22816
15000US061110050041,2325,120,295,133,19,22,276,130,2030,170,294,125,1736,158,22817
15000US061110051001,242,51,0,12,0,12,0,12,242,51,73,45,169,45,22818
15000US061110051002,216,46,19,28,0,12,19,28,197,50,79,40,118,43,22819
15000US061110051003,618,69,5,8,0,12,5,8,613,70,139,53,474,69,22820
15000US061110052021,301,63,24,27,10,17,14,21,277,64,79,45,198,52,22821
15000US061110052022,819,64,45,39,39,38,6,10,774,73,139,48,635,81,22822
15000US061110052031,916,104,0,12,0,12,0,12,916,104,234,80,682,120,22823
15000US061110052032,673,86,28,39,4,8,24,38,645,83,127,42,518,91,22824
15000US061110052033,271,55,11,18,11,18,0,12,260,56,60,49,200,48,22825
15000US061110052041,720,62,0,12,0,12,0,12,720,62,195,70,525,75,22826
15000US061110052042,535,64,9,13,9,13,0,12,526,66,194,61,332,73,22827
15000US061110052051,879,112,12,19,12,19,0,12,867,114,205,64,662,124,22828
15000US061110052052,1375,106,83,83,20,34,63,78,1292,122,272,95,1020,146,22829
15000US061110053031,2160,141,0,17,0,17,0,17,2160,141,405,117,1755,164,22830
15000US061110053032,1099,136,30,32,30,32,0,12,1069,137,290,137,779,131,22831
15000US061110053041,1370,160,14,22,0,12,14,22,1356,165,759,161,597,157,22832
15000US061110053042,684,131,49,53,49,53,0,12,635,134,255,120,380,126,22833
15000US061110053043,660,137,18,28,18,28,0,12,642,137,163,73,479,137,22834
15000US061110053051,935,96,0,12,0,12,0,12,935,96,158,65,777,98,22835
15000US061110053052,876,84,0,12,0,12,0,12,876,84,139,58,737,97,22836
15000US061110053061,673,63,0,12,0,12,0,12,673,63,156,52,517,73,22837
15000US061110053062,967,68,31,35,0,12,31,35,936,72,150,55,786,88,22838
15000US061110054011,585,66,27,28,17,25,10,15,558,63,126,41,432,70,22839
15000US061110054012,725,71,29,38,0,12,29,38,696,78,107,44,589,78,22840
15000US061110054031,954,44,132,51,73,43,59,32,822,68,209,56,613,82,22841
15000US061110054041,628,86,5,12,0,12,5,12,623,84,190,66,433,86,22842
15000US061110054042,528,92,14,24,0,12,14,24,514,86,158,64,356,81,22843
15000US061110055021,534,106,48,59,0,12,48,59,486,107,144,79,342,104,22844
15000US061110055022,619,128,14,27,0,12,14,27,605,128,53,64,552,125,22845
15000US061110055023,918,148,92,88,65,76,27,42,826,153,61,49,765,149,22846
15000US061110055031,770,81,24,22,9,14,15,16,746,85,225,70,521,82,22847
15000US061110055032,548,79,2,6,2,6,0,12,546,78,200,74,346,64,22848
15000US061110055041,714,84,13,20,13,20,0,12,701,88,187,59,514,91,22849
15000US061110055042,838,85,10,15,0,12,10,15,828,86,288,77,540,95,22850
15000US061110056001,1105,177,76,78,16,25,60,74,1029,182,124,67,905,181,22851
15000US061110056002,997,156,27,33,13,20,14,24,970,154,279,104,691,156,22852
15000US061110056003,1725,138,44,35,18,24,26,31,1681,140,325,121,1356,151,22853
15000US061110057001,580,40,0,12,0,12,0,12,580,40,68,28,512,48,22854
15000US061110058011,251,53,8,14,8,14,0,12,243,54,56,30,187,53,22855
15000US061110058012,729,77,12,19,12,19,0,12,717,78,54,34,663,86,22856
15000US061110058013,724,73,5,9,5,9,0,12,719,74,99,50,620,68,22857
15000US061110058021,932,105,0,12,0,12,0,12,932,105,127,82,805,123,22858
15000US061110058022,1561,138,18,28,0,17,18,28,1543,139,198,105,1345,141,22859
15000US061110058023,520,120,15,24,15,24,0,12,505,121,145,94,360,134,22860
15000US061110059011,455,128,0,12,0,12,0,12,455,128,99,58,356,143,22861
15000US061110059012,614,150,0,12,0,12,0,12,614,150,145,74,469,138,22862
15000US061110059013,423,87,0,12,0,12,0,12,423,87,27,33,396,96,22863
15000US061110059014,215,85,0,12,0,12,0,12,215,85,74,44,141,85,22864
15000US061110059015,597,128,0,12,0,12,0,12,597,128,9,15,588,130,22865
15000US061110059061,540,89,0,12,0,12,0,12,540,89,141,73,399,87,22866
15000US061110059062,1228,147,0,12,0,12,0,12,1228,147,184,78,1044,154,22867
15000US061110059063,475,111,0,12,0,12,0,12,475,111,54,39,421,113,22868
15000US061110059064,216,66,0,12,0,12,0,12,216,66,33,28,183,66,22869
15000US061110059071,806,109,0,12,0,12,0,12,806,109,170,79,636,112,22870
15000US061110059072,422,74,10,15,10,15,0,12,412,77,62,31,350,88,22871
15000US061110059073,547,75,17,20,8,14,9,14,530,76,132,59,398,83,22872
15000US061110059081,439,55,22,22,13,20,9,11,417,53,95,38,322,60,22873
15000US061110059082,495,57,5,8,0,12,5,8,490,58,86,40,404,64,22874
15000US061110059091,968,88,178,92,60,53,118,80,790,122,147,61,643,122,22875
15000US061110059092,514,74,30,47,30,47,0,12,484,71,126,61,358,76,22876
15000US061110059101,609,29,5,7,0,12,5,7,604,29,80,37,524,43,22877
15000US061110059111,786,108,18,21,0,12,18,21,768,107,68,44,700,114,22878
15000US061110059112,205,51,0,12,0,12,0,12,205,51,32,22,173,52,22879
15000US061110059113,506,72,6,9,0,12,6,9,500,71,75,35,425,79,22880
15000US061110060001,426,80,12,19,0,12,12,19,414,80,80,52,334,74,22881
15000US061110060002,595,92,8,13,0,12,8,13,587,91,145,70,442,92,22882
15000US061110060003,511,88,8,14,0,12,8,14,503,90,121,54,382,94,22883
15000US061110061001,1243,154,0,12,0,12,0,12,1243,154,278,116,965,132,22884
15000US061110061002,148,76,0,12,0,12,0,12,148,76,13,20,135,80,22885
15000US061110061003,292,119,79,62,0,12,79,62,213,126,116,85,97,94,22886
15000US061110061004,1127,164,88,106,0,12,88,106,1039,187,108,110,931,189,22887
15000US061110062001,813,74,27,26,16,18,11,17,786,77,190,69,596,96,22888
15000US061110062002,229,60,0,12,0,12,0,12,229,60,50,28,179,68,22889
15000US061110063011,1168,135,0,12,0,12,0,12,1168,135,441,129,727,149,22890
15000US061110063012,951,96,18,27,18,27,0,12,933,97,158,82,775,125,22891
15000US061110063013,487,97,0,12,0,12,0,12,487,97,105,52,382,90,22892
15000US061110063021,368,40,18,28,0,12,18,28,350,43,64,34,286,43,22893
15000US061110063022,452,38,0,12,0,12,0,12,452,38,77,32,375,45,22894
15000US061110064001,731,109,0,12,0,12,0,12,731,109,190,94,541,113,22895
15000US061110064002,639,102,0,12,0,12,0,12,639,102,125,75,514,105,22896
15000US061110064003,384,85,0,12,0,12,0,12,384,85,159,91,225,72,22897
15000US061110064004,219,92,26,40,26,40,0,12,193,83,32,30,161,81,22898
15000US061110064005,519,128,16,25,0,12,16,25,503,130,71,60,432,157,22899
15000US061110065001,361,55,8,12,8,12,0,12,353,57,68,38,285,54,22900
15000US061110065002,658,80,78,65,22,25,56,61,580,72,142,59,438,87,22901
15000US061110066001,532,66,17,19,10,16,7,11,515,64,135,47,380,73,22902
15000US061110066002,619,75,15,17,9,14,6,10,604,79,206,73,398,96,22903
15000US061110066003,213,39,0,12,0,12,0,12,213,39,15,17,198,43,22904
15000US061110067001,201,43,0,12,0,12,0,12,201,43,20,18,181,48,22905
15000US061110067002,949,57,5,9,5,9,0,12,944,59,204,83,740,96,22906
15000US061110068001,426,74,10,16,10,16,0,12,416,74,142,65,274,68,22907
15000US061110068002,441,80,31,37,10,14,21,34,410,72,91,41,319,69,22908
15000US061110068003,330,77,0,12,0,12,0,12,330,77,50,32,280,81,22909
15000US061110069001,700,114,52,47,0,12,52,47,648,111,191,74,457,99,22910
15000US061110069002,1055,107,59,59,33,50,26,33,996,119,219,70,777,114,22911
15000US061110070001,930,112,76,55,26,30,50,46,854,116,241,84,613,106,22912
15000US061110070002,663,99,107,54,45,41,62,48,556,98,221,78,335,74,22913
15000US061110071001,659,166,90,107,0,12,90,107,569,156,252,109,317,145,22914
15000US061110071002,1133,179,116,90,0,12,116,90,1017,189,267,123,750,162,22915
15000US061110071003,890,164,27,33,17,28,10,16,863,167,261,126,602,152,22916
15000US061110072011,343,48,0,12,0,12,0,12,343,48,62,33,281,52,22917
15000US061110072012,551,63,0,12,0,12,0,12,551,63,222,65,329,68,22918
15000US061110072013,307,48,0,12,0,12,0,12,307,48,34,28,273,48,22919
15000US061110072021,928,84,20,22,10,17,10,15,908,86,200,70,708,94,22920
15000US061110072022,659,75,0,12,0,12,0,12,659,75,131,60,528,85,22921
15000US061110073001,774,62,0,12,0,12,0,12,774,62,75,32,699,67,22922
15000US061110074021,865,117,12,19,12,19,0,12,853,119,159,87,694,116,22923
15000US061110074022,898,117,0,12,0,12,0,12,898,117,122,83,776,139,22924
15000US061110074023,820,114,0,12,0,12,0,12,820,114,116,60,704,125,22925
15000US061110074031,441,95,0,12,0,12,0,12,441,95,46,41,395,95,22926
15000US061110074032,867,131,16,26,0,12,16,26,851,132,136,87,715,135,22927
15000US061110074033,875,118,0,12,0,12,0,12,875,118,183,92,692,130,22928
15000US061110074051,1567,169,84,87,0,12,84,87,1483,156,189,104,1294,176,22929
15000US061110074052,447,112,15,23,15,23,0,12,432,112,135,94,297,92,22930
15000US061110074053,439,119,0,12,0,12,0,12,439,119,13,19,426,122,22931
15000US061110074061,854,36,17,16,11,13,6,10,837,44,74,32,763,45,22932
15000US061110075051,487,82,17,21,17,21,0,12,470,85,153,89,317,82,22933
15000US061110075052,649,85,20,33,2,5,18,34,629,78,260,71,369,79,22934
15000US061110075061,445,79,18,35,18,35,0,12,427,80,33,35,394,77,22935
15000US061110075062,550,126,0,12,0,12,0,12,550,126,113,101,437,114,22936
15000US061110075063,320,85,17,28,0,12,17,28,303,89,45,45,258,98,22937
15000US061110075064,782,110,0,12,0,12,0,12,782,110,93,53,689,118,22938
15000US061110075065,388,100,0,12,0,12,0,12,388,100,50,50,338,88,22939
15000US061110075071,773,123,0,12,0,12,0,12,773,123,117,91,656,108,22940
15000US061110075072,306,73,18,30,0,12,18,30,288,68,28,22,260,70,22941
15000US061110075073,1274,115,0,12,0,12,0,12,1274,115,221,86,1053,126,22942
15000US061110075081,401,61,0,12,0,12,0,12,401,61,154,61,247,61,22943
15000US061110075082,1037,72,94,59,17,19,77,57,943,91,168,79,775,117,22944
15000US061110075091,602,78,0,12,0,12,0,12,602,78,74,36,528,83,22945
15000US061110075092,914,89,22,26,22,26,0,12,892,90,186,75,706,104,22946
15000US061110075101,720,87,0,12,0,12,0,12,720,87,75,55,645,99,22947
15000US061110075102,672,109,0,12,0,12,0,12,672,109,104,72,568,123,22948
15000US061110075103,638,83,0,12,0,12,0,12,638,83,122,67,516,98,22949
15000US061110075111,601,41,0,12,0,12,0,12,601,41,134,49,467,56,22950
15000US061110075112,228,38,13,15,13,15,0,12,215,42,42,22,173,41,22951
15000US061110075121,1070,91,87,55,41,42,46,34,983,107,196,70,787,110,22952
15000US061110075122,688,85,0,12,0,12,0,12,688,85,132,71,556,93,22953
15000US061110075131,514,40,5,8,0,12,5,8,509,41,129,40,380,47,22954
15000US061110075141,731,135,13,21,13,21,0,12,718,132,250,117,468,149,22955
15000US061110075142,868,157,0,12,0,12,0,12,868,157,164,104,704,161,22956
15000US061110075143,1295,166,37,43,0,12,37,43,1258,167,365,129,893,158,22957
15000US061110076061,431,29,0,12,0,12,0,12,431,29,99,36,332,38,22958
15000US061110076071,978,117,0,12,0,12,0,12,978,117,117,68,861,133,22959
15000US061110076072,1006,134,0,12,0,12,0,12,1006,134,130,95,876,159,22960
15000US061110076091,821,33,23,18,11,12,12,14,798,36,133,44,665,52,22961
15000US061110076101,838,81,11,19,11,19,0,12,827,81,210,77,617,97,22962
15000US061110076102,926,76,19,20,0,12,19,20,907,78,158,56,749,86,22963
15000US061110076111,728,64,91,56,26,21,65,53,637,77,98,49,539,77,22964
15000US061110076112,182,56,18,19,10,13,8,13,164,59,43,39,121,48,22965
15000US061110076121,1078,97,170,87,88,67,82,61,908,110,227,88,681,126,22966
15000US061110076122,615,88,36,39,8,13,28,36,579,96,69,48,510,100,22967
15000US061110076131,688,101,17,19,0,12,17,19,671,103,104,57,567,105,22968
15000US061110076132,526,81,0,12,0,12,0,12,526,81,65,34,461,80,22969
15000US061110076141,485,108,38,62,0,12,38,62,447,105,132,72,315,108,22970
15000US061110076142,697,117,0,12,0,12,0,12,697,117,54,51,643,121,22971
15000US061110076143,454,95,0,12,0,12,0,12,454,95,30,34,424,95,22972
15000US061110076144,786,110,25,28,15,24,10,16,761,111,221,109,540,111,22973
15000US061110077001,861,109,9,15,0,12,9,15,852,109,228,86,624,109,22974
15000US061110077002,667,122,101,64,36,34,65,54,566,121,93,61,473,111,22975
15000US061110077003,490,99,0,12,0,12,0,12,490,99,127,66,363,83,22976
15000US061110078001,997,133,191,96,64,45,127,78,806,109,153,64,653,119,22977
15000US061110078002,421,88,65,47,18,27,47,38,356,88,73,39,283,88,22978
15000US061110079011,926,89,49,40,17,29,32,31,877,94,158,70,719,92,22979
15000US061110079012,295,58,17,19,7,11,10,15,278,62,127,56,151,58,22980
15000US061110079013,508,83,29,31,29,31,0,12,479,85,73,52,406,77,22981
15000US061110079031,1546,41,22,19,7,13,15,16,1524,47,284,70,1240,76,22982
15000US061110079041,505,89,7,11,0,12,7,11,498,91,90,39,408,92,22983
15000US061110079042,330,64,0,12,0,12,0,12,330,64,84,44,246,70,22984
15000US061110079043,467,82,16,17,0,12,16,17,451,84,177,79,274,82,22985
15000US061110079044,232,61,29,45,0,12,29,45,203,67,107,57,96,49,22986
15000US061110079045,218,78,28,42,0,12,28,42,190,73,55,35,135,67,22987
15000US061110080011,390,62,16,15,12,13,4,7,374,66,134,54,240,55,22988
15000US061110080012,580,62,71,46,32,28,39,38,509,61,154,59,355,65,22989
15000US061110080021,498,105,19,29,0,12,19,29,479,106,118,79,361,84,22990
15000US061110080022,806,99,53,47,0,12,53,47,753,101,182,74,571,103,22991
15000US061110080023,272,79,11,17,11,17,0,12,261,82,53,56,208,85,22992
15000US061110080041,532,80,8,12,8,12,0,12,524,80,128,64,396,87,22993
15000US061110080042,386,81,27,25,27,25,0,12,359,83,61,41,298,87,22994
15000US061110080043,240,72,29,22,9,15,20,19,211,74,43,28,168,75,22995
15000US061110080044,271,61,6,10,6,10,0,12,265,63,118,50,147,63,22996
15000US061110080051,488,44,27,20,0,12,27,20,461,50,101,40,360,59,22997
15000US061110080052,249,45,14,16,0,12,14,16,235,45,51,23,184,44,22998
15000US061110081011,635,61,31,22,4,10,27,25,604,63,115,56,489,67,22999
15000US061110081012,468,64,0,12,0,12,0,12,468,64,142,45,326,73,23000
15000US061110082011,612,76,76,54,47,50,29,23,536,86,98,46,438,92,23001
15000US061110082012,843,78,39,33,17,19,22,28,804,83,95,46,709,94,23002
15000US061110082021,485,78,0,12,0,12,0,12,485,78,76,36,409,82,23003
15000US061110082022,382,66,7,11,0,12,7,11,375,67,88,50,287,72,23004
15000US061110082023,621,85,47,37,19,28,28,34,574,80,251,81,323,77,23005
15000US061110083021,718,105,42,43,0,12,42,43,676,104,108,56,568,111,23006
15000US061110083022,1315,111,65,47,43,44,22,19,1250,106,371,104,879,132,23007
15000US061110083031,235,67,4,10,0,12,4,10,231,66,80,52,151,55,23008
15000US061110083032,1101,87,58,40,34,32,24,23,1043,79,311,82,732,97,23009
15000US061110083041,757,136,26,21,26,21,0,12,731,134,177,94,554,150,23010
15000US061110083042,868,116,11,19,0,12,11,19,857,122,237,118,620,139,23011
15000US061110083043,486,96,6,10,0,12,6,10,480,96,39,40,441,98,23012
15000US061110083051,1210,58,0,12,0,12,0,12,1210,58,117,56,1093,78,23013
15000US061110083061,192,70,0,12,0,12,0,12,192,70,50,33,142,68,23014
15000US061110083062,586,86,0,12,0,12,0,12,586,86,57,47,529,84,23015
15000US061110083063,786,110,0,12,0,12,0,12,786,110,192,75,594,112,23016
15000US061110084011,858,87,15,18,7,13,8,13,843,87,287,91,556,95,23017
15000US061110084012,427,67,21,24,21,24,0,12,406,62,52,34,354,69,23018
15000US061110084013,576,89,91,74,51,50,40,55,485,87,76,39,409,95,23019
15000US061110084021,633,64,9,14,9,14,0,12,624,64,186,74,438,76,23020
15000US061110084022,493,72,0,12,0,12,0,12,493,72,116,46,377,80,23021
15000US061110084023,226,49,14,15,14,15,0,12,212,52,41,27,171,54,23022
15000US061110084024,282,51,10,16,10,16,0,12,272,52,54,40,218,64,23023
15000US061110085001,923,140,13,20,0,12,13,20,910,144,135,88,775,165,23024
15000US061110085002,847,130,20,29,0,12,20,29,827,135,209,83,618,147,23025
15000US061110085003,1301,170,25,32,17,27,8,14,1276,176,279,129,997,175,23026
15000US061110086001,872,140,245,111,13,22,232,110,627,143,138,77,489,142,23027
15000US061110086002,705,127,226,109,88,78,138,86,479,109,174,76,305,111,23028
15000US061110086003,199,62,10,15,10,15,0,12,189,61,31,40,158,52,23029
15000US061110086004,369,108,18,30,0,12,18,30,351,106,171,97,180,83,23030
15000US061110087001,439,71,33,34,26,31,7,13,406,66,101,51,305,64,23031
15000US061110087002,968,104,120,55,62,41,58,37,848,110,287,76,561,113,23032
15000US061110087003,469,97,94,54,48,43,46,45,375,96,181,78,194,80,23033
15000US061110088001,912,90,127,71,61,54,66,45,785,102,144,57,641,106,23034
15000US061110088002,482,78,85,72,59,54,26,33,397,88,101,55,296,91,23035
15000US061110089001,224,51,20,22,20,22,0,12,204,50,56,26,148,48,23036
15000US061110089002,460,58,98,51,21,19,77,48,362,66,195,64,167,59,23037
15000US061110091001,305,67,70,47,11,17,59,41,235,72,114,61,121,55,23038
15000US061110091002,312,74,100,63,74,55,26,31,212,70,107,54,105,51,23039
15000US061110091003,123,57,16,25,0,12,16,25,107,53,47,48,60,44,23040
15000US061110091004,355,82,147,74,87,57,60,53,208,71,91,54,117,47,23041
15000US061119800001,0,12,0,12,0,12,0,12,0,12,0,12,0,12,23042
15000US061119901000,0,12,0,12,0,12,0,12,0,12,0,12,0,12,23043
15000US061130101011,460,125,33,36,16,25,17,26,427,124,75,60,352,109,23044
15000US061130101012,510,120,90,88,24,37,66,80,420,117,175,88,245,119,23045
15000US061130101013,1048,154,144,102,64,54,80,89,904,175,200,81,704,165,23046
15000US061130101014,448,142,168,83,59,64,109,84,280,116,95,84,185,99,23047
15000US061130101021,677,145,121,77,30,36,91,70,556,135,259,120,297,116,23048
15000US061130101022,461,117,118,66,40,42,78,55,343,117,166,83,177,92,23049
15000US061130101023,209,67,14,22,14,22,0,12,195,68,22,24,173,68,23050
15000US061130101024,1061,144,280,142,203,140,77,45,781,176,259,116,522,160,23051
15000US061130102011,911,88,156,64,21,32,135,64,755,107,131,60,624,108,23052
15000US061130102012,416,79,69,69,0,12,69,69,347,73,117,62,230,75,23053
15000US061130102031,569,160,23,33,0,12,23,33,546,157,84,94,462,136,23054
15000US061130102032,718,181,209,113,136,102,73,54,509,169,226,144,283,127,23055
15000US061130102033,522,157,184,119,89,79,95,97,338,121,152,90,186,103,23056
15000US061130102034,197,74,12,20,12,20,0,12,185,70,44,43,141,67,23057
15000US061130102041,1121,196,225,130,97,78,128,96,896,199,307,129,589,222,23058
15000US061130102042,397,112,121,120,0,12,121,120,276,97,117,75,159,90,23059
15000US061130102043,427,114,13,30,13,30,0,12,414,112,230,86,184,70,23060
15000US061130103021,613,114,31,34,19,29,12,19,582,125,148,102,434,150,23061
15000US061130103022,680,128,0,12,0,12,0,12,680,128,103,58,577,128,23062
15000US061130103023,1519,169,49,37,12,20,37,33,1470,174,244,105,1226,190,23063
15000US061130103101,1100,107,56,42,11,15,45,40,1044,111,204,90,840,119,23064
15000US061130103102,431,64,0,12,0,12,0,12,431,64,98,64,333,70,23065
15000US061130103103,224,48,0,12,0,12,0,12,224,48,51,35,173,48,23066
15000US061130103121,1080,85,68,41,35,37,33,30,1012,98,107,55,905,108,23067
15000US061130103122,586,84,23,25,0,12,23,25,563,89,195,70,368,85,23068
15000US061130103123,225,57,0,12,0,12,0,12,225,57,66,34,159,55,23069
15000US061130104011,334,65,0,12,0,12,0,12,334,65,51,32,283,64,23070
15000US061130104012,1036,101,48,45,7,12,41,43,988,103,122,59,866,104,23071
15000US061130104013,436,88,19,23,0,12,19,23,417,88,86,43,331,85,23072
15000US061130104021,639,75,11,17,0,12,11,17,628,74,142,55,486,75,23073
15000US061130104022,660,75,16,22,0,12,16,22,644,79,110,57,534,86,23074
15000US061130105011,1033,136,41,51,10,14,31,49,992,147,41,34,951,149,23075
15000US061130105012,241,60,48,32,14,21,34,35,193,60,8,14,185,59,23076
15000US061130105051,296,52,0,12,0,12,0,12,296,52,52,35,244,60,23077
15000US061130105052,66,28,0,12,0,12,0,12,66,28,26,23,40,37,23078
15000US061130105053,1417,79,46,46,0,12,46,46,1371,84,141,68,1230,102,23079
15000US061130105081,1032,47,0,12,0,12,0,12,1032,47,162,56,870,68,23080
15000US061130105091,551,70,19,20,19,20,0,12,532,69,66,54,466,74,23081
15000US061130105092,756,70,47,34,38,35,9,14,709,70,73,33,636,79,23082
15000US061130105101,226,55,17,27,0,12,17,27,209,59,33,29,176,59,23083
15000US061130105102,960,110,21,30,21,30,0,12,939,108,252,86,687,109,23084
15000US061130105103,463,113,0,12,0,12,0,12,463,113,43,45,420,120,23085
15000US061130105104,392,61,0,12,0,12,0,12,392,61,44,42,348,60,23086
15000US061130105111,445,73,0,12,0,12,0,12,445,73,38,27,407,77,23087
15000US061130105112,897,85,18,20,0,12,18,20,879,85,212,69,667,95,23088
15000US061130105121,590,75,34,33,0,12,34,33,556,84,80,49,476,80,23089
15000US061130105122,587,83,7,11,0,12,7,11,580,84,82,42,498,89,23090
15000US061130105131,536,72,9,14,0,12,9,14,527,73,35,26,492,75,23091
15000US061130105132,589,77,72,50,0,12,72,50,517,84,17,19,500,87,23092
15000US061130106021,1152,190,72,53,14,21,58,48,1080,178,111,69,969,184,23093
15000US061130106022,496,117,0,12,0,12,0,12,496,117,135,101,361,88,23094
15000US061130106023,359,116,11,20,0,12,11,20,348,117,40,45,308,111,23095
15000US061130106024,581,160,104,110,12,21,92,109,477,128,64,79,413,116,23096
15000US061130106051,802,71,65,63,0,12,65,63,737,75,75,34,662,75,23097
15000US061130106052,358,66,9,15,9,15,0,12,349,64,38,23,311,66,23098
15000US061130106061,532,92,22,26,13,20,9,16,510,98,32,38,478,102,23099
15000US061130106062,640,110,0,12,0,12,0,12,640,110,127,85,513,113,23100
15000US061130106063,317,62,20,32,20,32,0,12,297,58,90,58,207,67,23101
15000US061130106064,1112,136,103,78,35,33,68,76,1009,123,202,80,807,128,23102
15000US061130106065,249,73,0,12,0,12,0,12,249,73,37,40,212,71,23103
15000US061130106071,582,82,17,22,6,10,11,18,565,83,73,45,492,80,23104
15000US061130106072,245,53,0,12,0,12,0,12,245,53,56,34,189,48,23105
15000US061130106073,790,70,17,26,0,12,17,26,773,65,163,67,610,83,23106
15000US061130106081,480,70,12,16,12,16,0,12,468,71,37,26,431,71,23107
15000US061130106082,1025,119,97,68,0,12,97,68,928,118,106,42,822,116,23108
15000US061130106083,275,53,8,14,0,12,8,14,267,54,33,26,234,54,23109
15000US061130107011,404,75,0,12,0,12,0,12,404,75,37,36,367,79,23110
15000US061130107012,940,166,18,31,0,12,18,31,922,167,24,26,898,162,23111
15000US061130107013,367,112,0,12,0,12,0,12,367,112,44,38,323,111,23112
15000US061130107014,341,93,0,12,0,12,0,12,341,93,38,34,303,94,23113
15000US061130107031,221,63,8,13,0,12,8,13,213,66,17,20,196,66,23114
15000US061130107032,677,99,0,12,0,12,0,12,677,99,93,46,584,106,23115
15000US061130107033,359,84,39,50,0,12,39,50,320,74,41,31,279,78,23116
15000US061130107034,431,74,0,12,0,12,0,12,431,74,66,40,365,80,23117
15000US061130107041,876,58,47,24,4,7,43,25,829,53,136,38,693,62,23118
15000US061130108001,632,108,112,72,52,42,60,58,520,103,166,77,354,99,23119
15000US061130108002,359,76,82,53,14,15,68,53,277,70,69,34,208,70,23120
15000US061130108003,339,84,31,34,31,34,0,12,308,90,107,67,201,75,23121
15000US061130109011,666,93,42,33,16,19,26,24,624,96,108,51,516,95,23122
15000US061130109012,347,73,58,34,40,26,18,19,289,76,125,56,164,72,23123
15000US061130109013,761,96,94,68,52,55,42,42,667,105,229,75,438,100,23124
15000US061130109021,841,123,135,72,40,35,95,65,706,132,142,87,564,147,23125
15000US061130109022,890,125,170,92,59,54,111,80,720,128,252,105,468,121,23126
15000US061130109023,599,122,34,40,0,12,34,40,565,130,141,77,424,130,23127
15000US061130110011,854,176,71,64,30,36,41,56,783,168,202,91,581,172,23128
15000US061130110012,913,157,179,90,42,43,137,79,734,159,163,101,571,152,23129
15000US061130110013,703,152,264,115,48,41,216,113,439,123,73,48,366,120,23130
15000US061130110021,551,75,10,15,10,15,0,12,541,77,215,69,326,82,23131
15000US061130110022,481,73,20,22,20,22,0,12,461,74,132,54,329,76,23132
15000US061130110023,432,66,17,21,0,12,17,21,415,67,105,50,310,69,23133
15000US061130111011,562,80,58,42,30,26,28,33,504,79,155,63,349,85,23134
15000US061130111012,553,80,62,61,11,17,51,60,491,78,123,51,368,77,23135
15000US061130111021,855,109,217,87,61,37,156,83,638,115,151,72,487,106,23136
15000US061130111022,653,105,137,75,24,27,113,71,516,105,115,49,401,105,23137
15000US061130111031,543,77,57,42,16,19,41,37,486,75,137,50,349,75,23138
15000US061130111032,380,71,27,23,9,15,18,19,353,75,85,37,268,67,23139
15000US061130112031,589,68,19,30,0,12,19,30,570,71,71,40,499,76,23140
15000US061130112032,461,66,11,17,0,12,11,17,450,68,142,58,308,74,23141
15000US061130112041,754,79,47,32,41,30,6,11,707,85,204,76,503,101,23142
15000US061130112042,675,87,81,56,61,56,20,30,594,85,144,54,450,97,23143
15000US061130112043,440,72,18,22,0,12,18,22,422,74,128,55,294,79,23144
15000US061130112051,841,136,71,55,36,41,35,39,770,136,156,93,614,134,23145
15000US061130112052,402,105,0,12,0,12,0,12,402,105,94,64,308,100,23146
15000US061130112053,389,121,18,29,0,12,18,29,371,128,59,69,312,123,23147
15000US061130112054,454,122,48,56,0,12,48,56,406,123,35,33,371,126,23148
15000US061130112055,426,87,9,15,9,15,0,12,417,90,35,41,382,94,23149
15000US061130112061,309,91,35,43,35,43,0,12,274,95,54,57,220,86,23150
15000US061130112062,873,159,40,46,40,46,0,12,833,157,269,114,564,159,23151
15000US061130112063,1288,152,22,36,0,12,22,36,1266,156,195,104,1071,150,23152
15000US061130113001,571,169,6,12,0,12,6,12,565,168,81,60,484,167,23153
15000US061130113002,310,121,45,42,17,26,28,33,265,121,102,102,163,71,23154
15000US061130113003,1018,163,125,82,33,39,92,74,893,162,221,95,672,159,23155
15000US061130113004,791,148,0,12,0,12,0,12,791,148,145,115,646,164,23156
15000US061130113005,267,108,7,12,7,12,0,12,260,107,52,42,208,103,23157
15000US061130114001,333,78,49,39,9,13,40,37,284,77,110,49,174,68,23158
15000US061130114002,690,101,121,62,66,53,55,36,569,103,208,74,361,97,23159
15000US061130114003,466,89,15,20,0,12,15,20,451,87,136,60,315,89,23160
15000US061130115001,231,69,0,12,0,12,0,12,231,69,108,51,123,54,23161
15000US061130115002,396,118,17,28,0,12,17,28,379,120,100,64,279,108,23162
15000US061130115003,765,103,121,60,35,29,86,52,644,118,145,60,499,119,23163
15000US061130115004,250,86,5,9,0,12,5,9,245,86,113,57,132,66,23164
15000US061130115005,238,70,33,31,10,15,23,26,205,67,68,47,137,64,23165
15000US061150401001,306,56,44,37,29,27,15,23,262,58,107,52,155,62,23166
15000US061150401002,331,82,37,35,0,12,37,35,294,80,25,19,269,78,23167
15000US061150401003,454,101,96,56,38,43,58,39,358,94,151,76,207,82,23168
15000US061150401004,374,102,99,69,70,62,29,32,275,89,115,66,160,80,23169
15000US061150401005,313,79,81,57,32,40,49,42,232,85,87,54,145,70,23170
15000US061150402001,264,80,7,12,0,12,7,12,257,79,59,48,198,84,23171
15000US061150402002,724,169,188,114,64,52,124,103,536,194,162,93,374,182,23172
15000US061150402003,394,126,7,12,0,12,7,12,387,126,222,118,165,79,23173
15000US061150402004,337,126,22,28,9,16,13,22,315,127,36,28,279,127,23174
15000US061150402005,414,133,41,40,25,29,16,27,373,141,101,61,272,133,23175
15000US061150402006,392,128,160,106,64,61,96,94,232,128,50,45,182,126,23176
15000US061150402007,343,104,21,35,0,12,21,35,322,102,150,99,172,94,23177
15000US061150403011,1174,106,475,97,225,89,250,94,699,117,279,84,420,100,23178
15000US061150403021,743,54,325,72,161,62,164,59,418,72,143,47,275,67,23179
15000US061150403031,2009,165,232,119,126,81,106,91,1777,215,265,111,1512,210,23180
15000US061150403032,442,120,75,46,56,39,19,31,367,118,182,113,185,92,23181
15000US061150404001,609,121,191,81,99,55,92,62,418,107,176,90,242,89,23182
15000US061150404002,525,109,254,100,174,89,80,68,271,93,97,47,174,73,23183
15000US061150404003,544,96,135,66,61,46,74,50,409,103,272,71,137,78,23184
15000US061150405001,379,111,33,27,19,17,14,23,346,111,154,101,192,82,23185
15000US061150405002,527,107,124,66,76,59,48,35,403,109,230,92,173,73,23186
15000US061150405003,317,83,68,45,54,40,14,19,249,85,86,52,163,79,23187
15000US061150406001,489,130,122,72,47,45,75,61,367,123,143,75,224,91,23188
15000US061150406002,283,79,23,29,23,29,0,12,260,74,127,48,133,68,23189
15000US061150406003,445,125,160,104,21,24,139,107,285,89,115,69,170,70,23190
15000US061150406004,279,82,59,57,48,56,11,16,220,75,128,62,92,54,23191
15000US061150406005,416,102,88,55,60,55,28,34,328,105,85,53,243,97,23192
15000US061150407001,544,97,46,43,0,12,46,43,498,89,169,73,329,90,23193
15000US061150407002,1002,157,93,64,38,41,55,61,909,171,203,104,706,170,23194
15000US061150407003,231,105,0,12,0,12,0,12,231,105,89,57,142,101,23195
15000US061150407004,849,148,0,12,0,12,0,12,849,148,186,89,663,137,23196
15000US061150407005,1218,169,44,38,22,24,22,29,1174,169,198,74,976,167,23197
15000US061150408001,866,100,117,71,75,68,42,39,749,96,222,95,527,108,23198
15000US061150408002,178,87,19,22,0,12,19,22,159,88,134,83,25,33,23199
15000US061150408003,446,88,6,13,0,12,6,13,440,90,96,55,344,80,23200
15000US061150409011,599,79,96,59,46,38,50,48,503,66,145,58,358,79,23201
15000US061150409012,449,70,110,47,72,44,38,25,339,66,138,47,201,55,23202
15000US061150409021,145,43,12,10,4,6,8,8,133,44,7,8,126,43,23203
15000US061150409022,12,10,6,9,0,12,6,9,6,6,4,5,2,4,23204
15000US061150409023,212,56,13,16,0,12,13,16,199,57,21,16,178,59,23205
15000US061150410001,882,170,44,41,44,41,0,12,838,177,191,86,647,188,23206
15000US061150410002,808,173,124,71,56,68,68,70,684,165,300,138,384,144,23207
15000US061150410003,526,140,29,35,29,35,0,12,497,148,78,47,419,156,23208
15000US061150410004,441,121,76,55,15,23,61,50,365,116,112,70,253,102,23209
15000US061150410005,259,77,14,21,14,21,0,12,245,78,104,73,141,61,23210
15000US061150411001,503,91,25,17,12,10,13,14,478,91,167,53,311,91,23211
15000US061150411002,806,174,96,93,0,12,96,93,710,167,248,138,462,147,23212
15000US061150411003,561,177,33,39,33,39,0,12,528,172,134,91,394,153,23213
15000US061150411004,291,125,37,27,37,27,0,12,254,132,84,76,170,109,23214
